PokerStars Hand #152558476240:  Hold'em No Limit ($0.50/$1.00 USD) - 2016/04/28 14:40:29 CET [2016/04/28 8:40:29 ET]
Table 'Chiny II' 9-max Seat #5 is the button
Seat 1: WDW3 ($162.83 in chips) 
Seat 2: lumen21 ($102.50 in chips) 
Seat 3: Dantist1122 ($103.65 in chips) 
Seat 4: ozone2003 ($100 in chips) 
Seat 5: matiko09 ($100 in chips) 
Seat 6: St.LaCoste ($100 in chips) 
Seat 7: guoweiAA ($76.50 in chips) 
Seat 8: ruslik_by ($40 in chips) 
Seat 9: luckytigerok ($47.26 in chips) 
St.LaCoste: posts small blind $0.50
guoweiAA: posts big blind $1
*** HOLE CARDS ***
Dealt to matiko09 [9h 8c]
ruslik_by: folds 
luckytigerok: folds 
WDW3: folds 
lumen21: folds 
Dantist1122: folds 
ozone2003: folds 
matiko09: folds 
St.LaCoste: raises $1.28 to $2.28
guoweiAA: calls $1.28
*** FLOP *** [5d 4s 3d]
St.LaCoste: bets $3.15
guoweiAA: folds 
Uncalled bet ($3.15) returned to St.LaCoste
St.LaCoste collected $4.33 from pot
St.LaCoste: doesn't show hand 
*** SUMMARY ***
Total pot $4.56 | Rake $0.23 
Board [5d 4s 3d]
Seat 1: WDW3 folded before Flop (didn't bet)
Seat 2: lumen21 folded before Flop (didn't bet)
Seat 3: Dantist1122 folded before Flop (didn't bet)
Seat 4: ozone2003 folded before Flop (didn't bet)
Seat 5: matiko09 (button) folded before Flop (didn't bet)
Seat 6: St.LaCoste (small blind) collected ($4.33)
Seat 7: guoweiAA (big blind) folded on the Flop
Seat 8: ruslik_by folded before Flop (didn't bet)
Seat 9: luckytigerok folded before Flop (didn't bet)





PokerStars Hand #152558478960:  Hold'em No Limit (€0.50/€1.00 EUR) - 2016/04/28 14:40:33 CET [2016/04/28 8:40:33 ET]
Table 'Clivia II' 9-max Seat #2 is the button
Seat 1: piperkova (€40.85 in chips) 
Seat 2: HasBigBiceps (€100 in chips) 
Seat 3: R1aki (€119.66 in chips) 
Seat 4: matiko09 (€100 in chips) 
Seat 5: WDW3 (€123 in chips) 
Seat 6: ruslik_by (€46.55 in chips) 
Seat 7: St.LaCoste (€100 in chips) 
Seat 8: Dantist1122 (€100 in chips) 
Seat 9: ozone2003 (€101.50 in chips) 
R1aki: posts small blind €0.50
matiko09: posts big blind €1
*** HOLE CARDS ***
Dealt to matiko09 [9d Tc]
WDW3: raises €1.80 to €2.80
ruslik_by: folds 
St.LaCoste: folds 
Dantist1122 has timed out
Dantist1122: folds 
ozone2003: folds 
piperkova: folds 
HasBigBiceps: folds 
R1aki: folds 
matiko09: folds 
Uncalled bet (€1.80) returned to WDW3
WDW3 collected €2.50 from pot
WDW3: doesn't show hand 
*** SUMMARY ***
Total pot €2.50 | Rake €0 
Seat 1: piperkova folded before Flop (didn't bet)
Seat 2: HasBigBiceps (button) folded before Flop (didn't bet)
Seat 3: R1aki (small blind) folded before Flop
Seat 4: matiko09 (big blind) folded before Flop
Seat 5: WDW3 collected (€2.50)
Seat 6: ruslik_by folded before Flop (didn't bet)
Seat 7: St.LaCoste folded before Flop (didn't bet)
Seat 8: Dantist1122 folded before Flop (didn't bet)
Seat 9: ozone2003 folded before Flop (didn't bet)





PokerStars Hand #152558481206:  Hold'em No Limit ($1/$2 USD) - 2016/04/28 14:40:38 CET [2016/04/28 8:40:38 ET]
Table 'Mireille' 9-max Seat #7 is the button
Seat 2: matiko09 ($200 in chips) 
Seat 3: MZ2502 ($244.65 in chips) 
Seat 5: SoNe1988 ($145.35 in chips) 
Seat 6: RP513 ($105.73 in chips) 
Seat 7: aseban11 ($241.91 in chips) 
Seat 8: KDJAll3 ($924.68 in chips) 
Seat 9: a-talash ($151.75 in chips) 
KDJAll3: posts small blind $1
a-talash: posts big blind $2
Fish4trips: sits out 
*** HOLE CARDS ***
Dealt to matiko09 [6h 4c]
matiko09: folds 
pulkit25d leaves the table
MZ2502: folds 
SoNe1988: folds 
RP513: folds 
NamesLefTy joins the table at seat #1 
aseban11: raises $2 to $4
KDJAll3: folds 
a-talash: calls $2
*** FLOP *** [4d Ah 9d]
RP513 leaves the table
a-talash: checks 
Yaaaazz joins the table at seat #6 
aseban11: checks 
*** TURN *** [4d Ah 9d] [2c]
a-talash: checks 
aseban11: checks 
*** RIVER *** [4d Ah 9d 2c] [8d]
a-talash: checks 
aseban11: checks 
*** SHOW DOWN ***
a-talash: shows [Js 4s] (a pair of Fours)
aseban11: mucks hand 
a-talash collected $8.55 from pot
*** SUMMARY ***
Total pot $9 | Rake $0.45 
Board [4d Ah 9d 2c 8d]
Seat 2: matiko09 folded before Flop (didn't bet)
Seat 3: MZ2502 folded before Flop (didn't bet)
Seat 5: SoNe1988 folded before Flop (didn't bet)
Seat 6: RP513 folded before Flop (didn't bet)
Seat 7: aseban11 (button) mucked [Ts 2s]
Seat 8: KDJAll3 (small blind) folded before Flop
Seat 9: a-talash (big blind) showed [Js 4s] and won ($8.55) with a pair of Fours





PokerStars Hand #152558482410:  Hold'em No Limit ($1/$2 USD) - 2016/04/28 14:40:40 CET [2016/04/28 8:40:40 ET]
Table 'Libera II' 9-max Seat #2 is the button
Seat 1: libbyyww ($200 in chips) 
Seat 2: peevoajax ($210.35 in chips) 
Seat 3: maverick7614 ($250.68 in chips) 
Seat 4: Sly-Hustler ($121.80 in chips) 
Seat 5: ersevi6 ($100.05 in chips) 
Seat 6: matiko09 ($200 in chips) 
Seat 7: Fish4trips ($200 in chips) 
Seat 8: WDW3 ($207.89 in chips) 
Seat 9: InsomniaRU ($227 in chips) 
maverick7614: posts small blind $1
Sly-Hustler: posts big blind $2
*** HOLE CARDS ***
Dealt to matiko09 [Ad 6h]
ersevi6: folds 
matiko09: folds 
Fish4trips: folds 
WDW3: folds 
InsomniaRU: folds 
libbyyww: folds 
peevoajax: raises $4 to $6
maverick7614: folds 
Sly-Hustler: folds 
Uncalled bet ($4) returned to peevoajax
peevoajax collected $5 from pot
peevoajax: doesn't show hand 
*** SUMMARY ***
Total pot $5 | Rake $0 
Seat 1: libbyyww folded before Flop (didn't bet)
Seat 2: peevoajax (button) collected ($5)
Seat 3: maverick7614 (small blind) folded before Flop
Seat 4: Sly-Hustler (big blind) folded before Flop
Seat 5: ersevi6 folded before Flop (didn't bet)
Seat 6: matiko09 folded before Flop (didn't bet)
Seat 7: Fish4trips folded before Flop (didn't bet)
Seat 8: WDW3 folded before Flop (didn't bet)
Seat 9: InsomniaRU folded before Flop (didn't bet)





PokerStars Hand #152558482335:  Hold'em No Limit ($1/$2 USD) - 2016/04/28 14:40:40 CET [2016/04/28 8:40:40 ET]
Table 'Helio' 9-max Seat #3 is the button
Seat 1: prominente ($300.60 in chips) 
Seat 2: peevoajax ($203 in chips) 
Seat 3: InsomniaRU ($225.45 in chips) 
Seat 4: ersevi6 ($102.66 in chips) 
Seat 5: pretender 19 ($201.77 in chips) 
Seat 6: matiko09 ($206 in chips) 
Seat 7: Fish4trips ($203 in chips) 
Seat 8: libbyyww ($200 in chips) 
Seat 9: rmanjkeee ($91.75 in chips) 
ersevi6: posts small blind $1
pretender 19: posts big blind $2
*** HOLE CARDS ***
Dealt to matiko09 [7c 4d]
matiko09: folds 
Fish4trips: folds 
libbyyww: folds 
rmanjkeee: folds 
prominente: folds 
peevoajax: raises $4 to $6
InsomniaRU: folds 
ersevi6: raises $10 to $16
pretender 19: folds 
peevoajax: folds 
Uncalled bet ($10) returned to ersevi6
ersevi6 collected $14 from pot
ersevi6: doesn't show hand 
*** SUMMARY ***
Total pot $14 | Rake $0 
Seat 1: prominente folded before Flop (didn't bet)
Seat 2: peevoajax folded before Flop
Seat 3: InsomniaRU (button) folded before Flop (didn't bet)
Seat 4: ersevi6 (small blind) collected ($14)
Seat 5: pretender 19 (big blind) folded before Flop
Seat 6: matiko09 folded before Flop (didn't bet)
Seat 7: Fish4trips folded before Flop (didn't bet)
Seat 8: libbyyww folded before Flop (didn't bet)
Seat 9: rmanjkeee folded before Flop (didn't bet)





PokerStars Hand #152558483741:  Hold'em No Limit ($0.50/$1.00 USD) - 2016/04/28 14:40:42 CET [2016/04/28 8:40:42 ET]
Table 'Erynia' 9-max Seat #4 is the button
Seat 1: NamesLefTy ($142.43 in chips) 
Seat 2: matiko09 ($158.80 in chips) 
Seat 3: aseban11 ($111.39 in chips) 
Seat 4: WDW3 ($128.62 in chips) 
Seat 5: scottinsf ($51.99 in chips) 
Seat 6: chrho514 ($100 in chips) 
Seat 7: vrnMike ($111.98 in chips) 
Seat 8: YourKicker78 ($22.73 in chips) 
Seat 9: ruslik_by ($87 in chips) 
scottinsf: posts small blind $0.50
chrho514: posts big blind $1
*** HOLE CARDS ***
Dealt to matiko09 [Jh Kc]
vrnMike: folds 
YourKicker78: raises $2 to $3
ruslik_by: folds 
NamesLefTy: folds 
matiko09: folds 
aseban11: folds 
WDW3: folds 
scottinsf: folds 
chrho514: folds 
Uncalled bet ($2) returned to YourKicker78
YourKicker78 collected $2.50 from pot
YourKicker78: doesn't show hand 
*** SUMMARY ***
Total pot $2.50 | Rake $0 
Seat 1: NamesLefTy folded before Flop (didn't bet)
Seat 2: matiko09 folded before Flop (didn't bet)
Seat 3: aseban11 folded before Flop (didn't bet)
Seat 4: WDW3 (button) folded before Flop (didn't bet)
Seat 5: scottinsf (small blind) folded before Flop
Seat 6: chrho514 (big blind) folded before Flop
Seat 7: vrnMike folded before Flop (didn't bet)
Seat 8: YourKicker78 collected ($2.50)
Seat 9: ruslik_by folded before Flop (didn't bet)





PokerStars Hand #152558485078:  Hold'em No Limit ($0.50/$1.00 USD) - 2016/04/28 14:40:45 CET [2016/04/28 8:40:45 ET]
Table 'Bruwer' 9-max Seat #5 is the button
Seat 1: aseban11 ($100 in chips) 
Seat 2: ruslik_by ($40 in chips) 
Seat 3: koksskrt ($108.11 in chips) 
Seat 4: matiko09 ($153.04 in chips) 
Seat 5: Carloszhang ($131.50 in chips) 
Seat 6: I The King I ($100 in chips) 
Seat 7: R1aki ($251.08 in chips) 
Seat 8: WDW3 ($100 in chips) 
Seat 9: Dantist1122 ($128.91 in chips) 
I The King I: posts small blind $0.50
R1aki: posts big blind $1
*** HOLE CARDS ***
Dealt to matiko09 [7h 4d]
WDW3: folds 
Dantist1122: folds 
aseban11: folds 
ruslik_by: folds 
koksskrt: folds 
matiko09: folds 
Carloszhang: raises $1 to $2
I The King I: folds 
R1aki: calls $1
*** FLOP *** [Qs 9c Kh]
R1aki: checks 
Carloszhang: bets $3
R1aki: folds 
Uncalled bet ($3) returned to Carloszhang
Carloszhang collected $4.28 from pot
*** SUMMARY ***
Total pot $4.50 | Rake $0.22 
Board [Qs 9c Kh]
Seat 1: aseban11 folded before Flop (didn't bet)
Seat 2: ruslik_by folded before Flop (didn't bet)
Seat 3: koksskrt folded before Flop (didn't bet)
Seat 4: matiko09 folded before Flop (didn't bet)
Seat 5: Carloszhang (button) collected ($4.28)
Seat 6: I The King I (small blind) folded before Flop
Seat 7: R1aki (big blind) folded on the Flop
Seat 8: WDW3 folded before Flop (didn't bet)
Seat 9: Dantist1122 folded before Flop (didn't bet)





PokerStars Hand #152558485946:  Hold'em No Limit ($0.50/$1.00 USD) - 2016/04/28 14:40:46 CET [2016/04/28 8:40:46 ET]
Table 'Paris' 9-max Seat #2 is the button
Seat 1: matiko09 ($152.97 in chips) 
Seat 2: birdie1970 ($215.60 in chips) 
Seat 3: Patz B ($39 in chips) 
Seat 4: koksskrt ($100 in chips) 
Seat 6: aseban11 ($100 in chips) 
Seat 7: Westpants ($111.32 in chips) 
Seat 8: Muric05 ($61.51 in chips) 
Seat 9: ruslik_by ($40 in chips) 
Patz B: posts small blind $0.50
koksskrt: posts big blind $1
*** HOLE CARDS ***
Dealt to matiko09 [4h Ad]
aseban11: folds 
Westpants: folds 
Muric05: folds 
ruslik_by: raises $2 to $3
matiko09: folds 
birdie1970: folds 
Patz B: folds 
koksskrt: folds 
Uncalled bet ($2) returned to ruslik_by
ruslik_by collected $2.50 from pot
ruslik_by: doesn't show hand 
*** SUMMARY ***
Total pot $2.50 | Rake $0 
Seat 1: matiko09 folded before Flop (didn't bet)
Seat 2: birdie1970 (button) folded before Flop (didn't bet)
Seat 3: Patz B (small blind) folded before Flop
Seat 4: koksskrt (big blind) folded before Flop
Seat 6: aseban11 folded before Flop (didn't bet)
Seat 7: Westpants folded before Flop (didn't bet)
Seat 8: Muric05 folded before Flop (didn't bet)
Seat 9: ruslik_by collected ($2.50)





PokerStars Hand #152558486345:  Hold'em No Limit (€0.50/€1.00 EUR) - 2016/04/28 14:40:47 CET [2016/04/28 8:40:47 ET]
Table 'Lumiere II' 9-max Seat #1 is the button
Seat 1: vrnMike (€100 in chips) 
Seat 2: Racushniak (€100 in chips) 
Seat 3: ozone2003 (€106.23 in chips) 
Seat 4: ruslik_by (€53.22 in chips) 
Seat 5: Schmidy7 (€39 in chips) 
Seat 6: HasBigBiceps (€101.50 in chips) 
Seat 7: hammerwife (€105.12 in chips) 
Seat 8: WDW3 (€100 in chips) 
Seat 9: matiko09 (€100 in chips) 
Racushniak: posts small blind €0.50
ozone2003: posts big blind €1
*** HOLE CARDS ***
Dealt to matiko09 [3d 7d]
ruslik_by: folds 
Schmidy7: folds 
HasBigBiceps: folds 
hammerwife: raises €1.50 to €2.50
WDW3: folds 
matiko09: folds 
vrnMike: folds 
Racushniak: folds 
ozone2003: folds 
Uncalled bet (€1.50) returned to hammerwife
hammerwife collected €2.50 from pot
hammerwife: doesn't show hand 
*** SUMMARY ***
Total pot €2.50 | Rake €0 
Seat 1: vrnMike (button) folded before Flop (didn't bet)
Seat 2: Racushniak (small blind) folded before Flop
Seat 3: ozone2003 (big blind) folded before Flop
Seat 4: ruslik_by folded before Flop (didn't bet)
Seat 5: Schmidy7 folded before Flop (didn't bet)
Seat 6: HasBigBiceps folded before Flop (didn't bet)
Seat 7: hammerwife collected (€2.50)
Seat 8: WDW3 folded before Flop (didn't bet)
Seat 9: matiko09 folded before Flop (didn't bet)





PokerStars Hand #152558490062:  Hold'em No Limit ($0.50/$1.00 USD) - 2016/04/28 14:40:54 CET [2016/04/28 8:40:54 ET]
Table 'Libra III' 9-max Seat #8 is the button
Seat 1: Vavan1803 ($58.48 in chips) 
Seat 2: Dantist1122 ($210.98 in chips) 
Seat 3: matiko09 ($125.25 in chips) 
Seat 4: ruslik_by ($40 in chips) 
Seat 5: xcpoker0 ($31.27 in chips) 
Seat 6: scottinsf ($74 in chips) 
Seat 7: Westpants ($200 in chips) 
Seat 8: koksskrt ($166.99 in chips) 
Seat 9: peevoajax ($107.28 in chips) 
peevoajax: posts small blind $0.50
Vavan1803: posts big blind $1
*** HOLE CARDS ***
Dealt to matiko09 [4h Jd]
Dantist1122: folds 
Dantist1122 leaves the table
matiko09: folds 
ozone2003 joins the table at seat #2 
ruslik_by: folds 
xcpoker0: folds 
scottinsf: raises $2 to $3
Westpants: folds 
koksskrt: folds 
peevoajax: folds 
Vavan1803: calls $2
*** FLOP *** [8d 4s 7c]
Vavan1803: checks 
scottinsf: bets $5
Vavan1803: calls $5
*** TURN *** [8d 4s 7c] [Jh]
Vavan1803: checks 
scottinsf: bets $8
Vavan1803: calls $8
*** RIVER *** [8d 4s 7c Jh] [2c]
Vavan1803: bets $30.88
scottinsf: folds 
Uncalled bet ($30.88) returned to Vavan1803
Vavan1803 collected $30.88 from pot
Vavan1803: doesn't show hand 
*** SUMMARY ***
Total pot $32.50 | Rake $1.62 
Board [8d 4s 7c Jh 2c]
Seat 1: Vavan1803 (big blind) collected ($30.88)
Seat 2: Dantist1122 folded before Flop (didn't bet)
Seat 3: matiko09 folded before Flop (didn't bet)
Seat 4: ruslik_by folded before Flop (didn't bet)
Seat 5: xcpoker0 folded before Flop (didn't bet)
Seat 6: scottinsf folded on the River
Seat 7: Westpants folded before Flop (didn't bet)
Seat 8: koksskrt (button) folded before Flop (didn't bet)
Seat 9: peevoajax (small blind) folded before Flop





PokerStars Hand #152558494302:  Hold'em No Limit ($0.50/$1.00 USD) - 2016/04/28 14:41:01 CET [2016/04/28 8:41:01 ET]
Table 'Azimech' 9-max Seat #5 is the button
Seat 1: peevoajax ($101.70 in chips) 
Seat 2: adikier ($231.57 in chips) 
Seat 3: matiko09 ($100 in chips) 
Seat 4: ruslik_by ($81.40 in chips) 
Seat 5: ozone2003 ($107.20 in chips) 
Seat 6: chrho514 ($102.22 in chips) 
Seat 7: azzad2007 ($100 in chips) 
Seat 8: vrnMike ($101.08 in chips) 
Seat 9: scottinsf ($64.90 in chips) 
chrho514: posts small blind $0.50
azzad2007: posts big blind $1
*** HOLE CARDS ***
Dealt to matiko09 [5s Jc]
vrnMike: folds 
scottinsf: folds 
peevoajax: folds 
adikier: raises $2 to $3
matiko09: folds 
ruslik_by: folds 
ozone2003: folds 
chrho514: folds 
azzad2007: folds 
Uncalled bet ($2) returned to adikier
adikier collected $2.50 from pot
adikier: doesn't show hand 
*** SUMMARY ***
Total pot $2.50 | Rake $0 
Seat 1: peevoajax folded before Flop (didn't bet)
Seat 2: adikier collected ($2.50)
Seat 3: matiko09 folded before Flop (didn't bet)
Seat 4: ruslik_by folded before Flop (didn't bet)
Seat 5: ozone2003 (button) folded before Flop (didn't bet)
Seat 6: chrho514 (small blind) folded before Flop
Seat 7: azzad2007 (big blind) folded before Flop
Seat 8: vrnMike folded before Flop (didn't bet)
Seat 9: scottinsf folded before Flop (didn't bet)





PokerStars Hand #152558495784:  Hold'em No Limit ($1/$2 USD) - 2016/04/28 14:41:04 CET [2016/04/28 8:41:04 ET]
Table 'Libera II' 9-max Seat #3 is the button
Seat 1: libbyyww ($200 in chips) 
Seat 2: peevoajax ($213.35 in chips) 
Seat 3: maverick7614 ($249.68 in chips) 
Seat 4: Sly-Hustler ($119.80 in chips) 
Seat 5: ersevi6 ($100.05 in chips) 
Seat 6: matiko09 ($200 in chips) 
Seat 7: Fish4trips ($200 in chips) 
Seat 8: WDW3 ($207.89 in chips) 
Seat 9: InsomniaRU ($227 in chips) 
Sly-Hustler: posts small blind $1
ersevi6: posts big blind $2
*** HOLE CARDS ***
Dealt to matiko09 [3h 9c]
matiko09: folds 
Fish4trips: raises $3 to $5
WDW3: calls $5
InsomniaRU: folds 
libbyyww: folds 
peevoajax: folds 
maverick7614: folds 
Sly-Hustler: calls $4
ersevi6: calls $3
*** FLOP *** [9s 7d 2c]
Sly-Hustler: bets $8
ersevi6: raises $16 to $24
Fish4trips: folds 
WDW3: folds 
Sly-Hustler: calls $16
*** TURN *** [9s 7d 2c] [Jh]
Sly-Hustler: checks 
ersevi6: bets $71.05 and is all-in
Sly-Hustler: folds 
Uncalled bet ($71.05) returned to ersevi6
ersevi6 collected $65.25 from pot
ersevi6: doesn't show hand 
*** SUMMARY ***
Total pot $68 | Rake $2.75 
Board [9s 7d 2c Jh]
Seat 1: libbyyww folded before Flop (didn't bet)
Seat 2: peevoajax folded before Flop (didn't bet)
Seat 3: maverick7614 (button) folded before Flop (didn't bet)
Seat 4: Sly-Hustler (small blind) folded on the Turn
Seat 5: ersevi6 (big blind) collected ($65.25)
Seat 6: matiko09 folded before Flop (didn't bet)
Seat 7: Fish4trips folded on the Flop
Seat 8: WDW3 folded on the Flop
Seat 9: InsomniaRU folded before Flop (didn't bet)





PokerStars Hand #152558498324:  Hold'em No Limit ($1/$2 USD) - 2016/04/28 14:41:09 CET [2016/04/28 8:41:09 ET]
Table 'Simonida II' 9-max Seat #9 is the button
Seat 1: 13Ghosts ($200 in chips) 
Seat 2: snow937022 ($229.58 in chips) 
Seat 3: WDW3 ($210.05 in chips) 
Seat 4: a-talash ($171.92 in chips) 
Seat 5: matiko09 ($200 in chips) 
Seat 6: ocarey86 ($151.12 in chips) 
Seat 7: Fish4trips ($203.73 in chips) 
Seat 8: Sutt_420 ($120.49 in chips) 
Seat 9: prominente ($200 in chips) 
13Ghosts: posts small blind $1
snow937022: posts big blind $2
*** HOLE CARDS ***
Dealt to matiko09 [Qs 5c]
WDW3: folds 
a-talash: folds 
matiko09: folds 
ocarey86: folds 
Fish4trips: folds 
Sutt_420: folds 
prominente: raises $2 to $4
13Ghosts: folds 
snow937022: folds 
Uncalled bet ($2) returned to prominente
prominente collected $5 from pot
prominente: doesn't show hand 
*** SUMMARY ***
Total pot $5 | Rake $0 
Seat 1: 13Ghosts (small blind) folded before Flop
Seat 2: snow937022 (big blind) folded before Flop
Seat 3: WDW3 folded before Flop (didn't bet)
Seat 4: a-talash folded before Flop (didn't bet)
Seat 5: matiko09 folded before Flop (didn't bet)
Seat 6: ocarey86 folded before Flop (didn't bet)
Seat 7: Fish4trips folded before Flop (didn't bet)
Seat 8: Sutt_420 folded before Flop (didn't bet)
Seat 9: prominente (button) collected ($5)





PokerStars Hand #152558506192:  Hold'em No Limit ($0.50/$1.00 USD) - 2016/04/28 14:41:23 CET [2016/04/28 8:41:23 ET]
Table 'Erynia' 9-max Seat #5 is the button
Seat 1: NamesLefTy ($142.43 in chips) 
Seat 2: matiko09 ($158.80 in chips) 
Seat 3: aseban11 ($111.39 in chips) 
Seat 4: WDW3 ($128.62 in chips) 
Seat 5: scottinsf ($51.49 in chips) 
Seat 6: chrho514 ($99 in chips) 
Seat 7: vrnMike ($111.98 in chips) 
Seat 8: YourKicker78 ($24.23 in chips) 
Seat 9: ruslik_by ($87 in chips) 
chrho514: posts small blind $0.50
vrnMike: posts big blind $1
*** HOLE CARDS ***
Dealt to matiko09 [4h 3d]
YourKicker78: folds 
ruslik_by: folds 
NamesLefTy: folds 
matiko09: folds 
aseban11: raises $2 to $3
WDW3: folds 
scottinsf: folds 
chrho514: calls $2.50
vrnMike: folds 
*** FLOP *** [6h 4s Ts]
chrho514: checks 
aseban11: checks 
*** TURN *** [6h 4s Ts] [Tc]
chrho514 is disconnected 
chrho514 is connected 
chrho514: folds 
chrho514 leaves the table
aseban11 collected $6.65 from pot
aseban11: doesn't show hand 
*** SUMMARY ***
Total pot $7 | Rake $0.35 
Board [6h 4s Ts Tc]
Seat 1: NamesLefTy folded before Flop (didn't bet)
Seat 2: matiko09 folded before Flop (didn't bet)
Seat 3: aseban11 collected ($6.65)
Seat 4: WDW3 folded before Flop (didn't bet)
Seat 5: scottinsf (button) folded before Flop (didn't bet)
Seat 6: chrho514 (small blind) folded on the Turn
Seat 7: vrnMike (big blind) folded before Flop
Seat 8: YourKicker78 folded before Flop (didn't bet)
Seat 9: ruslik_by folded before Flop (didn't bet)





PokerStars Hand #152558506626:  Hold'em No Limit ($0.50/$1.00 USD) - 2016/04/28 14:41:24 CET [2016/04/28 8:41:24 ET]
Table 'Paris' 9-max Seat #3 is the button
Seat 1: matiko09 ($152.97 in chips) 
Seat 2: birdie1970 ($215.60 in chips) 
Seat 3: Patz B ($38.50 in chips) 
Seat 4: koksskrt ($100 in chips) 
Seat 6: aseban11 ($100 in chips) 
Seat 7: Westpants ($111.32 in chips) 
Seat 8: Muric05 ($61.51 in chips) 
Seat 9: ruslik_by ($41.50 in chips) 
koksskrt: posts small blind $0.50
aseban11: posts big blind $1
*** HOLE CARDS ***
Dealt to matiko09 [As 5s]
Westpants: folds 
Muric05: calls $1
ruslik_by: folds 
matiko09: raises $3 to $4
birdie1970: folds 
Patz B: folds 
koksskrt: folds 
aseban11: folds 
Muric05: folds 
Uncalled bet ($3) returned to matiko09
matiko09 collected $3.50 from pot
matiko09: doesn't show hand 
*** SUMMARY ***
Total pot $3.50 | Rake $0 
Seat 1: matiko09 collected ($3.50)
Seat 2: birdie1970 folded before Flop (didn't bet)
Seat 3: Patz B (button) folded before Flop (didn't bet)
Seat 4: koksskrt (small blind) folded before Flop
Seat 6: aseban11 (big blind) folded before Flop
Seat 7: Westpants folded before Flop (didn't bet)
Seat 8: Muric05 folded before Flop
Seat 9: ruslik_by folded before Flop (didn't bet)





PokerStars Hand #152558510159:  Hold'em No Limit ($0.50/$1.00 USD) - 2016/04/28 14:41:30 CET [2016/04/28 8:41:30 ET]
Table 'Lyot' 9-max Seat #7 is the button
Seat 1: matiko09 ($106 in chips) 
Seat 2: vrnMike ($116.66 in chips) 
Seat 3: aseban11 ($139.71 in chips) 
Seat 4: WDW3 ($103.74 in chips) 
Seat 5: di0d80 ($100 in chips) 
Seat 6: Monglaer ($101.87 in chips) 
Seat 7: PreMoze ($93.83 in chips) 
Seat 8: Patz B ($44.45 in chips) 
Seat 9: koksskrt ($100 in chips) 
Patz B: posts small blind $0.50
koksskrt: posts big blind $1
matiko09: posts the ante $0.20
vrnMike: posts the ante $0.20
aseban11: posts the ante $0.20
WDW3: posts the ante $0.20
di0d80: posts the ante $0.20
Monglaer: posts the ante $0.20
PreMoze: posts the ante $0.20
Patz B: posts the ante $0.20
koksskrt: posts the ante $0.20
*** HOLE CARDS ***
Dealt to matiko09 [Qs Qd]
matiko09: raises $2 to $3
vrnMike: folds 
aseban11: calls $3
WDW3: folds 
di0d80: folds 
Monglaer: folds 
PreMoze: folds 
Patz B: calls $2.50
koksskrt: folds 
*** FLOP *** [6c As 2d]
Patz B: checks 
matiko09: checks 
aseban11: checks 
*** TURN *** [6c As 2d] [4s]
Patz B: bets $4
matiko09: calls $4
aseban11: folds 
*** RIVER *** [6c As 2d 4s] [Jh]
Patz B: checks 
matiko09: checks 
*** SHOW DOWN ***
Patz B: shows [7c 7s] (a pair of Sevens)
matiko09: shows [Qs Qd] (a pair of Queens)
matiko09 collected $18.81 from pot
*** SUMMARY ***
Total pot $19.80 | Rake $0.99 
Board [6c As 2d 4s Jh]
Seat 1: matiko09 showed [Qs Qd] and won ($18.81) with a pair of Queens
Seat 2: vrnMike folded before Flop (didn't bet)
Seat 3: aseban11 folded on the Turn
Seat 4: WDW3 folded before Flop (didn't bet)
Seat 5: di0d80 folded before Flop (didn't bet)
Seat 6: Monglaer folded before Flop (didn't bet)
Seat 7: PreMoze (button) folded before Flop (didn't bet)
Seat 8: Patz B (small blind) showed [7c 7s] and lost with a pair of Sevens
Seat 9: koksskrt (big blind) folded before Flop





PokerStars Hand #152558511556:  Hold'em No Limit (€0.50/€1.00 EUR) - 2016/04/28 14:41:33 CET [2016/04/28 8:41:33 ET]
Table 'Lumiere II' 9-max Seat #2 is the button
Seat 1: vrnMike (€100 in chips) 
Seat 2: Racushniak (€100 in chips) 
Seat 3: ozone2003 (€105.23 in chips) 
Seat 4: ruslik_by (€53.22 in chips) 
Seat 5: Schmidy7 (€39 in chips) 
Seat 6: HasBigBiceps (€101.50 in chips) 
Seat 7: hammerwife (€106.62 in chips) 
Seat 8: WDW3 (€100 in chips) 
Seat 9: matiko09 (€100 in chips) 
ozone2003: posts small blind €0.50
ruslik_by: posts big blind €1
*** HOLE CARDS ***
Dealt to matiko09 [2c 3d]
Schmidy7: folds 
HasBigBiceps: folds 
hammerwife: folds 
WDW3: raises €1.80 to €2.80
matiko09: folds 
vrnMike: folds 
Racushniak: folds 
ozone2003: folds 
ruslik_by: calls €1.80
*** FLOP *** [5c 4h 4c]
ruslik_by: checks 
WDW3: bets €4
ruslik_by: folds 
Uncalled bet (€4) returned to WDW3
WDW3 collected €5.80 from pot
WDW3: doesn't show hand 
*** SUMMARY ***
Total pot €6.10 | Rake €0.30 
Board [5c 4h 4c]
Seat 1: vrnMike folded before Flop (didn't bet)
Seat 2: Racushniak (button) folded before Flop (didn't bet)
Seat 3: ozone2003 (small blind) folded before Flop
Seat 4: ruslik_by (big blind) folded on the Flop
Seat 5: Schmidy7 folded before Flop (didn't bet)
Seat 6: HasBigBiceps folded before Flop (didn't bet)
Seat 7: hammerwife folded before Flop (didn't bet)
Seat 8: WDW3 collected (€5.80)
Seat 9: matiko09 folded before Flop (didn't bet)





PokerStars Hand #152558512136:  Hold'em No Limit ($1/$2 USD) - 2016/04/28 14:41:34 CET [2016/04/28 8:41:34 ET]
Table 'Idomeneus II' 9-max Seat #3 is the button
Seat 1: 13Ghosts ($214.10 in chips) 
Seat 2: libbyyww ($304.54 in chips) 
Seat 3: adrenalin333 ($184.37 in chips) 
Seat 4: SoNe1988 ($82.48 in chips) 
Seat 5: matiko09 ($209.36 in chips) 
Seat 6: aseban11 ($225.99 in chips) 
Seat 7: ersevi6 ($123.11 in chips) 
Seat 8: di0d80 ($224.80 in chips) 
Seat 9: Fish4trips ($200 in chips) 
SoNe1988: posts small blind $1
matiko09: posts big blind $2
*** HOLE CARDS ***
Dealt to matiko09 [Qd 9c]
aseban11: folds 
ersevi6: folds 
di0d80: folds 
Fish4trips: raises $3 to $5
13Ghosts: raises $15 to $20
libbyyww: folds 
adrenalin333: folds 
SoNe1988: folds 
matiko09: folds 
Fish4trips: calls $15
*** FLOP *** [2h Jd 6h]
Fish4trips: checks 
13Ghosts: bets $20
Fish4trips: calls $20
*** TURN *** [2h Jd 6h] [9s]
Fish4trips: checks 
13Ghosts: checks 
*** RIVER *** [2h Jd 6h 9s] [4d]
Fish4trips: checks 
13Ghosts: checks 
*** SHOW DOWN ***
Fish4trips: shows [Kc Ah] (high card Ace)
13Ghosts: shows [As Kh] (high card Ace)
Fish4trips collected $40.13 from pot
13Ghosts collected $40.12 from pot
*** SUMMARY ***
Total pot $83 | Rake $2.75 
Board [2h Jd 6h 9s 4d]
Seat 1: 13Ghosts showed [As Kh] and won ($40.12) with high card Ace
Seat 2: libbyyww folded before Flop (didn't bet)
Seat 3: adrenalin333 (button) folded before Flop (didn't bet)
Seat 4: SoNe1988 (small blind) folded before Flop
Seat 5: matiko09 (big blind) folded before Flop
Seat 6: aseban11 folded before Flop (didn't bet)
Seat 7: ersevi6 folded before Flop (didn't bet)
Seat 8: di0d80 folded before Flop (didn't bet)
Seat 9: Fish4trips showed [Kc Ah] and won ($40.13) with high card Ace





PokerStars Hand #152558512893:  Hold'em No Limit ($0.50/$1.00 USD) - 2016/04/28 14:41:35 CET [2016/04/28 8:41:35 ET]
Table 'Chiny II' 9-max Seat #6 is the button
Seat 1: WDW3 ($162.83 in chips) 
Seat 2: lumen21 ($102.50 in chips) 
Seat 3: Dantist1122 ($103.65 in chips) 
Seat 4: ozone2003 ($100 in chips) 
Seat 5: matiko09 ($100 in chips) 
Seat 6: St.LaCoste ($102.05 in chips) 
Seat 7: guoweiAA ($74.22 in chips) 
Seat 8: ruslik_by ($40 in chips) 
Seat 9: luckytigerok ($47.26 in chips) 
guoweiAA: posts small blind $0.50
ruslik_by: posts big blind $1
*** HOLE CARDS ***
Dealt to matiko09 [5s 3h]
luckytigerok: folds 
WDW3: folds 
lumen21: folds 
Dantist1122: folds 
ozone2003: folds 
matiko09: folds 
St.LaCoste: raises $1.13 to $2.13
guoweiAA: folds 
ruslik_by: raises $4.87 to $7
St.LaCoste: folds 
Uncalled bet ($4.87) returned to ruslik_by
ruslik_by collected $4.76 from pot
ruslik_by: doesn't show hand 
*** SUMMARY ***
Total pot $4.76 | Rake $0 
Seat 1: WDW3 folded before Flop (didn't bet)
Seat 2: lumen21 folded before Flop (didn't bet)
Seat 3: Dantist1122 folded before Flop (didn't bet)
Seat 4: ozone2003 folded before Flop (didn't bet)
Seat 5: matiko09 folded before Flop (didn't bet)
Seat 6: St.LaCoste (button) folded before Flop
Seat 7: guoweiAA (small blind) folded before Flop
Seat 8: ruslik_by (big blind) collected ($4.76)
Seat 9: luckytigerok folded before Flop (didn't bet)





PokerStars Hand #152558513232:  Hold'em No Limit (€0.50/€1.00 EUR) - 2016/04/28 14:41:35 CET [2016/04/28 8:41:35 ET]
Table 'Clivia II' 9-max Seat #3 is the button
Seat 1: piperkova (€40.85 in chips) 
Seat 2: HasBigBiceps (€100 in chips) 
Seat 3: R1aki (€119.16 in chips) 
Seat 4: matiko09 (€100 in chips) 
Seat 5: WDW3 (€124.50 in chips) 
Seat 6: ruslik_by (€46.55 in chips) 
Seat 7: St.LaCoste (€100 in chips) 
Seat 8: Dantist1122 (€100 in chips) 
Seat 9: ozone2003 (€101.50 in chips) 
matiko09: posts small blind €0.50
WDW3: posts big blind €1
*** HOLE CARDS ***
Dealt to matiko09 [7c Ad]
ruslik_by: folds 
St.LaCoste: raises €2 to €3
Dantist1122: folds 
ozone2003: folds 
piperkova: folds 
HasBigBiceps: folds 
R1aki: folds 
matiko09: folds 
WDW3: folds 
Uncalled bet (€2) returned to St.LaCoste
St.LaCoste collected €2.50 from pot
St.LaCoste: doesn't show hand 
*** SUMMARY ***
Total pot €2.50 | Rake €0 
Seat 1: piperkova folded before Flop (didn't bet)
Seat 2: HasBigBiceps folded before Flop (didn't bet)
Seat 3: R1aki (button) folded before Flop (didn't bet)
Seat 4: matiko09 (small blind) folded before Flop
Seat 5: WDW3 (big blind) folded before Flop
Seat 6: ruslik_by folded before Flop (didn't bet)
Seat 7: St.LaCoste collected (€2.50)
Seat 8: Dantist1122 folded before Flop (didn't bet)
Seat 9: ozone2003 folded before Flop (didn't bet)





PokerStars Hand #152558513470:  Hold'em No Limit ($1/$2 USD) - 2016/04/28 14:41:36 CET [2016/04/28 8:41:36 ET]
Table 'Mireille' 9-max Seat #8 is the button
Seat 1: NamesLefTy ($132.90 in chips) 
Seat 2: matiko09 ($200 in chips) 
Seat 3: MZ2502 ($244.65 in chips) 
Seat 5: SoNe1988 ($145.35 in chips) 
Seat 7: aseban11 ($237.91 in chips) 
Seat 8: KDJAll3 ($923.68 in chips) 
Seat 9: a-talash ($156.30 in chips) 
a-talash: posts small blind $1
NamesLefTy: posts big blind $2
Fish4trips: sits out 
Yaaaazz: sits out 
*** HOLE CARDS ***
Dealt to matiko09 [8s 8h]
matiko09: raises $3 to $5
MZ2502: folds 
SoNe1988: folds 
aseban11: raises $13 to $18
KDJAll3: folds 
a-talash: folds 
NamesLefTy: folds 
matiko09: folds 
Uncalled bet ($13) returned to aseban11
aseban11 collected $13 from pot
aseban11: doesn't show hand 
*** SUMMARY ***
Total pot $13 | Rake $0 
Seat 1: NamesLefTy (big blind) folded before Flop
Seat 2: matiko09 folded before Flop
Seat 3: MZ2502 folded before Flop (didn't bet)
Seat 5: SoNe1988 folded before Flop (didn't bet)
Seat 7: aseban11 collected ($13)
Seat 8: KDJAll3 (button) folded before Flop (didn't bet)
Seat 9: a-talash (small blind) folded before Flop





PokerStars Hand #152558515663:  Hold'em No Limit ($1/$2 USD) - 2016/04/28 14:41:40 CET [2016/04/28 8:41:40 ET]
Table 'Helio' 9-max Seat #4 is the button
Seat 1: prominente ($300.60 in chips) 
Seat 2: peevoajax ($200 in chips) 
Seat 3: InsomniaRU ($225.45 in chips) 
Seat 4: ersevi6 ($110.66 in chips) 
Seat 5: pretender 19 ($199.77 in chips) 
Seat 6: matiko09 ($206 in chips) 
Seat 7: Fish4trips ($203 in chips) 
Seat 8: libbyyww ($200 in chips) 
Seat 9: rmanjkeee ($91.75 in chips) 
pretender 19: posts small blind $1
matiko09: posts big blind $2
*** HOLE CARDS ***
Dealt to matiko09 [Td As]
Fish4trips: folds 
libbyyww: folds 
rmanjkeee: raises $3 to $5
prominente: folds 
peevoajax: folds 
InsomniaRU: folds 
ersevi6: folds 
pretender 19: folds 
matiko09: folds 
Uncalled bet ($3) returned to rmanjkeee
rmanjkeee collected $5 from pot
rmanjkeee: doesn't show hand 
Fish4trips leaves the table
*** SUMMARY ***
Total pot $5 | Rake $0 
Seat 1: prominente folded before Flop (didn't bet)
Seat 2: peevoajax folded before Flop (didn't bet)
Seat 3: InsomniaRU folded before Flop (didn't bet)
Seat 4: ersevi6 (button) folded before Flop (didn't bet)
Seat 5: pretender 19 (small blind) folded before Flop
Seat 6: matiko09 (big blind) folded before Flop
Seat 7: Fish4trips folded before Flop (didn't bet)
Seat 8: libbyyww folded before Flop (didn't bet)
Seat 9: rmanjkeee collected ($5)





PokerStars Hand #152558520780:  Hold'em No Limit ($1/$2 USD) - 2016/04/28 14:41:49 CET [2016/04/28 8:41:49 ET]
Table 'Simonida II' 9-max Seat #1 is the button
Seat 1: 13Ghosts ($200 in chips) 
Seat 2: snow937022 ($227.58 in chips) 
Seat 3: WDW3 ($210.05 in chips) 
Seat 4: a-talash ($171.92 in chips) 
Seat 5: matiko09 ($200 in chips) 
Seat 6: ocarey86 ($151.12 in chips) 
Seat 7: Fish4trips ($203.73 in chips) 
Seat 8: Sutt_420 ($120.49 in chips) 
Seat 9: prominente ($203 in chips) 
snow937022: posts small blind $1
WDW3: posts big blind $2
*** HOLE CARDS ***
Dealt to matiko09 [Js 6d]
a-talash: folds 
matiko09: folds 
ocarey86: folds 
Fish4trips: folds 
Sutt_420: folds 
prominente: raises $3 to $5
13Ghosts: folds 
snow937022: folds 
WDW3: folds 
Uncalled bet ($3) returned to prominente
prominente collected $5 from pot
prominente: doesn't show hand 
*** SUMMARY ***
Total pot $5 | Rake $0 
Seat 1: 13Ghosts (button) folded before Flop (didn't bet)
Seat 2: snow937022 (small blind) folded before Flop
Seat 3: WDW3 (big blind) folded before Flop
Seat 4: a-talash folded before Flop (didn't bet)
Seat 5: matiko09 folded before Flop (didn't bet)
Seat 6: ocarey86 folded before Flop (didn't bet)
Seat 7: Fish4trips folded before Flop (didn't bet)
Seat 8: Sutt_420 folded before Flop (didn't bet)
Seat 9: prominente collected ($5)





PokerStars Hand #152558520624:  Hold'em No Limit ($0.50/$1.00 USD) - 2016/04/28 14:41:49 CET [2016/04/28 8:41:49 ET]
Table 'Paris' 9-max Seat #4 is the button
Seat 1: matiko09 ($155.47 in chips) 
Seat 2: birdie1970 ($215.60 in chips) 
Seat 3: Patz B ($38.50 in chips) 
Seat 4: koksskrt ($100 in chips) 
Seat 6: aseban11 ($100 in chips) 
Seat 7: Westpants ($111.32 in chips) 
Seat 8: Muric05 ($60.51 in chips) 
Seat 9: ruslik_by ($41.50 in chips) 
aseban11: posts small blind $0.50
Westpants: posts big blind $1
*** HOLE CARDS ***
Dealt to matiko09 [Th 3c]
Muric05: folds 
ruslik_by: folds 
matiko09: folds 
birdie1970: raises $1.50 to $2.50
Patz B: folds 
koksskrt: folds 
aseban11: folds 
Westpants: folds 
Uncalled bet ($1.50) returned to birdie1970
birdie1970 collected $2.50 from pot
*** SUMMARY ***
Total pot $2.50 | Rake $0 
Seat 1: matiko09 folded before Flop (didn't bet)
Seat 2: birdie1970 collected ($2.50)
Seat 3: Patz B folded before Flop (didn't bet)
Seat 4: koksskrt (button) folded before Flop (didn't bet)
Seat 6: aseban11 (small blind) folded before Flop
Seat 7: Westpants (big blind) folded before Flop
Seat 8: Muric05 folded before Flop (didn't bet)
Seat 9: ruslik_by folded before Flop (didn't bet)





PokerStars Hand #152558522282:  Hold'em No Limit ($0.50/$1.00 USD) - 2016/04/28 14:41:52 CET [2016/04/28 8:41:52 ET]
Table 'Azimech' 9-max Seat #6 is the button
Seat 1: peevoajax ($101.70 in chips) 
Seat 2: adikier ($233.07 in chips) 
Seat 3: matiko09 ($100 in chips) 
Seat 4: ruslik_by ($81.40 in chips) 
Seat 5: ozone2003 ($107.20 in chips) 
Seat 6: chrho514 ($101.72 in chips) 
Seat 7: azzad2007 ($100 in chips) 
Seat 8: vrnMike ($101.08 in chips) 
Seat 9: scottinsf ($64.90 in chips) 
azzad2007: posts small blind $0.50
vrnMike: posts big blind $1
*** HOLE CARDS ***
Dealt to matiko09 [2h Ah]
scottinsf: folds 
peevoajax: folds 
adikier: folds 
matiko09: folds 
ruslik_by: folds 
ozone2003: raises $1.50 to $2.50
chrho514: calls $2.50
azzad2007: folds 
vrnMike: folds 
*** FLOP *** [Qh Td 9h]
ozone2003: checks 
chrho514 is disconnected 
chrho514 is connected 
chrho514: folds 
chrho514 leaves the table
ozone2003 collected $6.18 from pot
ozone2003: doesn't show hand 
*** SUMMARY ***
Total pot $6.50 | Rake $0.32 
Board [Qh Td 9h]
Seat 1: peevoajax folded before Flop (didn't bet)
Seat 2: adikier folded before Flop (didn't bet)
Seat 3: matiko09 folded before Flop (didn't bet)
Seat 4: ruslik_by folded before Flop (didn't bet)
Seat 5: ozone2003 collected ($6.18)
Seat 6: chrho514 (button) folded on the Flop
Seat 7: azzad2007 (small blind) folded before Flop
Seat 8: vrnMike (big blind) folded before Flop
Seat 9: scottinsf folded before Flop (didn't bet)





PokerStars Hand #152558526174:  Hold'em No Limit ($0.50/$1.00 USD) - 2016/04/28 14:41:59 CET [2016/04/28 8:41:59 ET]
Table 'Libra III' 9-max Seat #9 is the button
Seat 1: Vavan1803 ($73.36 in chips) 
Seat 2: ozone2003 ($100 in chips) 
Seat 3: matiko09 ($125.25 in chips) 
Seat 4: ruslik_by ($40 in chips) 
Seat 5: xcpoker0 ($31.27 in chips) 
Seat 6: scottinsf ($58 in chips) 
Seat 7: Westpants ($200 in chips) 
Seat 8: koksskrt ($166.99 in chips) 
Seat 9: peevoajax ($106.78 in chips) 
Vavan1803: posts small blind $0.50
ozone2003: posts big blind $1
*** HOLE CARDS ***
Dealt to matiko09 [Jd 5s]
matiko09: folds 
ruslik_by: raises $2 to $3
xcpoker0: calls $3
scottinsf: folds 
Westpants: folds 
koksskrt: folds 
peevoajax: folds 
Vavan1803: folds 
ozone2003: folds 
*** FLOP *** [Jh 5c Ah]
ruslik_by: bets $2.50
xcpoker0: calls $2.50
*** TURN *** [Jh 5c Ah] [9s]
ruslik_by: bets $4
xcpoker0: folds 
Uncalled bet ($4) returned to ruslik_by
ruslik_by collected $11.88 from pot
ruslik_by: doesn't show hand 
*** SUMMARY ***
Total pot $12.50 | Rake $0.62 
Board [Jh 5c Ah 9s]
Seat 1: Vavan1803 (small blind) folded before Flop
Seat 2: ozone2003 (big blind) folded before Flop
Seat 3: matiko09 folded before Flop (didn't bet)
Seat 4: ruslik_by collected ($11.88)
Seat 5: xcpoker0 folded on the Turn
Seat 6: scottinsf folded before Flop (didn't bet)
Seat 7: Westpants folded before Flop (didn't bet)
Seat 8: koksskrt folded before Flop (didn't bet)
Seat 9: peevoajax (button) folded before Flop (didn't bet)





PokerStars Hand #152558527052:  Hold'em No Limit ($0.50/$1.00 USD) - 2016/04/28 14:42:00 CET [2016/04/28 8:42:00 ET]
Table 'Bruwer' 9-max Seat #6 is the button
Seat 1: aseban11 ($100 in chips) 
Seat 2: ruslik_by ($40 in chips) 
Seat 3: koksskrt ($108.11 in chips) 
Seat 4: matiko09 ($153.04 in chips) 
Seat 5: Carloszhang ($133.78 in chips) 
Seat 6: I The King I ($100 in chips) 
Seat 7: R1aki ($249.08 in chips) 
Seat 8: WDW3 ($100 in chips) 
Seat 9: Dantist1122 ($128.91 in chips) 
R1aki: posts small blind $0.50
WDW3: posts big blind $1
*** HOLE CARDS ***
Dealt to matiko09 [9s 3h]
Dantist1122: raises $2 to $3
aseban11: folds 
ruslik_by: folds 
koksskrt: raises $6 to $9
matiko09: folds 
Carloszhang: folds 
I The King I: folds 
R1aki: folds 
WDW3: folds 
Dantist1122: folds 
Uncalled bet ($6) returned to koksskrt
koksskrt collected $7.50 from pot
koksskrt: doesn't show hand 
*** SUMMARY ***
Total pot $7.50 | Rake $0 
Seat 1: aseban11 folded before Flop (didn't bet)
Seat 2: ruslik_by folded before Flop (didn't bet)
Seat 3: koksskrt collected ($7.50)
Seat 4: matiko09 folded before Flop (didn't bet)
Seat 5: Carloszhang folded before Flop (didn't bet)
Seat 6: I The King I (button) folded before Flop (didn't bet)
Seat 7: R1aki (small blind) folded before Flop
Seat 8: WDW3 (big blind) folded before Flop
Seat 9: Dantist1122 folded before Flop





PokerStars Hand #152558527170:  Hold'em No Limit ($1/$2 USD) - 2016/04/28 14:42:01 CET [2016/04/28 8:42:01 ET]
Table 'Helio' 9-max Seat #5 is the button
Seat 1: prominente ($300.60 in chips) 
Seat 2: peevoajax ($200 in chips) 
Seat 3: InsomniaRU ($225.45 in chips) 
Seat 4: ersevi6 ($110.66 in chips) 
Seat 5: pretender 19 ($198.77 in chips) 
Seat 6: matiko09 ($204 in chips) 
Seat 8: libbyyww ($200 in chips) 
Seat 9: rmanjkeee ($94.75 in chips) 
matiko09: posts small blind $1
libbyyww: posts big blind $2
*** HOLE CARDS ***
Dealt to matiko09 [5h Td]
rmanjkeee: folds 
prominente: folds 
peevoajax: folds 
InsomniaRU: folds 
ersevi6: folds 
pretender 19: folds 
matiko09: folds 
Uncalled bet ($1) returned to libbyyww
libbyyww collected $2 from pot
libbyyww: doesn't show hand 
*** SUMMARY ***
Total pot $2 | Rake $0 
Seat 1: prominente folded before Flop (didn't bet)
Seat 2: peevoajax folded before Flop (didn't bet)
Seat 3: InsomniaRU folded before Flop (didn't bet)
Seat 4: ersevi6 folded before Flop (didn't bet)
Seat 5: pretender 19 (button) folded before Flop (didn't bet)
Seat 6: matiko09 (small blind) folded before Flop
Seat 8: libbyyww (big blind) collected ($2)
Seat 9: rmanjkeee folded before Flop (didn't bet)





PokerStars Hand #152558536659:  Hold'em No Limit ($1/$2 USD) - 2016/04/28 14:42:17 CET [2016/04/28 8:42:17 ET]
Table 'Mireille' 9-max Seat #9 is the button
Seat 1: NamesLefTy ($130.90 in chips) 
Seat 2: matiko09 ($200 in chips) 
Seat 3: MZ2502 ($244.65 in chips) 
Seat 5: SoNe1988 ($145.35 in chips) 
Seat 7: aseban11 ($245.91 in chips) 
Seat 8: KDJAll3 ($923.68 in chips) 
Seat 9: a-talash ($155.30 in chips) 
NamesLefTy: posts small blind $1
matiko09: posts big blind $2
Fish4trips: sits out 
Yaaaazz: sits out 
*** HOLE CARDS ***
Dealt to matiko09 [9d Td]
MZ2502: folds 
SoNe1988: folds 
aseban11: folds 
KDJAll3: folds 
a-talash: folds 
NamesLefTy: folds 
Uncalled bet ($1) returned to matiko09
matiko09 collected $2 from pot
matiko09: doesn't show hand 
*** SUMMARY ***
Total pot $2 | Rake $0 
Seat 1: NamesLefTy (small blind) folded before Flop
Seat 2: matiko09 (big blind) collected ($2)
Seat 3: MZ2502 folded before Flop (didn't bet)
Seat 5: SoNe1988 folded before Flop (didn't bet)
Seat 7: aseban11 folded before Flop (didn't bet)
Seat 8: KDJAll3 folded before Flop (didn't bet)
Seat 9: a-talash (button) folded before Flop (didn't bet)





PokerStars Hand #152558541114:  Hold'em No Limit ($0.50/$1.00 USD) - 2016/04/28 14:42:25 CET [2016/04/28 8:42:25 ET]
Table 'Paris' 9-max Seat #6 is the button
Seat 1: matiko09 ($155.47 in chips) 
Seat 2: birdie1970 ($217.10 in chips) 
Seat 3: Patz B ($38.50 in chips) 
Seat 4: koksskrt ($100 in chips) 
Seat 6: aseban11 ($100 in chips) 
Seat 7: Westpants ($110.32 in chips) 
Seat 8: Muric05 ($60.51 in chips) 
Seat 9: ruslik_by ($41.50 in chips) 
Westpants: posts small blind $0.50
Muric05: posts big blind $1
*** HOLE CARDS ***
Dealt to matiko09 [5c Ac]
ruslik_by: folds 
matiko09: folds 
birdie1970: folds 
Patz B: folds 
koksskrt: raises $1.50 to $2.50
aseban11: folds 
Westpants: folds 
Muric05: folds 
Uncalled bet ($1.50) returned to koksskrt
koksskrt collected $2.50 from pot
koksskrt: doesn't show hand 
*** SUMMARY ***
Total pot $2.50 | Rake $0 
Seat 1: matiko09 folded before Flop (didn't bet)
Seat 2: birdie1970 folded before Flop (didn't bet)
Seat 3: Patz B folded before Flop (didn't bet)
Seat 4: koksskrt collected ($2.50)
Seat 6: aseban11 (button) folded before Flop (didn't bet)
Seat 7: Westpants (small blind) folded before Flop
Seat 8: Muric05 (big blind) folded before Flop
Seat 9: ruslik_by folded before Flop (didn't bet)





PokerStars Hand #152558541625:  Hold'em No Limit ($1/$2 USD) - 2016/04/28 14:42:26 CET [2016/04/28 8:42:26 ET]
Table 'Libera II' 9-max Seat #4 is the button
Seat 1: libbyyww ($200 in chips) 
Seat 2: peevoajax ($213.35 in chips) 
Seat 3: maverick7614 ($249.68 in chips) 
Seat 4: Sly-Hustler ($90.80 in chips) 
Seat 5: ersevi6 ($136.30 in chips) 
Seat 6: matiko09 ($200 in chips) 
Seat 7: Fish4trips ($200 in chips) 
Seat 8: WDW3 ($202.89 in chips) 
Seat 9: InsomniaRU ($227 in chips) 
ersevi6: posts small blind $1
matiko09: posts big blind $2
*** HOLE CARDS ***
Dealt to matiko09 [Kc 9h]
Fish4trips: folds 
WDW3: folds 
InsomniaRU: folds 
libbyyww: folds 
peevoajax: raises $4 to $6
maverick7614: folds 
Sly-Hustler: folds 
ersevi6: folds 
matiko09: folds 
Uncalled bet ($4) returned to peevoajax
peevoajax collected $5 from pot
peevoajax: doesn't show hand 
*** SUMMARY ***
Total pot $5 | Rake $0 
Seat 1: libbyyww folded before Flop (didn't bet)
Seat 2: peevoajax collected ($5)
Seat 3: maverick7614 folded before Flop (didn't bet)
Seat 4: Sly-Hustler (button) folded before Flop (didn't bet)
Seat 5: ersevi6 (small blind) folded before Flop
Seat 6: matiko09 (big blind) folded before Flop
Seat 7: Fish4trips folded before Flop (didn't bet)
Seat 8: WDW3 folded before Flop (didn't bet)
Seat 9: InsomniaRU folded before Flop (didn't bet)





PokerStars Hand #152558541806:  Hold'em No Limit ($1/$2 USD) - 2016/04/28 14:42:26 CET [2016/04/28 8:42:26 ET]
Table 'Simonida II' 9-max Seat #2 is the button
Seat 1: 13Ghosts ($200 in chips) 
Seat 2: snow937022 ($226.58 in chips) 
Seat 3: WDW3 ($208.05 in chips) 
Seat 4: a-talash ($171.92 in chips) 
Seat 5: matiko09 ($200 in chips) 
Seat 6: ocarey86 ($151.12 in chips) 
Seat 7: Fish4trips ($203.73 in chips) 
Seat 8: Sutt_420 ($120.49 in chips) 
Seat 9: prominente ($206 in chips) 
WDW3: posts small blind $1
a-talash: posts big blind $2
*** HOLE CARDS ***
Dealt to matiko09 [Qs Kc]
matiko09: folds 
ocarey86: raises $3 to $5
Fish4trips: folds 
Sutt_420: raises $11 to $16
prominente: folds 
13Ghosts: folds 
snow937022: folds 
WDW3: folds 
a-talash: folds 
ocarey86: folds 
Uncalled bet ($11) returned to Sutt_420
Sutt_420 collected $13 from pot
*** SUMMARY ***
Total pot $13 | Rake $0 
Seat 1: 13Ghosts folded before Flop (didn't bet)
Seat 2: snow937022 (button) folded before Flop (didn't bet)
Seat 3: WDW3 (small blind) folded before Flop
Seat 4: a-talash (big blind) folded before Flop
Seat 5: matiko09 folded before Flop (didn't bet)
Seat 6: ocarey86 folded before Flop
Seat 7: Fish4trips folded before Flop (didn't bet)
Seat 8: Sutt_420 collected ($13)
Seat 9: prominente folded before Flop (didn't bet)





PokerStars Hand #152558543255:  Hold'em No Limit (€0.50/€1.00 EUR) - 2016/04/28 14:42:29 CET [2016/04/28 8:42:29 ET]
Table 'Clivia II' 9-max Seat #4 is the button
Seat 1: piperkova (€40.85 in chips) 
Seat 2: HasBigBiceps (€100 in chips) 
Seat 3: R1aki (€119.16 in chips) 
Seat 4: matiko09 (€100 in chips) 
Seat 5: WDW3 (€123.50 in chips) 
Seat 6: ruslik_by (€46.55 in chips) 
Seat 7: St.LaCoste (€101.50 in chips) 
Seat 8: Dantist1122 (€100 in chips) 
Seat 9: ozone2003 (€101.50 in chips) 
WDW3: posts small blind €0.50
ruslik_by: posts big blind €1
*** HOLE CARDS ***
Dealt to matiko09 [As 3s]
St.LaCoste: folds 
Dantist1122: folds 
ozone2003: folds 
piperkova: calls €1
HasBigBiceps: folds 
R1aki: raises €2.50 to €3.50
matiko09: folds 
WDW3: folds 
ruslik_by: folds 
piperkova: calls €2.50
*** FLOP *** [4s 3h Js]
piperkova: checks 
R1aki: checks 
*** TURN *** [4s 3h Js] [6d]
piperkova: checks 
R1aki: checks 
*** RIVER *** [4s 3h Js 6d] [Qc]
piperkova: bets €1
R1aki: calls €1
*** SHOW DOWN ***
piperkova: shows [Qh Kd] (a pair of Queens)
R1aki: mucks hand 
piperkova collected €9.98 from pot
*** SUMMARY ***
Total pot €10.50 | Rake €0.52 
Board [4s 3h Js 6d Qc]
Seat 1: piperkova showed [Qh Kd] and won (€9.98) with a pair of Queens
Seat 2: HasBigBiceps folded before Flop (didn't bet)
Seat 3: R1aki mucked [8h Ac]
Seat 4: matiko09 (button) folded before Flop (didn't bet)
Seat 5: WDW3 (small blind) folded before Flop
Seat 6: ruslik_by (big blind) folded before Flop
Seat 7: St.LaCoste folded before Flop (didn't bet)
Seat 8: Dantist1122 folded before Flop (didn't bet)
Seat 9: ozone2003 folded before Flop (didn't bet)





PokerStars Hand #152558544107:  Hold'em No Limit ($1/$2 USD) - 2016/04/28 14:42:31 CET [2016/04/28 8:42:31 ET]
Table 'Helio' 9-max Seat #6 is the button
Seat 1: prominente ($300.60 in chips) 
Seat 2: peevoajax ($200 in chips) 
Seat 3: InsomniaRU ($225.45 in chips) 
Seat 4: ersevi6 ($110.66 in chips) 
Seat 5: pretender 19 ($198.77 in chips) 
Seat 6: matiko09 ($203 in chips) 
Seat 8: libbyyww ($201 in chips) 
Seat 9: rmanjkeee ($94.75 in chips) 
di0d80 joins the table at seat #7 
libbyyww: posts small blind $1
rmanjkeee: posts big blind $2
*** HOLE CARDS ***
Dealt to matiko09 [Kc 6c]
prominente: folds 
peevoajax: folds 
InsomniaRU: folds 
ersevi6: folds 
pretender 19: folds 
matiko09: raises $2.54 to $4.54
libbyyww: raises $11.46 to $16
rmanjkeee: folds 
matiko09: folds 
Uncalled bet ($11.46) returned to libbyyww
libbyyww collected $11.08 from pot
libbyyww: doesn't show hand 
*** SUMMARY ***
Total pot $11.08 | Rake $0 
Seat 1: prominente folded before Flop (didn't bet)
Seat 2: peevoajax folded before Flop (didn't bet)
Seat 3: InsomniaRU folded before Flop (didn't bet)
Seat 4: ersevi6 folded before Flop (didn't bet)
Seat 5: pretender 19 folded before Flop (didn't bet)
Seat 6: matiko09 (button) folded before Flop
Seat 8: libbyyww (small blind) collected ($11.08)
Seat 9: rmanjkeee (big blind) folded before Flop





PokerStars Hand #152558544695:  Hold'em No Limit (€0.50/€1.00 EUR) - 2016/04/28 14:42:32 CET [2016/04/28 8:42:32 ET]
Table 'Lumiere II' 9-max Seat #3 is the button
Seat 1: vrnMike (€100 in chips) 
Seat 2: Racushniak (€100 in chips) 
Seat 3: ozone2003 (€104.73 in chips) 
Seat 4: ruslik_by (€50.42 in chips) 
Seat 5: Schmidy7 (€39 in chips) 
Seat 6: HasBigBiceps (€101.50 in chips) 
Seat 7: hammerwife (€106.62 in chips) 
Seat 8: WDW3 (€103 in chips) 
Seat 9: matiko09 (€100 in chips) 
ruslik_by: posts small blind €0.50
Schmidy7: posts big blind €1
*** HOLE CARDS ***
Dealt to matiko09 [3s 9s]
HasBigBiceps: folds 
hammerwife: raises €2 to €3
WDW3: folds 
matiko09: folds 
vrnMike: folds 
Racushniak: folds 
ozone2003: folds 
ruslik_by: folds 
Schmidy7: folds 
Uncalled bet (€2) returned to hammerwife
hammerwife collected €2.50 from pot
hammerwife: doesn't show hand 
*** SUMMARY ***
Total pot €2.50 | Rake €0 
Seat 1: vrnMike folded before Flop (didn't bet)
Seat 2: Racushniak folded before Flop (didn't bet)
Seat 3: ozone2003 (button) folded before Flop (didn't bet)
Seat 4: ruslik_by (small blind) folded before Flop
Seat 5: Schmidy7 (big blind) folded before Flop
Seat 6: HasBigBiceps folded before Flop (didn't bet)
Seat 7: hammerwife collected (€2.50)
Seat 8: WDW3 folded before Flop (didn't bet)
Seat 9: matiko09 folded before Flop (didn't bet)





PokerStars Hand #152558555979:  Hold'em No Limit ($0.50/$1.00 USD) - 2016/04/28 14:42:52 CET [2016/04/28 8:42:52 ET]
Table 'Chiny II' 9-max Seat #7 is the button
Seat 1: WDW3 ($162.83 in chips) 
Seat 2: lumen21 ($102.50 in chips) 
Seat 3: Dantist1122 ($103.65 in chips) 
Seat 4: ozone2003 ($100 in chips) 
Seat 5: matiko09 ($100 in chips) 
Seat 6: St.LaCoste ($100 in chips) 
Seat 7: guoweiAA ($73.72 in chips) 
Seat 8: ruslik_by ($42.63 in chips) 
Seat 9: luckytigerok ($47.26 in chips) 
ruslik_by: posts small blind $0.50
luckytigerok: posts big blind $1
*** HOLE CARDS ***
Dealt to matiko09 [Th Kh]
WDW3: raises $1.80 to $2.80
lumen21: folds 
Dantist1122: folds 
ozone2003: folds 
matiko09: folds 
St.LaCoste: folds 
guoweiAA: folds 
ruslik_by: folds 
luckytigerok: calls $1.80
*** FLOP *** [4h 4s Ad]
luckytigerok: checks 
WDW3: checks 
*** TURN *** [4h 4s Ad] [Qc]
luckytigerok: bets $6
WDW3: folds 
Uncalled bet ($6) returned to luckytigerok
luckytigerok collected $5.80 from pot
luckytigerok: doesn't show hand 
*** SUMMARY ***
Total pot $6.10 | Rake $0.30 
Board [4h 4s Ad Qc]
Seat 1: WDW3 folded on the Turn
Seat 2: lumen21 folded before Flop (didn't bet)
Seat 3: Dantist1122 folded before Flop (didn't bet)
Seat 4: ozone2003 folded before Flop (didn't bet)
Seat 5: matiko09 folded before Flop (didn't bet)
Seat 6: St.LaCoste folded before Flop (didn't bet)
Seat 7: guoweiAA (button) folded before Flop (didn't bet)
Seat 8: ruslik_by (small blind) folded before Flop
Seat 9: luckytigerok (big blind) collected ($5.80)





PokerStars Hand #152558555748:  Hold'em No Limit ($0.50/$1.00 USD) - 2016/04/28 14:42:52 CET [2016/04/28 8:42:52 ET]
Table 'Bruwer' 9-max Seat #7 is the button
Seat 1: aseban11 ($100 in chips) 
Seat 2: ruslik_by ($40 in chips) 
Seat 3: koksskrt ($112.61 in chips) 
Seat 4: matiko09 ($153.04 in chips) 
Seat 5: Carloszhang ($133.78 in chips) 
Seat 6: I The King I ($100 in chips) 
Seat 7: R1aki ($248.58 in chips) 
Seat 8: WDW3 ($100 in chips) 
Seat 9: Dantist1122 ($125.91 in chips) 
WDW3: posts small blind $0.50
Dantist1122: posts big blind $1
*** HOLE CARDS ***
Dealt to matiko09 [Ad Ks]
aseban11: folds 
ruslik_by: folds 
koksskrt: folds 
matiko09: raises $2 to $3
Carloszhang: folds 
I The King I: raises $6 to $9
R1aki: folds 
WDW3: folds 
Dantist1122: folds 
matiko09: calls $6
*** FLOP *** [8h 7s 5c]
matiko09: checks 
I The King I: bets $10
matiko09: folds 
Uncalled bet ($10) returned to I The King I
I The King I collected $18.52 from pot
I The King I: doesn't show hand 
*** SUMMARY ***
Total pot $19.50 | Rake $0.98 
Board [8h 7s 5c]
Seat 1: aseban11 folded before Flop (didn't bet)
Seat 2: ruslik_by folded before Flop (didn't bet)
Seat 3: koksskrt folded before Flop (didn't bet)
Seat 4: matiko09 folded on the Flop
Seat 5: Carloszhang folded before Flop (didn't bet)
Seat 6: I The King I collected ($18.52)
Seat 7: R1aki (button) folded before Flop (didn't bet)
Seat 8: WDW3 (small blind) folded before Flop
Seat 9: Dantist1122 (big blind) folded before Flop





PokerStars Hand #152558558279:  Hold'em No Limit ($1/$2 USD) - 2016/04/28 14:42:56 CET [2016/04/28 8:42:56 ET]
Table 'Libera II' 9-max Seat #5 is the button
Seat 1: libbyyww ($200 in chips) 
Seat 2: peevoajax ($216.35 in chips) 
Seat 3: maverick7614 ($249.68 in chips) 
Seat 4: Sly-Hustler ($90.80 in chips) 
Seat 5: ersevi6 ($135.30 in chips) 
Seat 6: matiko09 ($200 in chips) 
Seat 7: Fish4trips ($200 in chips) 
Seat 8: WDW3 ($202.89 in chips) 
Seat 9: InsomniaRU ($227 in chips) 
matiko09: posts small blind $1
Fish4trips: posts big blind $2
*** HOLE CARDS ***
Dealt to matiko09 [7h 3d]
WDW3: folds 
InsomniaRU: folds 
libbyyww: folds 
peevoajax: folds 
maverick7614: folds 
Sly-Hustler: folds 
ersevi6: raises $3 to $5
matiko09: folds 
Fish4trips: folds 
Uncalled bet ($3) returned to ersevi6
ersevi6 collected $5 from pot
ersevi6: doesn't show hand 
*** SUMMARY ***
Total pot $5 | Rake $0 
Seat 1: libbyyww folded before Flop (didn't bet)
Seat 2: peevoajax folded before Flop (didn't bet)
Seat 3: maverick7614 folded before Flop (didn't bet)
Seat 4: Sly-Hustler folded before Flop (didn't bet)
Seat 5: ersevi6 (button) collected ($5)
Seat 6: matiko09 (small blind) folded before Flop
Seat 7: Fish4trips (big blind) folded before Flop
Seat 8: WDW3 folded before Flop (didn't bet)
Seat 9: InsomniaRU folded before Flop (didn't bet)





PokerStars Hand #152558558603:  Hold'em No Limit ($1/$2 USD) - 2016/04/28 14:42:57 CET [2016/04/28 8:42:57 ET]
Table 'Idomeneus II' 9-max Seat #4 is the button
Seat 1: 13Ghosts ($214.22 in chips) 
Seat 2: libbyyww ($304.54 in chips) 
Seat 3: adrenalin333 ($184.37 in chips) 
Seat 4: SoNe1988 ($81.48 in chips) 
Seat 5: matiko09 ($207.36 in chips) 
Seat 7: ersevi6 ($123.11 in chips) 
Seat 8: di0d80 ($224.80 in chips) 
Seat 9: Fish4trips ($200.13 in chips) 
matiko09: posts small blind $1
aseban11: is sitting out 
ersevi6: posts big blind $2
*** HOLE CARDS ***
Dealt to matiko09 [Ts Ac]
di0d80: folds 
Fish4trips: folds 
13Ghosts: folds 
libbyyww: folds 
adrenalin333: calls $2
SoNe1988: folds 
matiko09: raises $6 to $8
ersevi6: folds 
adrenalin333: folds 
Uncalled bet ($6) returned to matiko09
matiko09 collected $6 from pot
matiko09: doesn't show hand 
*** SUMMARY ***
Total pot $6 | Rake $0 
Seat 1: 13Ghosts folded before Flop (didn't bet)
Seat 2: libbyyww folded before Flop (didn't bet)
Seat 3: adrenalin333 folded before Flop
Seat 4: SoNe1988 (button) folded before Flop (didn't bet)
Seat 5: matiko09 (small blind) collected ($6)
Seat 7: ersevi6 (big blind) folded before Flop
Seat 8: di0d80 folded before Flop (didn't bet)
Seat 9: Fish4trips folded before Flop (didn't bet)





PokerStars Hand #152558560153:  Hold'em No Limit ($0.50/$1.00 USD) - 2016/04/28 14:42:59 CET [2016/04/28 8:42:59 ET]
Table 'Lyot' 9-max Seat #8 is the button
Seat 1: matiko09 ($117.61 in chips) 
Seat 2: vrnMike ($116.46 in chips) 
Seat 3: aseban11 ($136.51 in chips) 
Seat 4: WDW3 ($103.54 in chips) 
Seat 5: di0d80 ($100 in chips) 
Seat 6: Monglaer ($101.67 in chips) 
Seat 7: PreMoze ($93.63 in chips) 
Seat 8: Patz B ($37.25 in chips) 
Seat 9: koksskrt ($100 in chips) 
koksskrt: posts small blind $0.50
matiko09: posts big blind $1
matiko09: posts the ante $0.20
vrnMike: posts the ante $0.20
aseban11: posts the ante $0.20
WDW3: posts the ante $0.20
di0d80: posts the ante $0.20
Monglaer: posts the ante $0.20
PreMoze: posts the ante $0.20
Patz B: posts the ante $0.20
koksskrt: posts the ante $0.20
*** HOLE CARDS ***
Dealt to matiko09 [2h 4d]
vrnMike: folds 
aseban11: raises $4.30 to $5.30
WDW3: folds 
di0d80: folds 
Monglaer: folds 
PreMoze: folds 
Patz B: folds 
koksskrt: folds 
matiko09: folds 
Uncalled bet ($4.30) returned to aseban11
aseban11 collected $4.30 from pot
aseban11: doesn't show hand 
*** SUMMARY ***
Total pot $4.30 | Rake $0 
Seat 1: matiko09 (big blind) folded before Flop
Seat 2: vrnMike folded before Flop (didn't bet)
Seat 3: aseban11 collected ($4.30)
Seat 4: WDW3 folded before Flop (didn't bet)
Seat 5: di0d80 folded before Flop (didn't bet)
Seat 6: Monglaer folded before Flop (didn't bet)
Seat 7: PreMoze folded before Flop (didn't bet)
Seat 8: Patz B (button) folded before Flop (didn't bet)
Seat 9: koksskrt (small blind) folded before Flop





PokerStars Hand #152558562682:  Hold'em No Limit ($1/$2 USD) - 2016/04/28 14:43:04 CET [2016/04/28 8:43:04 ET]
Table 'Simonida II' 9-max Seat #3 is the button
Seat 1: 13Ghosts ($200 in chips) 
Seat 2: snow937022 ($226.58 in chips) 
Seat 3: WDW3 ($207.05 in chips) 
Seat 4: a-talash ($169.92 in chips) 
Seat 5: matiko09 ($200 in chips) 
Seat 6: ocarey86 ($146.12 in chips) 
Seat 7: Fish4trips ($203.73 in chips) 
Seat 8: Sutt_420 ($128.49 in chips) 
Seat 9: prominente ($206 in chips) 
a-talash: posts small blind $1
matiko09: posts big blind $2
*** HOLE CARDS ***
Dealt to matiko09 [6s Qh]
ocarey86: folds 
Fish4trips: folds 
Sutt_420: folds 
prominente: folds 
13Ghosts: raises $2.78 to $4.78
snow937022: folds 
WDW3: folds 
a-talash: folds 
matiko09: folds 
Uncalled bet ($2.78) returned to 13Ghosts
13Ghosts collected $5 from pot
13Ghosts: doesn't show hand 
*** SUMMARY ***
Total pot $5 | Rake $0 
Seat 1: 13Ghosts collected ($5)
Seat 2: snow937022 folded before Flop (didn't bet)
Seat 3: WDW3 (button) folded before Flop (didn't bet)
Seat 4: a-talash (small blind) folded before Flop
Seat 5: matiko09 (big blind) folded before Flop
Seat 6: ocarey86 folded before Flop (didn't bet)
Seat 7: Fish4trips folded before Flop (didn't bet)
Seat 8: Sutt_420 folded before Flop (didn't bet)
Seat 9: prominente folded before Flop (didn't bet)





PokerStars Hand #152558564851:  Hold'em No Limit ($0.50/$1.00 USD) - 2016/04/28 14:43:08 CET [2016/04/28 8:43:08 ET]
Table 'Paris' 9-max Seat #7 is the button
Seat 1: matiko09 ($155.47 in chips) 
Seat 2: birdie1970 ($217.10 in chips) 
Seat 3: Patz B ($38.50 in chips) 
Seat 4: koksskrt ($101.50 in chips) 
Seat 6: aseban11 ($100 in chips) 
Seat 7: Westpants ($109.82 in chips) 
Seat 8: Muric05 ($59.51 in chips) 
Seat 9: ruslik_by ($41.50 in chips) 
Muric05: posts small blind $0.50
ruslik_by: posts big blind $1
*** HOLE CARDS ***
Dealt to matiko09 [2h 9h]
matiko09: folds 
birdie1970: folds 
Patz B: folds 
koksskrt: folds 
aseban11: raises $2 to $3
Westpants: raises $5 to $8
Muric05: folds 
ruslik_by: folds 
aseban11: calls $5
*** FLOP *** [5h 4h Qc]
aseban11: checks 
Westpants: bets $9.75
aseban11: calls $9.75
*** TURN *** [5h 4h Qc] [As]
aseban11: checks 
Westpants: checks 
*** RIVER *** [5h 4h Qc As] [4d]
aseban11: checks 
Westpants: bets $16.87
aseban11: folds 
Uncalled bet ($16.87) returned to Westpants
Westpants collected $35.15 from pot
*** SUMMARY ***
Total pot $37 | Rake $1.85 
Board [5h 4h Qc As 4d]
Seat 1: matiko09 folded before Flop (didn't bet)
Seat 2: birdie1970 folded before Flop (didn't bet)
Seat 3: Patz B folded before Flop (didn't bet)
Seat 4: koksskrt folded before Flop (didn't bet)
Seat 6: aseban11 folded on the River
Seat 7: Westpants (button) collected ($35.15)
Seat 8: Muric05 (small blind) folded before Flop
Seat 9: ruslik_by (big blind) folded before Flop





PokerStars Hand #152558568099:  Hold'em No Limit ($1/$2 USD) - 2016/04/28 14:43:14 CET [2016/04/28 8:43:14 ET]
Table 'Mireille' 9-max Seat #1 is the button
Seat 1: NamesLefTy ($129.90 in chips) 
Seat 2: matiko09 ($201 in chips) 
Seat 3: MZ2502 ($244.65 in chips) 
Seat 5: SoNe1988 ($145.35 in chips) 
Seat 7: aseban11 ($245.91 in chips) 
Seat 8: KDJAll3 ($923.68 in chips) 
Seat 9: a-talash ($155.30 in chips) 
matiko09: posts small blind $1
MZ2502: posts big blind $2
Fish4trips: sits out 
Yaaaazz: sits out 
*** HOLE CARDS ***
Dealt to matiko09 [Th 3d]
SoNe1988: folds 
aseban11: raises $4 to $6
KDJAll3: folds 
a-talash: folds 
NamesLefTy: folds 
matiko09: folds 
MZ2502: calls $4
*** FLOP *** [2h 9c Qs]
MZ2502: checks 
aseban11: checks 
*** TURN *** [2h 9c Qs] [7d]
MZ2502: bets $8
aseban11: calls $8
*** RIVER *** [2h 9c Qs 7d] [Ad]
NamesLefTy is disconnected 
MZ2502: bets $16
aseban11: raises $42 to $58
MZ2502: folds 
Uncalled bet ($42) returned to aseban11
aseban11 collected $58.25 from pot
aseban11: doesn't show hand 
*** SUMMARY ***
Total pot $61 | Rake $2.75 
Board [2h 9c Qs 7d Ad]
Seat 1: NamesLefTy (button) folded before Flop (didn't bet)
Seat 2: matiko09 (small blind) folded before Flop
Seat 3: MZ2502 (big blind) folded on the River
Seat 5: SoNe1988 folded before Flop (didn't bet)
Seat 7: aseban11 collected ($58.25)
Seat 8: KDJAll3 folded before Flop (didn't bet)
Seat 9: a-talash folded before Flop (didn't bet)





PokerStars Hand #152558570484:  Hold'em No Limit (€0.50/€1.00 EUR) - 2016/04/28 14:43:18 CET [2016/04/28 8:43:18 ET]
Table 'Lumiere II' 9-max Seat #4 is the button
Seat 1: vrnMike (€100 in chips) 
Seat 2: Racushniak (€100 in chips) 
Seat 3: ozone2003 (€104.73 in chips) 
Seat 4: ruslik_by (€49.92 in chips) 
Seat 5: Schmidy7 (€38 in chips) 
Seat 6: HasBigBiceps (€101.50 in chips) 
Seat 7: hammerwife (€108.12 in chips) 
Seat 8: WDW3 (€103 in chips) 
Seat 9: matiko09 (€100 in chips) 
Schmidy7: posts small blind €0.50
HasBigBiceps: posts big blind €1
*** HOLE CARDS ***
Dealt to matiko09 [Jh 6h]
hammerwife: folds 
WDW3: folds 
matiko09: folds 
vrnMike: folds 
Racushniak: raises €2 to €3
ozone2003: folds 
ruslik_by: folds 
Schmidy7: folds 
HasBigBiceps: folds 
Uncalled bet (€2) returned to Racushniak
Racushniak collected €2.50 from pot
Racushniak: doesn't show hand 
*** SUMMARY ***
Total pot €2.50 | Rake €0 
Seat 1: vrnMike folded before Flop (didn't bet)
Seat 2: Racushniak collected (€2.50)
Seat 3: ozone2003 folded before Flop (didn't bet)
Seat 4: ruslik_by (button) folded before Flop (didn't bet)
Seat 5: Schmidy7 (small blind) folded before Flop
Seat 6: HasBigBiceps (big blind) folded before Flop
Seat 7: hammerwife folded before Flop (didn't bet)
Seat 8: WDW3 folded before Flop (didn't bet)
Seat 9: matiko09 folded before Flop (didn't bet)





PokerStars Hand #152558572474:  Hold'em No Limit ($1/$2 USD) - 2016/04/28 14:43:22 CET [2016/04/28 8:43:22 ET]
Table 'Helio' 9-max Seat #8 is the button
Seat 1: prominente ($300.60 in chips) 
Seat 2: peevoajax ($200 in chips) 
Seat 3: InsomniaRU ($225.45 in chips) 
Seat 4: ersevi6 ($110.66 in chips) 
Seat 5: pretender 19 ($198.77 in chips) 
Seat 6: matiko09 ($200 in chips) 
Seat 8: libbyyww ($207.54 in chips) 
Seat 9: rmanjkeee ($92.75 in chips) 
rmanjkeee: posts small blind $1
prominente: posts big blind $2
*** HOLE CARDS ***
Dealt to matiko09 [2s 6d]
peevoajax: folds 
InsomniaRU: folds 
ersevi6: raises $3 to $5
pretender 19: folds 
matiko09: folds 
libbyyww: folds 
rmanjkeee: folds 
prominente: folds 
Uncalled bet ($3) returned to ersevi6
ersevi6 collected $5 from pot
ersevi6: doesn't show hand 
*** SUMMARY ***
Total pot $5 | Rake $0 
Seat 1: prominente (big blind) folded before Flop
Seat 2: peevoajax folded before Flop (didn't bet)
Seat 3: InsomniaRU folded before Flop (didn't bet)
Seat 4: ersevi6 collected ($5)
Seat 5: pretender 19 folded before Flop (didn't bet)
Seat 6: matiko09 folded before Flop (didn't bet)
Seat 8: libbyyww (button) folded before Flop (didn't bet)
Seat 9: rmanjkeee (small blind) folded before Flop





PokerStars Hand #152558578062:  Hold'em No Limit ($0.50/$1.00 USD) - 2016/04/28 14:43:32 CET [2016/04/28 8:43:32 ET]
Table 'Lyot' 9-max Seat #9 is the button
Seat 1: matiko09 ($116.41 in chips) 
Seat 2: vrnMike ($116.26 in chips) 
Seat 3: aseban11 ($139.61 in chips) 
Seat 4: WDW3 ($103.34 in chips) 
Seat 5: di0d80 ($100 in chips) 
Seat 6: Monglaer ($101.47 in chips) 
Seat 7: PreMoze ($93.43 in chips) 
Seat 8: Patz B ($37.05 in chips) 
Seat 9: koksskrt ($100 in chips) 
matiko09: posts small blind $0.50
vrnMike: posts big blind $1
matiko09: posts the ante $0.20
vrnMike: posts the ante $0.20
aseban11: posts the ante $0.20
WDW3: posts the ante $0.20
di0d80: posts the ante $0.20
Monglaer: posts the ante $0.20
PreMoze: posts the ante $0.20
Patz B: posts the ante $0.20
koksskrt: posts the ante $0.20
*** HOLE CARDS ***
Dealt to matiko09 [8s Tc]
aseban11: folds 
WDW3: folds 
di0d80: folds 
Monglaer: folds 
PreMoze: calls $1
Patz B: folds 
koksskrt: folds 
matiko09: folds 
vrnMike: checks 
*** FLOP *** [Qs 4c Qh]
vrnMike: checks 
PreMoze: checks 
*** TURN *** [Qs 4c Qh] [Js]
vrnMike: checks 
PreMoze: bets $1
vrnMike: folds 
Uncalled bet ($1) returned to PreMoze
PreMoze collected $4.08 from pot
*** SUMMARY ***
Total pot $4.30 | Rake $0.22 
Board [Qs 4c Qh Js]
Seat 1: matiko09 (small blind) folded before Flop
Seat 2: vrnMike (big blind) folded on the Turn
Seat 3: aseban11 folded before Flop (didn't bet)
Seat 4: WDW3 folded before Flop (didn't bet)
Seat 5: di0d80 folded before Flop (didn't bet)
Seat 6: Monglaer folded before Flop (didn't bet)
Seat 7: PreMoze collected ($4.08)
Seat 8: Patz B folded before Flop (didn't bet)
Seat 9: koksskrt (button) folded before Flop (didn't bet)





PokerStars Hand #152558581245:  Hold'em No Limit ($1/$2 USD) - 2016/04/28 14:43:38 CET [2016/04/28 8:43:38 ET]
Table 'Simonida II' 9-max Seat #4 is the button
Seat 1: 13Ghosts ($203 in chips) 
Seat 2: snow937022 ($226.58 in chips) 
Seat 3: WDW3 ($207.05 in chips) 
Seat 4: a-talash ($168.92 in chips) 
Seat 5: matiko09 ($200 in chips) 
Seat 6: ocarey86 ($146.12 in chips) 
Seat 7: Fish4trips ($203.73 in chips) 
Seat 8: Sutt_420 ($128.49 in chips) 
Seat 9: prominente ($206 in chips) 
matiko09: posts small blind $1
ocarey86: posts big blind $2
*** HOLE CARDS ***
Dealt to matiko09 [Ad 3h]
Fish4trips: folds 
Sutt_420: calls $2
prominente: folds 
13Ghosts: folds 
snow937022: folds 
WDW3: folds 
a-talash: folds 
matiko09: folds 
ocarey86: checks 
*** FLOP *** [5d 6s Ac]
ocarey86: checks 
Sutt_420: bets $4
ocarey86: calls $4
*** TURN *** [5d 6s Ac] [Kd]
ocarey86: checks 
Sutt_420: checks 
*** RIVER *** [5d 6s Ac Kd] [2s]
ocarey86: bets $7.50
Sutt_420: folds 
Uncalled bet ($7.50) returned to ocarey86
ocarey86 collected $12.35 from pot
*** SUMMARY ***
Total pot $13 | Rake $0.65 
Board [5d 6s Ac Kd 2s]
Seat 1: 13Ghosts folded before Flop (didn't bet)
Seat 2: snow937022 folded before Flop (didn't bet)
Seat 3: WDW3 folded before Flop (didn't bet)
Seat 4: a-talash (button) folded before Flop (didn't bet)
Seat 5: matiko09 (small blind) folded before Flop
Seat 6: ocarey86 (big blind) collected ($12.35)
Seat 7: Fish4trips folded before Flop (didn't bet)
Seat 8: Sutt_420 folded on the River
Seat 9: prominente folded before Flop (didn't bet)





PokerStars Hand #152558584997:  Hold'em No Limit ($0.50/$1.00 USD) - 2016/04/28 14:43:44 CET [2016/04/28 8:43:44 ET]
Table 'Azimech' 9-max Seat #7 is the button
Seat 1: peevoajax ($101.70 in chips) 
Seat 2: adikier ($233.07 in chips) 
Seat 3: matiko09 ($100 in chips) 
Seat 4: ruslik_by ($81.40 in chips) 
Seat 5: ozone2003 ($110.88 in chips) 
Seat 7: azzad2007 ($100 in chips) 
Seat 8: vrnMike ($100.08 in chips) 
Seat 9: scottinsf ($64.90 in chips) 
vrnMike: posts small blind $0.50
sanpidk joins the table at seat #6 
scottinsf: posts big blind $1
*** HOLE CARDS ***
Dealt to matiko09 [Jd Ks]
peevoajax: folds 
adikier: folds 
matiko09: folds 
ruslik_by: folds 
ozone2003: folds 
azzad2007: folds 
vrnMike: folds 
Uncalled bet ($0.50) returned to scottinsf
scottinsf collected $1 from pot
scottinsf: doesn't show hand 
*** SUMMARY ***
Total pot $1 | Rake $0 
Seat 1: peevoajax folded before Flop (didn't bet)
Seat 2: adikier folded before Flop (didn't bet)
Seat 3: matiko09 folded before Flop (didn't bet)
Seat 4: ruslik_by folded before Flop (didn't bet)
Seat 5: ozone2003 folded before Flop (didn't bet)
Seat 7: azzad2007 (button) folded before Flop (didn't bet)
Seat 8: vrnMike (small blind) folded before Flop
Seat 9: scottinsf (big blind) collected ($1)





PokerStars Hand #152558585601:  Hold'em No Limit ($1/$2 USD) - 2016/04/28 14:43:45 CET [2016/04/28 8:43:45 ET]
Table 'Libera II' 9-max Seat #6 is the button
Seat 1: libbyyww ($200 in chips) 
Seat 2: peevoajax ($216.35 in chips) 
Seat 3: maverick7614 ($249.68 in chips) 
Seat 4: Sly-Hustler ($90.80 in chips) 
Seat 5: ersevi6 ($138.30 in chips) 
Seat 6: matiko09 ($200 in chips) 
Seat 7: Fish4trips ($200 in chips) 
Seat 8: WDW3 ($202.89 in chips) 
Seat 9: InsomniaRU ($227 in chips) 
Fish4trips: posts small blind $1
WDW3: posts big blind $2
*** HOLE CARDS ***
Dealt to matiko09 [Ks 7d]
InsomniaRU: folds 
libbyyww: raises $4 to $6
peevoajax: folds 
maverick7614: folds 
Sly-Hustler: folds 
ersevi6: folds 
matiko09: folds 
Fish4trips: folds 
WDW3: folds 
Uncalled bet ($4) returned to libbyyww
libbyyww collected $5 from pot
libbyyww: doesn't show hand 
*** SUMMARY ***
Total pot $5 | Rake $0 
Seat 1: libbyyww collected ($5)
Seat 2: peevoajax folded before Flop (didn't bet)
Seat 3: maverick7614 folded before Flop (didn't bet)
Seat 4: Sly-Hustler folded before Flop (didn't bet)
Seat 5: ersevi6 folded before Flop (didn't bet)
Seat 6: matiko09 (button) folded before Flop (didn't bet)
Seat 7: Fish4trips (small blind) folded before Flop
Seat 8: WDW3 (big blind) folded before Flop
Seat 9: InsomniaRU folded before Flop (didn't bet)





PokerStars Hand #152558585849:  Hold'em No Limit ($1/$2 USD) - 2016/04/28 14:43:46 CET [2016/04/28 8:43:46 ET]
Table 'Helio' 9-max Seat #9 is the button
Seat 1: prominente ($298.60 in chips) 
Seat 2: peevoajax ($200 in chips) 
Seat 3: InsomniaRU ($225.45 in chips) 
Seat 4: ersevi6 ($113.66 in chips) 
Seat 5: pretender 19 ($198.77 in chips) 
Seat 6: matiko09 ($200 in chips) 
Seat 8: libbyyww ($207.54 in chips) 
Seat 9: rmanjkeee ($91.75 in chips) 
prominente: posts small blind $1
peevoajax: posts big blind $2
*** HOLE CARDS ***
Dealt to matiko09 [2d 2h]
InsomniaRU: folds 
ersevi6: folds 
pretender 19: folds 
matiko09: raises $3 to $5
libbyyww: folds 
rmanjkeee: folds 
prominente: folds 
peevoajax: folds 
Uncalled bet ($3) returned to matiko09
matiko09 collected $5 from pot
matiko09: doesn't show hand 
*** SUMMARY ***
Total pot $5 | Rake $0 
Seat 1: prominente (small blind) folded before Flop
Seat 2: peevoajax (big blind) folded before Flop
Seat 3: InsomniaRU folded before Flop (didn't bet)
Seat 4: ersevi6 folded before Flop (didn't bet)
Seat 5: pretender 19 folded before Flop (didn't bet)
Seat 6: matiko09 collected ($5)
Seat 8: libbyyww folded before Flop (didn't bet)
Seat 9: rmanjkeee (button) folded before Flop (didn't bet)





PokerStars Hand #152558587046:  Hold'em No Limit ($0.50/$1.00 USD) - 2016/04/28 14:43:48 CET [2016/04/28 8:43:48 ET]
Table 'Erynia' 9-max Seat #7 is the button
Seat 1: NamesLefTy ($142.43 in chips) 
Seat 2: matiko09 ($158.80 in chips) 
Seat 3: aseban11 ($115.04 in chips) 
Seat 4: WDW3 ($128.62 in chips) 
Seat 5: scottinsf ($51.49 in chips) 
Seat 7: vrnMike ($110.98 in chips) 
Seat 8: YourKicker78 ($24.23 in chips) 
Seat 9: ruslik_by ($87 in chips) 
YourKicker78: posts small blind $0.50
ruslik_by: posts big blind $1
*** HOLE CARDS ***
Dealt to matiko09 [Ah 3s]
peevoajax joins the table at seat #6 
NamesLefTy is disconnected 
NamesLefTy has timed out while disconnected
NamesLefTy: folds 
matiko09: folds 
aseban11: folds 
WDW3: folds 
scottinsf: folds 
vrnMike: raises $2 to $3
YourKicker78: folds 
ruslik_by: raises $6 to $9
vrnMike: calls $6
*** FLOP *** [Qh 8c 4d]
ruslik_by: bets $7.50
vrnMike: folds 
Uncalled bet ($7.50) returned to ruslik_by
ruslik_by collected $17.58 from pot
ruslik_by: doesn't show hand 
*** SUMMARY ***
Total pot $18.50 | Rake $0.92 
Board [Qh 8c 4d]
Seat 1: NamesLefTy folded before Flop (didn't bet)
Seat 2: matiko09 folded before Flop (didn't bet)
Seat 3: aseban11 folded before Flop (didn't bet)
Seat 4: WDW3 folded before Flop (didn't bet)
Seat 5: scottinsf folded before Flop (didn't bet)
Seat 7: vrnMike (button) folded on the Flop
Seat 8: YourKicker78 (small blind) folded before Flop
Seat 9: ruslik_by (big blind) collected ($17.58)





PokerStars Hand #152558589343:  Hold'em No Limit ($1/$2 USD) - 2016/04/28 14:43:52 CET [2016/04/28 8:43:52 ET]
Table 'Idomeneus II' 9-max Seat #5 is the button
Seat 1: 13Ghosts ($214.22 in chips) 
Seat 2: libbyyww ($304.54 in chips) 
Seat 3: adrenalin333 ($182.37 in chips) 
Seat 4: SoNe1988 ($81.48 in chips) 
Seat 5: matiko09 ($211.36 in chips) 
Seat 7: ersevi6 ($166.11 in chips) 
Seat 9: Fish4trips ($200.13 in chips) 
ersevi6: posts small blind $1
di0d80: is sitting out 
Fish4trips: posts big blind $2
*** HOLE CARDS ***
Dealt to matiko09 [2d Jh]
13Ghosts: folds 
libbyyww: folds 
adrenalin333: folds 
SoNe1988: folds 
matiko09: folds 
ersevi6: raises $2.50 to $4.50
Fish4trips: calls $2.50
*** FLOP *** [Qc Qd 7h]
ersevi6: bets $5
Fish4trips: calls $5
*** TURN *** [Qc Qd 7h] [7d]
ersevi6: checks 
Fish4trips: bets $7.40
ersevi6: folds 
Uncalled bet ($7.40) returned to Fish4trips
Fish4trips collected $18.05 from pot
Fish4trips: doesn't show hand 
*** SUMMARY ***
Total pot $19 | Rake $0.95 
Board [Qc Qd 7h 7d]
Seat 1: 13Ghosts folded before Flop (didn't bet)
Seat 2: libbyyww folded before Flop (didn't bet)
Seat 3: adrenalin333 folded before Flop (didn't bet)
Seat 4: SoNe1988 folded before Flop (didn't bet)
Seat 5: matiko09 (button) folded before Flop (didn't bet)
Seat 7: ersevi6 (small blind) folded on the Turn
Seat 9: Fish4trips (big blind) collected ($18.05)





PokerStars Hand #152558592296:  Hold'em No Limit ($0.50/$1.00 USD) - 2016/04/28 14:43:57 CET [2016/04/28 8:43:57 ET]
Table 'Chiny II' 9-max Seat #8 is the button
Seat 1: WDW3 ($160.03 in chips) 
Seat 2: lumen21 ($102.50 in chips) 
Seat 3: Dantist1122 ($103.65 in chips) 
Seat 4: ozone2003 ($100 in chips) 
Seat 5: matiko09 ($100 in chips) 
Seat 6: St.LaCoste ($100 in chips) 
Seat 7: guoweiAA ($73.72 in chips) 
Seat 8: ruslik_by ($42.13 in chips) 
Seat 9: luckytigerok ($50.26 in chips) 
luckytigerok: posts small blind $0.50
WDW3: posts big blind $1
*** HOLE CARDS ***
Dealt to matiko09 [3s 9c]
lumen21: folds 
Dantist1122: folds 
ozone2003: folds 
matiko09: folds 
St.LaCoste: folds 
guoweiAA: folds 
ruslik_by: raises $1 to $2
luckytigerok: folds 
WDW3: folds 
Uncalled bet ($1) returned to ruslik_by
ruslik_by collected $2.50 from pot
ruslik_by: doesn't show hand 
*** SUMMARY ***
Total pot $2.50 | Rake $0 
Seat 1: WDW3 (big blind) folded before Flop
Seat 2: lumen21 folded before Flop (didn't bet)
Seat 3: Dantist1122 folded before Flop (didn't bet)
Seat 4: ozone2003 folded before Flop (didn't bet)
Seat 5: matiko09 folded before Flop (didn't bet)
Seat 6: St.LaCoste folded before Flop (didn't bet)
Seat 7: guoweiAA folded before Flop (didn't bet)
Seat 8: ruslik_by (button) collected ($2.50)
Seat 9: luckytigerok (small blind) folded before Flop





PokerStars Hand #152558596006:  Hold'em No Limit ($0.50/$1.00 USD) - 2016/04/28 14:44:04 CET [2016/04/28 8:44:04 ET]
Table 'Azimech' 9-max Seat #8 is the button
Seat 1: peevoajax ($101.70 in chips) 
Seat 2: adikier ($233.07 in chips) 
Seat 3: matiko09 ($100 in chips) 
Seat 4: ruslik_by ($81.40 in chips) 
Seat 5: ozone2003 ($110.88 in chips) 
Seat 7: azzad2007 ($100 in chips) 
Seat 8: vrnMike ($100 in chips) 
Seat 9: scottinsf ($65.40 in chips) 
scottinsf: posts small blind $0.50
peevoajax: posts big blind $1
sanpidk: sits out 
*** HOLE CARDS ***
Dealt to matiko09 [Th 4s]
adikier: folds 
matiko09: folds 
ruslik_by: folds 
ozone2003: folds 
azzad2007: raises $1.50 to $2.50
vrnMike: folds 
scottinsf: calls $2
peevoajax: folds 
*** FLOP *** [Kd 9h 9s]
scottinsf: checks 
azzad2007: bets $1.59
scottinsf: folds 
Uncalled bet ($1.59) returned to azzad2007
azzad2007 collected $5.70 from pot
azzad2007: doesn't show hand 
*** SUMMARY ***
Total pot $6 | Rake $0.30 
Board [Kd 9h 9s]
Seat 1: peevoajax (big blind) folded before Flop
Seat 2: adikier folded before Flop (didn't bet)
Seat 3: matiko09 folded before Flop (didn't bet)
Seat 4: ruslik_by folded before Flop (didn't bet)
Seat 5: ozone2003 folded before Flop (didn't bet)
Seat 7: azzad2007 collected ($5.70)
Seat 8: vrnMike (button) folded before Flop (didn't bet)
Seat 9: scottinsf (small blind) folded on the Flop





PokerStars Hand #152558597676:  Hold'em No Limit (€0.50/€1.00 EUR) - 2016/04/28 14:44:07 CET [2016/04/28 8:44:07 ET]
Table 'Lumiere II' 9-max Seat #5 is the button
Seat 1: vrnMike (€100 in chips) 
Seat 2: Racushniak (€101.50 in chips) 
Seat 3: ozone2003 (€104.73 in chips) 
Seat 4: ruslik_by (€49.92 in chips) 
Seat 5: Schmidy7 (€37.50 in chips) 
Seat 6: HasBigBiceps (€100.50 in chips) 
Seat 7: hammerwife (€108.12 in chips) 
Seat 8: WDW3 (€103 in chips) 
Seat 9: matiko09 (€100 in chips) 
HasBigBiceps: posts small blind €0.50
hammerwife: posts big blind €1
*** HOLE CARDS ***
Dealt to matiko09 [9d Kc]
WDW3: raises €1.80 to €2.80
matiko09: folds 
vrnMike: folds 
Racushniak: folds 
ozone2003: folds 
ruslik_by: folds 
Schmidy7: folds 
HasBigBiceps: folds 
hammerwife: folds 
Uncalled bet (€1.80) returned to WDW3
WDW3 collected €2.50 from pot
WDW3: doesn't show hand 
*** SUMMARY ***
Total pot €2.50 | Rake €0 
Seat 1: vrnMike folded before Flop (didn't bet)
Seat 2: Racushniak folded before Flop (didn't bet)
Seat 3: ozone2003 folded before Flop (didn't bet)
Seat 4: ruslik_by folded before Flop (didn't bet)
Seat 5: Schmidy7 (button) folded before Flop (didn't bet)
Seat 6: HasBigBiceps (small blind) folded before Flop
Seat 7: hammerwife (big blind) folded before Flop
Seat 8: WDW3 collected (€2.50)
Seat 9: matiko09 folded before Flop (didn't bet)





PokerStars Hand #152558599836:  Hold'em No Limit ($1/$2 USD) - 2016/04/28 14:44:11 CET [2016/04/28 8:44:11 ET]
Table 'Helio' 9-max Seat #1 is the button
Seat 1: prominente ($297.60 in chips) 
Seat 2: peevoajax ($200 in chips) 
Seat 3: InsomniaRU ($225.45 in chips) 
Seat 4: ersevi6 ($113.66 in chips) 
Seat 5: pretender 19 ($198.77 in chips) 
Seat 6: matiko09 ($203 in chips) 
Seat 8: libbyyww ($207.54 in chips) 
Seat 9: rmanjkeee ($91.75 in chips) 
peevoajax: posts small blind $1
InsomniaRU: posts big blind $2
*** HOLE CARDS ***
Dealt to matiko09 [Qh 3s]
ersevi6: folds 
pretender 19: raises $2 to $4
matiko09: folds 
libbyyww: folds 
rmanjkeee: folds 
prominente: raises $8 to $12
peevoajax: folds 
InsomniaRU: folds 
pretender 19: calls $8
*** FLOP *** [Td Kd Qc]
pretender 19: checks 
prominente: checks 
*** TURN *** [Td Kd Qc] [6h]
pretender 19: bets $8
prominente: folds 
Uncalled bet ($8) returned to pretender 19
pretender 19 collected $25.65 from pot
pretender 19: doesn't show hand 
*** SUMMARY ***
Total pot $27 | Rake $1.35 
Board [Td Kd Qc 6h]
Seat 1: prominente (button) folded on the Turn
Seat 2: peevoajax (small blind) folded before Flop
Seat 3: InsomniaRU (big blind) folded before Flop
Seat 4: ersevi6 folded before Flop (didn't bet)
Seat 5: pretender 19 collected ($25.65)
Seat 6: matiko09 folded before Flop (didn't bet)
Seat 8: libbyyww folded before Flop (didn't bet)
Seat 9: rmanjkeee folded before Flop (didn't bet)





PokerStars Hand #152558602574:  Hold'em No Limit (€0.50/€1.00 EUR) - 2016/04/28 14:44:16 CET [2016/04/28 8:44:16 ET]
Table 'Clivia II' 9-max Seat #5 is the button
Seat 1: piperkova (€46.33 in chips) 
Seat 2: HasBigBiceps (€100 in chips) 
Seat 3: R1aki (€114.66 in chips) 
Seat 4: matiko09 (€100 in chips) 
Seat 5: WDW3 (€123 in chips) 
Seat 6: ruslik_by (€45.55 in chips) 
Seat 7: St.LaCoste (€101.50 in chips) 
Seat 8: Dantist1122 (€100 in chips) 
Seat 9: ozone2003 (€101.50 in chips) 
ruslik_by: posts small blind €0.50
St.LaCoste: posts big blind €1
*** HOLE CARDS ***
Dealt to matiko09 [4d 5h]
Dantist1122: folds 
ozone2003: folds 
piperkova: calls €1
HasBigBiceps: folds 
R1aki: folds 
matiko09: folds 
WDW3: folds 
ruslik_by: calls €0.50
St.LaCoste: checks 
*** FLOP *** [As 8s 9h]
ruslik_by: bets €1
St.LaCoste: folds 
piperkova: calls €1
*** TURN *** [As 8s 9h] [Jh]
ruslik_by: bets €2
piperkova: calls €2
*** RIVER *** [As 8s 9h Jh] [Qd]
ruslik_by: checks 
piperkova: bets €1
ruslik_by: folds 
Uncalled bet (€1) returned to piperkova
piperkova collected €8.55 from pot
piperkova: doesn't show hand 
*** SUMMARY ***
Total pot €9 | Rake €0.45 
Board [As 8s 9h Jh Qd]
Seat 1: piperkova collected (€8.55)
Seat 2: HasBigBiceps folded before Flop (didn't bet)
Seat 3: R1aki folded before Flop (didn't bet)
Seat 4: matiko09 folded before Flop (didn't bet)
Seat 5: WDW3 (button) folded before Flop (didn't bet)
Seat 6: ruslik_by (small blind) folded on the River
Seat 7: St.LaCoste (big blind) folded on the Flop
Seat 8: Dantist1122 folded before Flop (didn't bet)
Seat 9: ozone2003 folded before Flop (didn't bet)





PokerStars Hand #152558608356:  Hold'em No Limit ($1/$2 USD) - 2016/04/28 14:44:26 CET [2016/04/28 8:44:26 ET]
Table 'Mireille' 9-max Seat #2 is the button
Seat 1: NamesLefTy ($129.90 in chips) 
Seat 2: matiko09 ($200 in chips) 
Seat 3: MZ2502 ($214.65 in chips) 
Seat 4: Fish4trips ($200 in chips) 
Seat 5: SoNe1988 ($145.35 in chips) 
Seat 7: aseban11 ($274.16 in chips) 
Seat 8: KDJAll3 ($923.68 in chips) 
Seat 9: a-talash ($155.30 in chips) 
MZ2502: posts small blind $1
Fish4trips: posts big blind $2
Yaaaazz: sits out 
*** HOLE CARDS ***
Dealt to matiko09 [6c 6h]
SoNe1988: folds 
aseban11: folds 
KDJAll3: raises $2 to $4
a-talash: folds 
NamesLefTy has timed out while disconnected
NamesLefTy: folds 
matiko09: calls $4
MZ2502: folds 
Fish4trips: folds 
*** FLOP *** [8c 7h 6d]
KDJAll3: checks 
matiko09: bets $6.79
KDJAll3: folds 
Uncalled bet ($6.79) returned to matiko09
matiko09 collected $10.45 from pot
matiko09: doesn't show hand 
*** SUMMARY ***
Total pot $11 | Rake $0.55 
Board [8c 7h 6d]
Seat 1: NamesLefTy folded before Flop (didn't bet)
Seat 2: matiko09 (button) collected ($10.45)
Seat 3: MZ2502 (small blind) folded before Flop
Seat 4: Fish4trips (big blind) folded before Flop
Seat 5: SoNe1988 folded before Flop (didn't bet)
Seat 7: aseban11 folded before Flop (didn't bet)
Seat 8: KDJAll3 folded on the Flop
Seat 9: a-talash folded before Flop (didn't bet)





PokerStars Hand #152558611404:  Hold'em No Limit ($0.50/$1.00 USD) - 2016/04/28 14:44:32 CET [2016/04/28 8:44:32 ET]
Table 'Lyot' 9-max Seat #1 is the button
Seat 1: matiko09 ($115.71 in chips) 
Seat 2: vrnMike ($115.06 in chips) 
Seat 4: WDW3 ($103.14 in chips) 
Seat 5: di0d80 ($100 in chips) 
Seat 6: Monglaer ($101.27 in chips) 
Seat 7: PreMoze ($96.31 in chips) 
Seat 8: Patz B ($36.85 in chips) 
Seat 9: koksskrt ($100 in chips) 
vrnMike: posts small blind $0.50
aseban11: is sitting out 
WDW3: posts big blind $1
matiko09: posts the ante $0.20
vrnMike: posts the ante $0.20
WDW3: posts the ante $0.20
di0d80: posts the ante $0.20
Monglaer: posts the ante $0.20
PreMoze: posts the ante $0.20
Patz B: posts the ante $0.20
koksskrt: posts the ante $0.20
*** HOLE CARDS ***
Dealt to matiko09 [4h Kc]
di0d80: folds 
Monglaer: folds 
PreMoze: calls $1
Patz B: folds 
koksskrt: folds 
matiko09: folds 
vrnMike: calls $0.50
WDW3: checks 
*** FLOP *** [2h 7c Js]
vrnMike: checks 
WDW3: checks 
PreMoze: checks 
*** TURN *** [2h 7c Js] [9s]
vrnMike: bets $3
WDW3: folds 
PreMoze: calls $3
*** RIVER *** [2h 7c Js 9s] [8s]
vrnMike: checks 
PreMoze: bets $15
vrnMike: calls $15
*** SHOW DOWN ***
PreMoze: shows [3c 3h] (a pair of Threes)
vrnMike: shows [Jh Ts] (a straight, Seven to Jack)
vrnMike collected $38.57 from pot
*** SUMMARY ***
Total pot $40.60 | Rake $2.03 
Board [2h 7c Js 9s 8s]
Seat 1: matiko09 (button) folded before Flop (didn't bet)
Seat 2: vrnMike (small blind) showed [Jh Ts] and won ($38.57) with a straight, Seven to Jack
Seat 4: WDW3 (big blind) folded on the Turn
Seat 5: di0d80 folded before Flop (didn't bet)
Seat 6: Monglaer folded before Flop (didn't bet)
Seat 7: PreMoze showed [3c 3h] and lost with a pair of Threes
Seat 8: Patz B folded before Flop (didn't bet)
Seat 9: koksskrt folded before Flop (didn't bet)





PokerStars Hand #152558613732:  Hold'em No Limit ($0.50/$1.00 USD) - 2016/04/28 14:44:36 CET [2016/04/28 8:44:36 ET]
Table 'Chiny II' 9-max Seat #9 is the button
Seat 1: WDW3 ($159.03 in chips) 
Seat 2: lumen21 ($102.50 in chips) 
Seat 3: Dantist1122 ($103.65 in chips) 
Seat 4: ozone2003 ($100 in chips) 
Seat 5: matiko09 ($100 in chips) 
Seat 6: St.LaCoste ($100 in chips) 
Seat 7: guoweiAA ($73.72 in chips) 
Seat 8: ruslik_by ($43.63 in chips) 
Seat 9: luckytigerok ($49.76 in chips) 
WDW3: posts small blind $0.50
lumen21: posts big blind $1
*** HOLE CARDS ***
Dealt to matiko09 [Td Ac]
Dantist1122: folds 
ozone2003: folds 
matiko09: folds 
St.LaCoste: folds 
guoweiAA: folds 
ruslik_by: raises $1.50 to $2.50
luckytigerok: folds 
WDW3: folds 
lumen21: folds 
Uncalled bet ($1.50) returned to ruslik_by
ruslik_by collected $2.50 from pot
ruslik_by: doesn't show hand 
*** SUMMARY ***
Total pot $2.50 | Rake $0 
Seat 1: WDW3 (small blind) folded before Flop
Seat 2: lumen21 (big blind) folded before Flop
Seat 3: Dantist1122 folded before Flop (didn't bet)
Seat 4: ozone2003 folded before Flop (didn't bet)
Seat 5: matiko09 folded before Flop (didn't bet)
Seat 6: St.LaCoste folded before Flop (didn't bet)
Seat 7: guoweiAA folded before Flop (didn't bet)
Seat 8: ruslik_by collected ($2.50)
Seat 9: luckytigerok (button) folded before Flop (didn't bet)





PokerStars Hand #152558617013:  Hold'em No Limit ($1/$2 USD) - 2016/04/28 14:44:42 CET [2016/04/28 8:44:42 ET]
Table 'Libera II' 9-max Seat #7 is the button
Seat 1: libbyyww ($203 in chips) 
Seat 2: peevoajax ($216.35 in chips) 
Seat 3: maverick7614 ($249.68 in chips) 
Seat 4: Sly-Hustler ($90.80 in chips) 
Seat 5: ersevi6 ($138.30 in chips) 
Seat 6: matiko09 ($200 in chips) 
Seat 7: Fish4trips ($200 in chips) 
Seat 8: WDW3 ($200.89 in chips) 
Seat 9: InsomniaRU ($227 in chips) 
WDW3: posts small blind $1
InsomniaRU: posts big blind $2
*** HOLE CARDS ***
Dealt to matiko09 [4s Js]
libbyyww: folds 
peevoajax: folds 
maverick7614: folds 
Sly-Hustler: folds 
ersevi6: folds 
matiko09: folds 
Fish4trips: raises $2 to $4
WDW3: raises $12 to $16
InsomniaRU: folds 
Fish4trips: folds 
Uncalled bet ($12) returned to WDW3
WDW3 collected $10 from pot
WDW3: doesn't show hand 
*** SUMMARY ***
Total pot $10 | Rake $0 
Seat 1: libbyyww folded before Flop (didn't bet)
Seat 2: peevoajax folded before Flop (didn't bet)
Seat 3: maverick7614 folded before Flop (didn't bet)
Seat 4: Sly-Hustler folded before Flop (didn't bet)
Seat 5: ersevi6 folded before Flop (didn't bet)
Seat 6: matiko09 folded before Flop (didn't bet)
Seat 7: Fish4trips (button) folded before Flop
Seat 8: WDW3 (small blind) collected ($10)
Seat 9: InsomniaRU (big blind) folded before Flop





PokerStars Hand #152558619259:  Hold'em No Limit ($0.50/$1.00 USD) - 2016/04/28 14:44:46 CET [2016/04/28 8:44:46 ET]
Table 'Bruwer' 9-max Seat #8 is the button
Seat 2: ruslik_by ($40 in chips) 
Seat 3: koksskrt ($112.61 in chips) 
Seat 4: matiko09 ($144.04 in chips) 
Seat 5: Carloszhang ($133.78 in chips) 
Seat 6: I The King I ($109.52 in chips) 
Seat 7: R1aki ($248.58 in chips) 
Seat 8: WDW3 ($100 in chips) 
Seat 9: Dantist1122 ($124.91 in chips) 
Dantist1122: posts small blind $0.50
aseban11: is sitting out 
ruslik_by: posts big blind $1
*** HOLE CARDS ***
Dealt to matiko09 [5c Qd]
koksskrt: folds 
matiko09: folds 
Carloszhang: raises $1 to $2
I The King I: folds 
R1aki: folds 
WDW3: calls $2
Dantist1122: folds 
ruslik_by: folds 
*** FLOP *** [Ah Tc 3s]
Carloszhang: bets $3
WDW3: calls $3
*** TURN *** [Ah Tc 3s] [8c]
Carloszhang: checks 
WDW3: checks 
*** RIVER *** [Ah Tc 3s 8c] [7d]
Carloszhang: checks 
WDW3: bets $4
Carloszhang: calls $4
*** SHOW DOWN ***
WDW3: shows [9d Ad] (a pair of Aces)
Carloszhang: mucks hand 
WDW3 collected $18.52 from pot
*** SUMMARY ***
Total pot $19.50 | Rake $0.98 
Board [Ah Tc 3s 8c 7d]
Seat 2: ruslik_by (big blind) folded before Flop
Seat 3: koksskrt folded before Flop (didn't bet)
Seat 4: matiko09 folded before Flop (didn't bet)
Seat 5: Carloszhang mucked [Kh Th]
Seat 6: I The King I folded before Flop (didn't bet)
Seat 7: R1aki folded before Flop (didn't bet)
Seat 8: WDW3 (button) showed [9d Ad] and won ($18.52) with a pair of Aces
Seat 9: Dantist1122 (small blind) folded before Flop





PokerStars Hand #152558623124:  Hold'em No Limit ($0.50/$1.00 USD) - 2016/04/28 14:44:53 CET [2016/04/28 8:44:53 ET]
Table 'Azimech' 9-max Seat #9 is the button
Seat 1: peevoajax ($100.70 in chips) 
Seat 2: adikier ($233.07 in chips) 
Seat 3: matiko09 ($100 in chips) 
Seat 4: ruslik_by ($81.40 in chips) 
Seat 5: ozone2003 ($110.88 in chips) 
Seat 7: azzad2007 ($103.20 in chips) 
Seat 8: vrnMike ($100 in chips) 
Seat 9: scottinsf ($62.90 in chips) 
peevoajax: posts small blind $0.50
adikier: posts big blind $1
sanpidk: sits out 
*** HOLE CARDS ***
Dealt to matiko09 [3s As]
matiko09: folds 
ruslik_by: folds 
ozone2003: folds 
azzad2007: folds 
vrnMike: raises $1 to $2
scottinsf: folds 
peevoajax: folds 
adikier: calls $1
*** FLOP *** [Qs 9d Th]
adikier: bets $2.14
vrnMike: folds 
Uncalled bet ($2.14) returned to adikier
adikier collected $4.28 from pot
adikier: doesn't show hand 
*** SUMMARY ***
Total pot $4.50 | Rake $0.22 
Board [Qs 9d Th]
Seat 1: peevoajax (small blind) folded before Flop
Seat 2: adikier (big blind) collected ($4.28)
Seat 3: matiko09 folded before Flop (didn't bet)
Seat 4: ruslik_by folded before Flop (didn't bet)
Seat 5: ozone2003 folded before Flop (didn't bet)
Seat 7: azzad2007 folded before Flop (didn't bet)
Seat 8: vrnMike folded on the Flop
Seat 9: scottinsf (button) folded before Flop (didn't bet)





PokerStars Hand #152558626890:  Hold'em No Limit ($1/$2 USD) - 2016/04/28 14:45:00 CET [2016/04/28 8:45:00 ET]
Table 'Helio' 9-max Seat #2 is the button
Seat 1: prominente ($285.60 in chips) 
Seat 2: peevoajax ($200 in chips) 
Seat 3: InsomniaRU ($223.45 in chips) 
Seat 4: ersevi6 ($113.66 in chips) 
Seat 5: pretender 19 ($212.42 in chips) 
Seat 6: matiko09 ($203 in chips) 
Seat 8: libbyyww ($207.54 in chips) 
Seat 9: rmanjkeee ($91.75 in chips) 
InsomniaRU: posts small blind $1
ersevi6: posts big blind $2
*** HOLE CARDS ***
Dealt to matiko09 [Jc 8s]
pretender 19: folds 
matiko09: folds 
libbyyww: folds 
rmanjkeee: folds 
prominente: folds 
peevoajax: raises $4 to $6
InsomniaRU: folds 
ersevi6: folds 
Uncalled bet ($4) returned to peevoajax
peevoajax collected $5 from pot
peevoajax: doesn't show hand 
*** SUMMARY ***
Total pot $5 | Rake $0 
Seat 1: prominente folded before Flop (didn't bet)
Seat 2: peevoajax (button) collected ($5)
Seat 3: InsomniaRU (small blind) folded before Flop
Seat 4: ersevi6 (big blind) folded before Flop
Seat 5: pretender 19 folded before Flop (didn't bet)
Seat 6: matiko09 folded before Flop (didn't bet)
Seat 8: libbyyww folded before Flop (didn't bet)
Seat 9: rmanjkeee folded before Flop (didn't bet)





PokerStars Hand #152558633218:  Hold'em No Limit ($0.50/$1.00 USD) - 2016/04/28 14:45:11 CET [2016/04/28 8:45:11 ET]
Table 'Paris' 9-max Seat #8 is the button
Seat 1: matiko09 ($155.47 in chips) 
Seat 2: birdie1970 ($217.10 in chips) 
Seat 3: Patz B ($38.50 in chips) 
Seat 4: koksskrt ($101.50 in chips) 
Seat 6: aseban11 ($100 in chips) 
Seat 7: Westpants ($127.22 in chips) 
Seat 8: Muric05 ($59.01 in chips) 
Seat 9: ruslik_by ($40.50 in chips) 
ruslik_by: posts small blind $0.50
matiko09: posts big blind $1
*** HOLE CARDS ***
Dealt to matiko09 [7s 4s]
birdie1970: folds 
Patz B: raises $4 to $5
koksskrt: folds 
aseban11: raises $8.50 to $13.50
Westpants: folds 
Muric05: folds 
ruslik_by: folds 
matiko09: folds 
Patz B: calls $8.50
*** FLOP *** [Jc Th Ts]
Patz B: bets $12
aseban11: raises $38.31 to $50.31
Patz B: calls $13 and is all-in
Uncalled bet ($25.31) returned to aseban11
*** TURN *** [Jc Th Ts] [As]
*** RIVER *** [Jc Th Ts As] [3h]
*** SHOW DOWN ***
Patz B: shows [5h 5s] (two pair, Tens and Fives)
aseban11: shows [Ad Kh] (two pair, Aces and Tens)
aseban11 collected $76 from pot
*** SUMMARY ***
Total pot $78.50 | Rake $2.50 
Board [Jc Th Ts As 3h]
Seat 1: matiko09 (big blind) folded before Flop
Seat 2: birdie1970 folded before Flop (didn't bet)
Seat 3: Patz B showed [5h 5s] and lost with two pair, Tens and Fives
Seat 4: koksskrt folded before Flop (didn't bet)
Seat 6: aseban11 showed [Ad Kh] and won ($76) with two pair, Aces and Tens
Seat 7: Westpants folded before Flop (didn't bet)
Seat 8: Muric05 (button) folded before Flop (didn't bet)
Seat 9: ruslik_by (small blind) folded before Flop





PokerStars Hand #152558634862:  Hold'em No Limit ($1/$2 USD) - 2016/04/28 14:45:14 CET [2016/04/28 8:45:14 ET]
Table 'Simonida II' 9-max Seat #5 is the button
Seat 1: 13Ghosts ($203 in chips) 
Seat 2: snow937022 ($226.58 in chips) 
Seat 3: WDW3 ($207.05 in chips) 
Seat 4: a-talash ($168.92 in chips) 
Seat 5: matiko09 ($200 in chips) 
Seat 6: ocarey86 ($152.47 in chips) 
Seat 7: Fish4trips ($203.73 in chips) 
Seat 8: Sutt_420 ($122.49 in chips) 
Seat 9: prominente ($206 in chips) 
ocarey86: posts small blind $1
Fish4trips: posts big blind $2
*** HOLE CARDS ***
Dealt to matiko09 [Kd Td]
Sutt_420: folds 
prominente: folds 
13Ghosts: folds 
snow937022: folds 
WDW3: folds 
a-talash: folds 
matiko09: raises $2.54 to $4.54
ocarey86: folds 
Fish4trips: folds 
Uncalled bet ($2.54) returned to matiko09
matiko09 collected $5 from pot
matiko09: doesn't show hand 
*** SUMMARY ***
Total pot $5 | Rake $0 
Seat 1: 13Ghosts folded before Flop (didn't bet)
Seat 2: snow937022 folded before Flop (didn't bet)
Seat 3: WDW3 folded before Flop (didn't bet)
Seat 4: a-talash folded before Flop (didn't bet)
Seat 5: matiko09 (button) collected ($5)
Seat 6: ocarey86 (small blind) folded before Flop
Seat 7: Fish4trips (big blind) folded before Flop
Seat 8: Sutt_420 folded before Flop (didn't bet)
Seat 9: prominente folded before Flop (didn't bet)





PokerStars Hand #152558634875:  Hold'em No Limit ($1/$2 USD) - 2016/04/28 14:45:14 CET [2016/04/28 8:45:14 ET]
Table 'Idomeneus II' 9-max Seat #7 is the button
Seat 1: 13Ghosts ($214.22 in chips) 
Seat 2: libbyyww ($304.54 in chips) 
Seat 3: adrenalin333 ($182.37 in chips) 
Seat 4: SoNe1988 ($81.48 in chips) 
Seat 5: matiko09 ($211.36 in chips) 
Seat 7: ersevi6 ($156.61 in chips) 
Seat 9: Fish4trips ($208.68 in chips) 
Fish4trips: posts small blind $1
13Ghosts: posts big blind $2
*** HOLE CARDS ***
Dealt to matiko09 [2s Kd]
libbyyww: folds 
adrenalin333: raises $4 to $6
SoNe1988: raises $10 to $16
matiko09: folds 
ersevi6: folds 
Fish4trips: folds 
13Ghosts: folds 
adrenalin333: folds 
Uncalled bet ($10) returned to SoNe1988
SoNe1988 collected $15 from pot
SoNe1988: doesn't show hand 
*** SUMMARY ***
Total pot $15 | Rake $0 
Seat 1: 13Ghosts (big blind) folded before Flop
Seat 2: libbyyww folded before Flop (didn't bet)
Seat 3: adrenalin333 folded before Flop
Seat 4: SoNe1988 collected ($15)
Seat 5: matiko09 folded before Flop (didn't bet)
Seat 7: ersevi6 (button) folded before Flop (didn't bet)
Seat 9: Fish4trips (small blind) folded before Flop





PokerStars Hand #152558636034:  Hold'em No Limit (€0.50/€1.00 EUR) - 2016/04/28 14:45:16 CET [2016/04/28 8:45:16 ET]
Table 'Lumiere II' 9-max Seat #6 is the button
Seat 1: vrnMike (€100 in chips) 
Seat 2: Racushniak (€101.50 in chips) 
Seat 3: ozone2003 (€104.73 in chips) 
Seat 4: ruslik_by (€49.92 in chips) 
Seat 5: Schmidy7 (€37.50 in chips) 
Seat 6: HasBigBiceps (€100 in chips) 
Seat 7: hammerwife (€107.12 in chips) 
Seat 8: WDW3 (€104.50 in chips) 
Seat 9: matiko09 (€100 in chips) 
hammerwife: posts small blind €0.50
WDW3: posts big blind €1
*** HOLE CARDS ***
Dealt to matiko09 [Qd Th]
matiko09: folds 
vrnMike: folds 
Racushniak: folds 
ozone2003: folds 
ruslik_by: folds 
Schmidy7: raises €1 to €2
HasBigBiceps: folds 
hammerwife: folds 
WDW3: folds 
Uncalled bet (€1) returned to Schmidy7
Schmidy7 collected €2.50 from pot
*** SUMMARY ***
Total pot €2.50 | Rake €0 
Seat 1: vrnMike folded before Flop (didn't bet)
Seat 2: Racushniak folded before Flop (didn't bet)
Seat 3: ozone2003 folded before Flop (didn't bet)
Seat 4: ruslik_by folded before Flop (didn't bet)
Seat 5: Schmidy7 collected (€2.50)
Seat 6: HasBigBiceps (button) folded before Flop (didn't bet)
Seat 7: hammerwife (small blind) folded before Flop
Seat 8: WDW3 (big blind) folded before Flop
Seat 9: matiko09 folded before Flop (didn't bet)





PokerStars Hand #152558638096:  Hold'em No Limit ($0.50/$1.00 USD) - 2016/04/28 14:45:20 CET [2016/04/28 8:45:20 ET]
Table 'Erynia' 9-max Seat #8 is the button
Seat 2: matiko09 ($158.80 in chips) 
Seat 3: aseban11 ($115.04 in chips) 
Seat 4: WDW3 ($128.62 in chips) 
Seat 5: scottinsf ($51.49 in chips) 
Seat 7: vrnMike ($101.98 in chips) 
Seat 8: YourKicker78 ($23.73 in chips) 
Seat 9: ruslik_by ($95.58 in chips) 
ruslik_by: posts small blind $0.50
matiko09: posts big blind $1
peevoajax: sits out 
*** HOLE CARDS ***
Dealt to matiko09 [8d 6d]
aseban11: folds 
WDW3: folds 
scottinsf: folds 
vrnMike: folds 
YourKicker78: raises $2 to $3
ruslik_by: raises $6 to $9
matiko09: folds 
YourKicker78: raises $14.73 to $23.73 and is all-in
ruslik_by: calls $14.73
*** FLOP *** [8c Kd Ac]
*** TURN *** [8c Kd Ac] [Jd]
*** RIVER *** [8c Kd Ac Jd] [Kc]
*** SHOW DOWN ***
ruslik_by: shows [Ks Qs] (three of a kind, Kings)
YourKicker78: shows [Ad Kh] (a full house, Kings full of Aces)
YourKicker78 collected $46.04 from pot
*** SUMMARY ***
Total pot $48.46 | Rake $2.42 
Board [8c Kd Ac Jd Kc]
Seat 2: matiko09 (big blind) folded before Flop
Seat 3: aseban11 folded before Flop (didn't bet)
Seat 4: WDW3 folded before Flop (didn't bet)
Seat 5: scottinsf folded before Flop (didn't bet)
Seat 7: vrnMike folded before Flop (didn't bet)
Seat 8: YourKicker78 (button) showed [Ad Kh] and won ($46.04) with a full house, Kings full of Aces
Seat 9: ruslik_by (small blind) showed [Ks Qs] and lost with three of a kind, Kings





PokerStars Hand #152558639539:  Hold'em No Limit ($1/$2 USD) - 2016/04/28 14:45:22 CET [2016/04/28 8:45:22 ET]
Table 'Helio' 9-max Seat #3 is the button
Seat 1: prominente ($285.60 in chips) 
Seat 2: peevoajax ($203 in chips) 
Seat 3: InsomniaRU ($222.45 in chips) 
Seat 4: ersevi6 ($111.66 in chips) 
Seat 5: pretender 19 ($212.42 in chips) 
Seat 6: matiko09 ($203 in chips) 
Seat 8: libbyyww ($207.54 in chips) 
Seat 9: rmanjkeee ($91.75 in chips) 
ersevi6: posts small blind $1
pretender 19: posts big blind $2
*** HOLE CARDS ***
Dealt to matiko09 [9c 2d]
matiko09: folds 
libbyyww: folds 
rmanjkeee: folds 
prominente: folds 
peevoajax: folds 
InsomniaRU: folds 
ersevi6: raises $3 to $5
pretender 19: raises $3 to $8
ersevi6: calls $3
*** FLOP *** [9d Td 7d]
ersevi6: checks 
pretender 19: bets $12
ersevi6: calls $12
*** TURN *** [9d Td 7d] [2h]
ersevi6: checks 
pretender 19: checks 
*** RIVER *** [9d Td 7d 2h] [Ts]
ersevi6: bets $23.22
pretender 19: folds 
Uncalled bet ($23.22) returned to ersevi6
ersevi6 collected $38 from pot
ersevi6: doesn't show hand 
*** SUMMARY ***
Total pot $40 | Rake $2 
Board [9d Td 7d 2h Ts]
Seat 1: prominente folded before Flop (didn't bet)
Seat 2: peevoajax folded before Flop (didn't bet)
Seat 3: InsomniaRU (button) folded before Flop (didn't bet)
Seat 4: ersevi6 (small blind) collected ($38)
Seat 5: pretender 19 (big blind) folded on the River
Seat 6: matiko09 folded before Flop (didn't bet)
Seat 8: libbyyww folded before Flop (didn't bet)
Seat 9: rmanjkeee folded before Flop (didn't bet)





PokerStars Hand #152558641061:  Hold'em No Limit ($0.50/$1.00 USD) - 2016/04/28 14:45:25 CET [2016/04/28 8:45:25 ET]
Table 'Chiny II' 9-max Seat #1 is the button
Seat 1: WDW3 ($158.53 in chips) 
Seat 2: lumen21 ($101.50 in chips) 
Seat 3: Dantist1122 ($103.65 in chips) 
Seat 4: ozone2003 ($100 in chips) 
Seat 5: matiko09 ($100 in chips) 
Seat 6: St.LaCoste ($100 in chips) 
Seat 7: guoweiAA ($73.72 in chips) 
Seat 8: ruslik_by ($45.13 in chips) 
Seat 9: luckytigerok ($49.76 in chips) 
lumen21: posts small blind $0.50
Dantist1122: posts big blind $1
*** HOLE CARDS ***
Dealt to matiko09 [Jc 4h]
ozone2003: folds 
matiko09: folds 
St.LaCoste: raises $2 to $3
guoweiAA: calls $3
ruslik_by: folds 
luckytigerok is disconnected 
luckytigerok has timed out while disconnected
luckytigerok: folds 
WDW3: folds 
lumen21: folds 
Dantist1122: folds 
*** FLOP *** [9c 3h Jh]
St.LaCoste: checks 
guoweiAA: bets $7.12
St.LaCoste: calls $7.12
*** TURN *** [9c 3h Jh] [Th]
St.LaCoste: checks 
guoweiAA: bets $20.65
St.LaCoste: folds 
Uncalled bet ($20.65) returned to guoweiAA
guoweiAA collected $20.65 from pot
guoweiAA: doesn't show hand 
*** SUMMARY ***
Total pot $21.74 | Rake $1.09 
Board [9c 3h Jh Th]
Seat 1: WDW3 (button) folded before Flop (didn't bet)
Seat 2: lumen21 (small blind) folded before Flop
Seat 3: Dantist1122 (big blind) folded before Flop
Seat 4: ozone2003 folded before Flop (didn't bet)
Seat 5: matiko09 folded before Flop (didn't bet)
Seat 6: St.LaCoste folded on the Turn
Seat 7: guoweiAA collected ($20.65)
Seat 8: ruslik_by folded before Flop (didn't bet)
Seat 9: luckytigerok folded before Flop (didn't bet)





PokerStars Hand #152558641304:  Hold'em No Limit ($1/$2 USD) - 2016/04/28 14:45:26 CET [2016/04/28 8:45:26 ET]
Table 'Mireille' 9-max Seat #3 is the button
Seat 2: matiko09 ($206.45 in chips) 
Seat 3: MZ2502 ($213.65 in chips) 
Seat 4: Fish4trips ($200 in chips) 
Seat 5: SoNe1988 ($145.35 in chips) 
Seat 7: aseban11 ($274.16 in chips) 
Seat 8: KDJAll3 ($919.68 in chips) 
Seat 9: a-talash ($155.30 in chips) 
Fish4trips: posts small blind $1
SoNe1988: posts big blind $2
Yaaaazz: sits out 
*** HOLE CARDS ***
Dealt to matiko09 [Kc Ah]
aseban11: folds 
KDJAll3: folds 
a-talash: folds 
matiko09: raises $3 to $5
MZ2502: folds 
Fish4trips: calls $4
SoNe1988: folds 
*** FLOP *** [Th Ac Jh]
Fish4trips: checks 
matiko09: checks 
*** TURN *** [Th Ac Jh] [3c]
Fish4trips: bets $7.98
matiko09: calls $7.98
*** RIVER *** [Th Ac Jh 3c] [7h]
Fish4trips: bets $18
matiko09: calls $18
*** SHOW DOWN ***
Fish4trips: shows [Ts As] (two pair, Aces and Tens)
matiko09: mucks hand 
Fish4trips collected $61.21 from pot
*** SUMMARY ***
Total pot $63.96 | Rake $2.75 
Board [Th Ac Jh 3c 7h]
Seat 2: matiko09 mucked [Kc Ah]
Seat 3: MZ2502 (button) folded before Flop (didn't bet)
Seat 4: Fish4trips (small blind) showed [Ts As] and won ($61.21) with two pair, Aces and Tens
Seat 5: SoNe1988 (big blind) folded before Flop
Seat 7: aseban11 folded before Flop (didn't bet)
Seat 8: KDJAll3 folded before Flop (didn't bet)
Seat 9: a-talash folded before Flop (didn't bet)





PokerStars Hand #152558645250:  Hold'em No Limit ($0.50/$1.00 USD) - 2016/04/28 14:45:33 CET [2016/04/28 8:45:33 ET]
Table 'Azimech' 9-max Seat #1 is the button
Seat 1: peevoajax ($100.20 in chips) 
Seat 2: adikier ($235.35 in chips) 
Seat 3: matiko09 ($100 in chips) 
Seat 4: ruslik_by ($81.40 in chips) 
Seat 5: ozone2003 ($110.88 in chips) 
Seat 7: azzad2007 ($103.20 in chips) 
Seat 8: vrnMike ($100 in chips) 
Seat 9: scottinsf ($62.90 in chips) 
adikier: posts small blind $0.50
matiko09: posts big blind $1
sanpidk: sits out 
*** HOLE CARDS ***
Dealt to matiko09 [5c 3h]
ruslik_by: folds 
ozone2003: folds 
azzad2007: folds 
vrnMike: folds 
scottinsf: folds 
peevoajax: folds 
adikier: raises $2 to $3
matiko09: folds 
Uncalled bet ($2) returned to adikier
adikier collected $2 from pot
adikier: doesn't show hand 
*** SUMMARY ***
Total pot $2 | Rake $0 
Seat 1: peevoajax (button) folded before Flop (didn't bet)
Seat 2: adikier (small blind) collected ($2)
Seat 3: matiko09 (big blind) folded before Flop
Seat 4: ruslik_by folded before Flop (didn't bet)
Seat 5: ozone2003 folded before Flop (didn't bet)
Seat 7: azzad2007 folded before Flop (didn't bet)
Seat 8: vrnMike folded before Flop (didn't bet)
Seat 9: scottinsf folded before Flop (didn't bet)





PokerStars Hand #152558650550:  Hold'em No Limit (€0.50/€1.00 EUR) - 2016/04/28 14:45:42 CET [2016/04/28 8:45:42 ET]
Table 'Clivia II' 9-max Seat #6 is the button
Seat 1: piperkova (€50.88 in chips) 
Seat 2: HasBigBiceps (€100 in chips) 
Seat 3: R1aki (€114.66 in chips) 
Seat 4: matiko09 (€100 in chips) 
Seat 5: WDW3 (€123 in chips) 
Seat 6: ruslik_by (€41.55 in chips) 
Seat 7: St.LaCoste (€100.50 in chips) 
Seat 8: Dantist1122 (€100 in chips) 
Seat 9: ozone2003 (€101.50 in chips) 
St.LaCoste: posts small blind €0.50
Dantist1122: posts big blind €1
*** HOLE CARDS ***
Dealt to matiko09 [7c 8d]
ozone2003: folds 
piperkova: folds 
HasBigBiceps: folds 
R1aki: raises €1.50 to €2.50
matiko09: folds 
WDW3: folds 
ruslik_by: raises €4 to €6.50
St.LaCoste: folds 
Dantist1122: folds 
R1aki: calls €4
*** FLOP *** [Jh Ks 9d]
R1aki: checks 
ruslik_by: bets €4.50
R1aki: calls €4.50
*** TURN *** [Jh Ks 9d] [Js]
R1aki: checks 
ruslik_by: checks 
*** RIVER *** [Jh Ks 9d Js] [9h]
R1aki: bets €9.50
ruslik_by: raises €21.05 to €30.55 and is all-in
R1aki: folds 
Uncalled bet (€21.05) returned to ruslik_by
ruslik_by collected €40.38 from pot
ruslik_by: doesn't show hand 
*** SUMMARY ***
Total pot €42.50 | Rake €2.12 
Board [Jh Ks 9d Js 9h]
Seat 1: piperkova folded before Flop (didn't bet)
Seat 2: HasBigBiceps folded before Flop (didn't bet)
Seat 3: R1aki folded on the River
Seat 4: matiko09 folded before Flop (didn't bet)
Seat 5: WDW3 folded before Flop (didn't bet)
Seat 6: ruslik_by (button) collected (€40.38)
Seat 7: St.LaCoste (small blind) folded before Flop
Seat 8: Dantist1122 (big blind) folded before Flop
Seat 9: ozone2003 folded before Flop (didn't bet)





PokerStars Hand #152558651491:  Hold'em No Limit ($1/$2 USD) - 2016/04/28 14:45:44 CET [2016/04/28 8:45:44 ET]
Table 'Libera II' 9-max Seat #8 is the button
Seat 1: libbyyww ($203 in chips) 
Seat 2: peevoajax ($216.35 in chips) 
Seat 3: maverick7614 ($249.68 in chips) 
Seat 4: Sly-Hustler ($90.80 in chips) 
Seat 5: ersevi6 ($138.30 in chips) 
Seat 6: matiko09 ($200 in chips) 
Seat 7: Fish4trips ($200 in chips) 
Seat 8: WDW3 ($206.89 in chips) 
Seat 9: InsomniaRU ($225 in chips) 
InsomniaRU: posts small blind $1
libbyyww: posts big blind $2
*** HOLE CARDS ***
Dealt to matiko09 [7h 5s]
peevoajax: folds 
maverick7614: raises $2 to $4
Sly-Hustler: folds 
ersevi6: folds 
matiko09: folds 
Fish4trips: raises $10 to $14
WDW3: folds 
InsomniaRU: folds 
libbyyww: folds 
maverick7614: calls $10
*** FLOP *** [2h 7c Tc]
maverick7614: checks 
Fish4trips: bets $16.90
maverick7614: calls $16.90
*** TURN *** [2h 7c Tc] [5d]
maverick7614: bets $20
Fish4trips: raises $50 to $70
maverick7614: calls $50
*** RIVER *** [2h 7c Tc 5d] [2d]
maverick7614: bets $148.78 and is all-in
Fish4trips: calls $99.10 and is all-in
Uncalled bet ($49.68) returned to maverick7614
*** SHOW DOWN ***
maverick7614: shows [9d Ts] (two pair, Tens and Deuces)
Fish4trips: shows [Qd Qs] (two pair, Queens and Deuces)
Fish4trips collected $400.25 from pot
*** SUMMARY ***
Total pot $403 | Rake $2.75 
Board [2h 7c Tc 5d 2d]
Seat 1: libbyyww (big blind) folded before Flop
Seat 2: peevoajax folded before Flop (didn't bet)
Seat 3: maverick7614 showed [9d Ts] and lost with two pair, Tens and Deuces
Seat 4: Sly-Hustler folded before Flop (didn't bet)
Seat 5: ersevi6 folded before Flop (didn't bet)
Seat 6: matiko09 folded before Flop (didn't bet)
Seat 7: Fish4trips showed [Qd Qs] and won ($400.25) with two pair, Queens and Deuces
Seat 8: WDW3 (button) folded before Flop (didn't bet)
Seat 9: InsomniaRU (small blind) folded before Flop





PokerStars Hand #152558661027:  Hold'em No Limit (€0.50/€1.00 EUR) - 2016/04/28 14:46:01 CET [2016/04/28 8:46:01 ET]
Table 'Lumiere II' 9-max Seat #7 is the button
Seat 1: vrnMike (€100 in chips) 
Seat 2: Racushniak (€101.50 in chips) 
Seat 3: ozone2003 (€104.73 in chips) 
Seat 4: ruslik_by (€49.92 in chips) 
Seat 5: Schmidy7 (€39 in chips) 
Seat 6: HasBigBiceps (€100 in chips) 
Seat 7: hammerwife (€106.62 in chips) 
Seat 8: WDW3 (€103.50 in chips) 
Seat 9: matiko09 (€100 in chips) 
WDW3: posts small blind €0.50
matiko09: posts big blind €1
*** HOLE CARDS ***
Dealt to matiko09 [2h Jh]
vrnMike: folds 
Racushniak: raises €2 to €3
ozone2003: folds 
ruslik_by: folds 
Schmidy7: folds 
HasBigBiceps: folds 
hammerwife: folds 
WDW3: folds 
matiko09: folds 
Uncalled bet (€2) returned to Racushniak
Racushniak collected €2.50 from pot
Racushniak: doesn't show hand 
*** SUMMARY ***
Total pot €2.50 | Rake €0 
Seat 1: vrnMike folded before Flop (didn't bet)
Seat 2: Racushniak collected (€2.50)
Seat 3: ozone2003 folded before Flop (didn't bet)
Seat 4: ruslik_by folded before Flop (didn't bet)
Seat 5: Schmidy7 folded before Flop (didn't bet)
Seat 6: HasBigBiceps folded before Flop (didn't bet)
Seat 7: hammerwife (button) folded before Flop (didn't bet)
Seat 8: WDW3 (small blind) folded before Flop
Seat 9: matiko09 (big blind) folded before Flop





PokerStars Hand #152558662517:  Hold'em No Limit ($1/$2 USD) - 2016/04/28 14:46:04 CET [2016/04/28 8:46:04 ET]
Table 'Simonida II' 9-max Seat #6 is the button
Seat 1: 13Ghosts ($203 in chips) 
Seat 2: snow937022 ($226.58 in chips) 
Seat 3: WDW3 ($207.05 in chips) 
Seat 4: a-talash ($168.92 in chips) 
Seat 5: matiko09 ($203 in chips) 
Seat 6: ocarey86 ($151.47 in chips) 
Seat 7: Fish4trips ($201.73 in chips) 
Seat 8: Sutt_420 ($122.49 in chips) 
Seat 9: prominente ($206 in chips) 
Fish4trips: posts small blind $1
Sutt_420: posts big blind $2
*** HOLE CARDS ***
Dealt to matiko09 [Tc As]
prominente: folds 
13Ghosts: folds 
snow937022: folds 
WDW3: folds 
a-talash: raises $2 to $4
matiko09: folds 
ocarey86: folds 
Fish4trips: folds 
Sutt_420: folds 
Uncalled bet ($2) returned to a-talash
a-talash collected $5 from pot
*** SUMMARY ***
Total pot $5 | Rake $0 
Seat 1: 13Ghosts folded before Flop (didn't bet)
Seat 2: snow937022 folded before Flop (didn't bet)
Seat 3: WDW3 folded before Flop (didn't bet)
Seat 4: a-talash collected ($5)
Seat 5: matiko09 folded before Flop (didn't bet)
Seat 6: ocarey86 (button) folded before Flop (didn't bet)
Seat 7: Fish4trips (small blind) folded before Flop
Seat 8: Sutt_420 (big blind) folded before Flop
Seat 9: prominente folded before Flop (didn't bet)





PokerStars Hand #152558662719:  Hold'em No Limit ($0.50/$1.00 USD) - 2016/04/28 14:46:04 CET [2016/04/28 8:46:04 ET]
Table 'Azimech' 9-max Seat #2 is the button
Seat 1: peevoajax ($100.20 in chips) 
Seat 2: adikier ($236.35 in chips) 
Seat 3: matiko09 ($100 in chips) 
Seat 4: ruslik_by ($81.40 in chips) 
Seat 5: ozone2003 ($110.88 in chips) 
Seat 7: azzad2007 ($103.20 in chips) 
Seat 8: vrnMike ($100 in chips) 
Seat 9: scottinsf ($62.90 in chips) 
matiko09: posts small blind $0.50
ruslik_by: posts big blind $1
sanpidk: sits out 
*** HOLE CARDS ***
Dealt to matiko09 [3h 4d]
ozone2003: folds 
azzad2007: folds 
vrnMike: folds 
scottinsf: folds 
peevoajax: folds 
adikier: folds 
matiko09: folds 
Uncalled bet ($0.50) returned to ruslik_by
ruslik_by collected $1 from pot
ruslik_by: doesn't show hand 
*** SUMMARY ***
Total pot $1 | Rake $0 
Seat 1: peevoajax folded before Flop (didn't bet)
Seat 2: adikier (button) folded before Flop (didn't bet)
Seat 3: matiko09 (small blind) folded before Flop
Seat 4: ruslik_by (big blind) collected ($1)
Seat 5: ozone2003 folded before Flop (didn't bet)
Seat 7: azzad2007 folded before Flop (didn't bet)
Seat 8: vrnMike folded before Flop (didn't bet)
Seat 9: scottinsf folded before Flop (didn't bet)





PokerStars Hand #152558663677:  Hold'em No Limit ($0.50/$1.00 USD) - 2016/04/28 14:46:06 CET [2016/04/28 8:46:06 ET]
Table 'Lyot' 9-max Seat #2 is the button
Seat 1: matiko09 ($115.51 in chips) 
Seat 2: vrnMike ($134.43 in chips) 
Seat 4: WDW3 ($101.94 in chips) 
Seat 6: Monglaer ($101.07 in chips) 
Seat 7: PreMoze ($77.11 in chips) 
Seat 8: Patz B ($36.65 in chips) 
Seat 9: koksskrt ($100 in chips) 
WDW3: posts small blind $0.50
di0d80: is sitting out 
Monglaer: posts big blind $1
matiko09: posts the ante $0.20
vrnMike: posts the ante $0.20
WDW3: posts the ante $0.20
Monglaer: posts the ante $0.20
PreMoze: posts the ante $0.20
Patz B: posts the ante $0.20
koksskrt: posts the ante $0.20
*** HOLE CARDS ***
Dealt to matiko09 [Ts Jd]
PreMoze: calls $1
Patz B: folds 
koksskrt: folds 
vrnMike said, "i knew 33"
matiko09: folds 
vrnMike: raises $2.40 to $3.40
WDW3: folds 
Monglaer: folds 
PreMoze: calls $2.40
*** FLOP *** [3c 2d Qh]
PreMoze: checks 
vrnMike: bets $5
PreMoze: folds 
Uncalled bet ($5) returned to vrnMike
vrnMike collected $9.22 from pot
*** SUMMARY ***
Total pot $9.70 | Rake $0.48 
Board [3c 2d Qh]
Seat 1: matiko09 folded before Flop (didn't bet)
Seat 2: vrnMike (button) collected ($9.22)
Seat 4: WDW3 (small blind) folded before Flop
Seat 6: Monglaer (big blind) folded before Flop
Seat 7: PreMoze folded on the Flop
Seat 8: Patz B folded before Flop (didn't bet)
Seat 9: koksskrt folded before Flop (didn't bet)





PokerStars Hand #152558664605:  Hold'em No Limit ($1/$2 USD) - 2016/04/28 14:46:08 CET [2016/04/28 8:46:08 ET]
Table 'Idomeneus II' 9-max Seat #9 is the button
Seat 1: 13Ghosts ($212.22 in chips) 
Seat 2: libbyyww ($304.54 in chips) 
Seat 3: adrenalin333 ($176.37 in chips) 
Seat 4: SoNe1988 ($90.48 in chips) 
Seat 5: matiko09 ($211.36 in chips) 
Seat 7: ersevi6 ($156.61 in chips) 
Seat 9: Fish4trips ($207.68 in chips) 
13Ghosts: posts small blind $1
libbyyww: posts big blind $2
*** HOLE CARDS ***
Dealt to matiko09 [Kc 9d]
adrenalin333: folds 
SoNe1988: folds 
matiko09: folds 
ersevi6: folds 
Fish4trips: folds 
13Ghosts: raises $2.78 to $4.78
libbyyww: folds 
Uncalled bet ($2.78) returned to 13Ghosts
13Ghosts collected $4 from pot
13Ghosts: doesn't show hand 
*** SUMMARY ***
Total pot $4 | Rake $0 
Seat 1: 13Ghosts (small blind) collected ($4)
Seat 2: libbyyww (big blind) folded before Flop
Seat 3: adrenalin333 folded before Flop (didn't bet)
Seat 4: SoNe1988 folded before Flop (didn't bet)
Seat 5: matiko09 folded before Flop (didn't bet)
Seat 7: ersevi6 folded before Flop (didn't bet)
Seat 9: Fish4trips (button) folded before Flop (didn't bet)





PokerStars Hand #152558666003:  Hold'em No Limit ($0.50/$1.00 USD) - 2016/04/28 14:46:10 CET [2016/04/28 8:46:10 ET]
Table 'Erynia' 9-max Seat #9 is the button
Seat 2: matiko09 ($157.80 in chips) 
Seat 4: WDW3 ($128.62 in chips) 
Seat 5: scottinsf ($51.49 in chips) 
Seat 7: vrnMike ($101.98 in chips) 
Seat 8: YourKicker78 ($46.04 in chips) 
Seat 9: ruslik_by ($71.85 in chips) 
matiko09: posts small blind $0.50
aseban11: is sitting out 
WDW3: posts big blind $1
peevoajax: sits out 
*** HOLE CARDS ***
Dealt to matiko09 [9h Ad]
scottinsf: raises $1 to $2
vrnMike: raises $4 to $6
YourKicker78: folds 
ruslik_by: folds 
matiko09: folds 
WDW3: folds 
scottinsf: calls $4
*** FLOP *** [Jc 4s Ah]
scottinsf: checks 
vrnMike: bets $5
scottinsf: calls $5
*** TURN *** [Jc 4s Ah] [Js]
scottinsf: checks 
vrnMike: checks 
*** RIVER *** [Jc 4s Ah Js] [Kc]
scottinsf: checks 
vrnMike: checks 
*** SHOW DOWN ***
scottinsf: shows [5d 4d] (two pair, Jacks and Fours)
vrnMike: shows [Tc Td] (two pair, Jacks and Tens)
vrnMike collected $22.32 from pot
*** SUMMARY ***
Total pot $23.50 | Rake $1.18 
Board [Jc 4s Ah Js Kc]
Seat 2: matiko09 (small blind) folded before Flop
Seat 4: WDW3 (big blind) folded before Flop
Seat 5: scottinsf showed [5d 4d] and lost with two pair, Jacks and Fours
Seat 7: vrnMike showed [Tc Td] and won ($22.32) with two pair, Jacks and Tens
Seat 8: YourKicker78 folded before Flop (didn't bet)
Seat 9: ruslik_by (button) folded before Flop (didn't bet)





PokerStars Hand #152558669307:  Hold'em No Limit ($0.50/$1.00 USD) - 2016/04/28 14:46:16 CET [2016/04/28 8:46:16 ET]
Table 'Bruwer' 9-max Seat #9 is the button
Seat 2: ruslik_by ($40 in chips) 
Seat 3: koksskrt ($112.61 in chips) 
Seat 4: matiko09 ($144.04 in chips) 
Seat 5: Carloszhang ($124.78 in chips) 
Seat 6: I The King I ($109.52 in chips) 
Seat 7: R1aki ($248.58 in chips) 
Seat 8: WDW3 ($109.52 in chips) 
Seat 9: Dantist1122 ($124.41 in chips) 
ruslik_by: posts small blind $0.50
koksskrt: posts big blind $1
*** HOLE CARDS ***
Dealt to matiko09 [Th 2s]
matiko09: folds 
Carloszhang: folds 
I The King I: raises $2 to $3
R1aki: folds 
WDW3: folds 
Dantist1122: folds 
ruslik_by: folds 
koksskrt: folds 
Uncalled bet ($2) returned to I The King I
I The King I collected $2.50 from pot
I The King I: doesn't show hand 
*** SUMMARY ***
Total pot $2.50 | Rake $0 
Seat 2: ruslik_by (small blind) folded before Flop
Seat 3: koksskrt (big blind) folded before Flop
Seat 4: matiko09 folded before Flop (didn't bet)
Seat 5: Carloszhang folded before Flop (didn't bet)
Seat 6: I The King I collected ($2.50)
Seat 7: R1aki folded before Flop (didn't bet)
Seat 8: WDW3 folded before Flop (didn't bet)
Seat 9: Dantist1122 (button) folded before Flop (didn't bet)





PokerStars Hand #152558669663:  Hold'em No Limit ($0.50/$1.00 USD) - 2016/04/28 14:46:17 CET [2016/04/28 8:46:17 ET]
Table 'Paris' 9-max Seat #9 is the button
Seat 1: matiko09 ($154.47 in chips) 
Seat 2: birdie1970 ($217.10 in chips) 
Seat 4: koksskrt ($101.50 in chips) 
Seat 6: aseban11 ($137.50 in chips) 
Seat 7: Westpants ($127.22 in chips) 
Seat 8: Muric05 ($59.01 in chips) 
Seat 9: ruslik_by ($40 in chips) 
matiko09: posts small blind $0.50
birdie1970: posts big blind $1
*** HOLE CARDS ***
Dealt to matiko09 [6c 3s]
koksskrt: raises $2 to $3
aseban11: folds 
Patz B leaves the table
Westpants: calls $3
Muric05: calls $3
vrnMike joins the table at seat #3 
ruslik_by: folds 
matiko09: folds 
birdie1970: folds 
*** FLOP *** [Ad 4c 8d]
koksskrt: checks 
Westpants: checks 
Muric05: bets $4
koksskrt: calls $4
Westpants: raises $10 to $14
Muric05: folds 
koksskrt: folds 
Uncalled bet ($10) returned to Westpants
Westpants collected $21.38 from pot
*** SUMMARY ***
Total pot $22.50 | Rake $1.12 
Board [Ad 4c 8d]
Seat 1: matiko09 (small blind) folded before Flop
Seat 2: birdie1970 (big blind) folded before Flop
Seat 4: koksskrt folded on the Flop
Seat 6: aseban11 folded before Flop (didn't bet)
Seat 7: Westpants collected ($21.38)
Seat 8: Muric05 folded on the Flop
Seat 9: ruslik_by (button) folded before Flop (didn't bet)





PokerStars Hand #152558670844:  Hold'em No Limit ($0.50/$1.00 USD) - 2016/04/28 14:46:19 CET [2016/04/28 8:46:19 ET]
Table 'Azimech' 9-max Seat #3 is the button
Seat 1: peevoajax ($100.20 in chips) 
Seat 2: adikier ($236.35 in chips) 
Seat 3: matiko09 ($100 in chips) 
Seat 4: ruslik_by ($81.90 in chips) 
Seat 5: ozone2003 ($110.88 in chips) 
Seat 7: azzad2007 ($103.20 in chips) 
Seat 8: vrnMike ($100 in chips) 
Seat 9: scottinsf ($62.90 in chips) 
ruslik_by: posts small blind $0.50
ozone2003: posts big blind $1
sanpidk: sits out 
*** HOLE CARDS ***
Dealt to matiko09 [7d 8s]
azzad2007: folds 
vrnMike: folds 
scottinsf: folds 
peevoajax: folds 
adikier: folds 
matiko09: folds 
ruslik_by: folds 
Uncalled bet ($0.50) returned to ozone2003
ozone2003 collected $1 from pot
ozone2003: doesn't show hand 
*** SUMMARY ***
Total pot $1 | Rake $0 
Seat 1: peevoajax folded before Flop (didn't bet)
Seat 2: adikier folded before Flop (didn't bet)
Seat 3: matiko09 (button) folded before Flop (didn't bet)
Seat 4: ruslik_by (small blind) folded before Flop
Seat 5: ozone2003 (big blind) collected ($1)
Seat 7: azzad2007 folded before Flop (didn't bet)
Seat 8: vrnMike folded before Flop (didn't bet)
Seat 9: scottinsf folded before Flop (didn't bet)





PokerStars Hand #152558672772:  Hold'em No Limit ($1/$2 USD) - 2016/04/28 14:46:22 CET [2016/04/28 8:46:22 ET]
Table 'Helio' 9-max Seat #4 is the button
Seat 1: prominente ($285.60 in chips) 
Seat 2: peevoajax ($203 in chips) 
Seat 3: InsomniaRU ($222.45 in chips) 
Seat 4: ersevi6 ($129.66 in chips) 
Seat 5: pretender 19 ($192.42 in chips) 
Seat 6: matiko09 ($203 in chips) 
Seat 8: libbyyww ($207.54 in chips) 
Seat 9: rmanjkeee ($91.75 in chips) 
pretender 19: posts small blind $1
matiko09: posts big blind $2
*** HOLE CARDS ***
Dealt to matiko09 [2s 9c]
libbyyww: folds 
rmanjkeee: folds 
prominente: folds 
peevoajax: raises $4 to $6
InsomniaRU: folds 
ersevi6: folds 
pretender 19: folds 
matiko09: folds 
Uncalled bet ($4) returned to peevoajax
peevoajax collected $5 from pot
peevoajax: doesn't show hand 
*** SUMMARY ***
Total pot $5 | Rake $0 
Seat 1: prominente folded before Flop (didn't bet)
Seat 2: peevoajax collected ($5)
Seat 3: InsomniaRU folded before Flop (didn't bet)
Seat 4: ersevi6 (button) folded before Flop (didn't bet)
Seat 5: pretender 19 (small blind) folded before Flop
Seat 6: matiko09 (big blind) folded before Flop
Seat 8: libbyyww folded before Flop (didn't bet)
Seat 9: rmanjkeee folded before Flop (didn't bet)





PokerStars Hand #152558681544:  Hold'em No Limit ($1/$2 USD) - 2016/04/28 14:46:38 CET [2016/04/28 8:46:38 ET]
Table 'Mireille' 9-max Seat #4 is the button
Seat 2: matiko09 ($200 in chips) 
Seat 3: MZ2502 ($213.65 in chips) 
Seat 4: Fish4trips ($230.23 in chips) 
Seat 5: SoNe1988 ($143.35 in chips) 
Seat 6: Yaaaazz ($200 in chips) 
Seat 7: aseban11 ($274.16 in chips) 
Seat 8: KDJAll3 ($919.68 in chips) 
Seat 9: a-talash ($155.30 in chips) 
SoNe1988: posts small blind $1
Yaaaazz: posts big blind $2
*** HOLE CARDS ***
Dealt to matiko09 [5d Kc]
aseban11: folds 
KDJAll3: folds 
a-talash: folds 
matiko09: folds 
MZ2502: folds 
Fish4trips: folds 
SoNe1988: raises $3 to $5
Yaaaazz: calls $3
*** FLOP *** [Jh 7h 9c]
SoNe1988: bets $7.12
Yaaaazz: raises $12.81 to $19.93
SoNe1988: calls $12.81
*** TURN *** [Jh 7h 9c] [8c]
SoNe1988: checks 
Yaaaazz: bets $47.37
SoNe1988: folds 
Uncalled bet ($47.37) returned to Yaaaazz
Yaaaazz collected $47.37 from pot
*** SUMMARY ***
Total pot $49.86 | Rake $2.49 
Board [Jh 7h 9c 8c]
Seat 2: matiko09 folded before Flop (didn't bet)
Seat 3: MZ2502 folded before Flop (didn't bet)
Seat 4: Fish4trips (button) folded before Flop (didn't bet)
Seat 5: SoNe1988 (small blind) folded on the Turn
Seat 6: Yaaaazz (big blind) collected ($47.37)
Seat 7: aseban11 folded before Flop (didn't bet)
Seat 8: KDJAll3 folded before Flop (didn't bet)
Seat 9: a-talash folded before Flop (didn't bet)





PokerStars Hand #152558682642:  Hold'em No Limit ($0.50/$1.00 USD) - 2016/04/28 14:46:40 CET [2016/04/28 8:46:40 ET]
Table 'Zachia II' 9-max Seat #1 is the button
Seat 1: greyman571 ($92.84 in chips) 
Seat 2: sanpidk ($154.45 in chips) 
Seat 3: matiko09 ($100 in chips) 
Seat 4: omorfadramou ($105.97 in chips) 
Seat 5: vrnMike ($100 in chips) 
Seat 6: maxxmeister ($103.50 in chips) 
Seat 7: ozone2003 ($100 in chips) 
Seat 9: I The King I ($101.50 in chips) 
sanpidk: posts small blind $0.50
matiko09: posts big blind $1
*** HOLE CARDS ***
Dealt to matiko09 [Qc 6d]
omorfadramou: folds 
vrnMike: raises $1 to $2
maxxmeister: folds 
ozone2003: folds 
I The King I: folds 
greyman571: folds 
sanpidk: folds 
matiko09: folds 
Uncalled bet ($1) returned to vrnMike
vrnMike collected $2.50 from pot
*** SUMMARY ***
Total pot $2.50 | Rake $0 
Seat 1: greyman571 (button) folded before Flop (didn't bet)
Seat 2: sanpidk (small blind) folded before Flop
Seat 3: matiko09 (big blind) folded before Flop
Seat 4: omorfadramou folded before Flop (didn't bet)
Seat 5: vrnMike collected ($2.50)
Seat 6: maxxmeister folded before Flop (didn't bet)
Seat 7: ozone2003 folded before Flop (didn't bet)
Seat 9: I The King I folded before Flop (didn't bet)





PokerStars Hand #152558684203:  Hold'em No Limit ($1/$2 USD) - 2016/04/28 14:46:43 CET [2016/04/28 8:46:43 ET]
Table 'Idomeneus II' 9-max Seat #1 is the button
Seat 1: 13Ghosts ($214.22 in chips) 
Seat 2: libbyyww ($302.54 in chips) 
Seat 3: adrenalin333 ($176.37 in chips) 
Seat 4: SoNe1988 ($90.48 in chips) 
Seat 5: matiko09 ($211.36 in chips) 
Seat 7: ersevi6 ($156.61 in chips) 
Seat 9: Fish4trips ($207.68 in chips) 
libbyyww: posts small blind $1
adrenalin333: posts big blind $2
*** HOLE CARDS ***
Dealt to matiko09 [9s 2d]
SoNe1988: folds 
matiko09: folds 
ersevi6: folds 
Fish4trips: folds 
13Ghosts: folds 
libbyyww: folds 
Uncalled bet ($1) returned to adrenalin333
adrenalin333 collected $2 from pot
adrenalin333: doesn't show hand 
*** SUMMARY ***
Total pot $2 | Rake $0 
Seat 1: 13Ghosts (button) folded before Flop (didn't bet)
Seat 2: libbyyww (small blind) folded before Flop
Seat 3: adrenalin333 (big blind) collected ($2)
Seat 4: SoNe1988 folded before Flop (didn't bet)
Seat 5: matiko09 folded before Flop (didn't bet)
Seat 7: ersevi6 folded before Flop (didn't bet)
Seat 9: Fish4trips folded before Flop (didn't bet)





PokerStars Hand #152558693738:  Hold'em No Limit ($1/$2 USD) - 2016/04/28 14:47:00 CET [2016/04/28 8:47:00 ET]
Table 'Helio' 9-max Seat #5 is the button
Seat 1: prominente ($285.60 in chips) 
Seat 2: peevoajax ($206 in chips) 
Seat 3: InsomniaRU ($222.45 in chips) 
Seat 4: ersevi6 ($129.66 in chips) 
Seat 5: pretender 19 ($191.42 in chips) 
Seat 6: matiko09 ($201 in chips) 
Seat 9: rmanjkeee ($91.75 in chips) 
matiko09: posts small blind $1
libbyyww: is sitting out 
rmanjkeee: posts big blind $2
*** HOLE CARDS ***
Dealt to matiko09 [4h 3d]
prominente: raises $3 to $5
libbyyww leaves the table
I The King I joins the table at seat #8 
I The King I leaves the table
wiseyoyo joins the table at seat #8 
peevoajax: folds 
InsomniaRU: raises $11 to $16
ersevi6: folds 
pretender 19: folds 
matiko09: folds 
rmanjkeee: folds 
prominente: raises $19 to $35
InsomniaRU: calls $19
*** FLOP *** [Td Qd Th]
prominente: bets $35.50
InsomniaRU: calls $35.50
*** TURN *** [Td Qd Th] [Js]
prominente: checks 
InsomniaRU: checks 
*** RIVER *** [Td Qd Th Js] [Ah]
prominente: bets $55
InsomniaRU: calls $55
*** SHOW DOWN ***
prominente: shows [As Ac] (a full house, Aces full of Tens)
InsomniaRU: mucks hand 
prominente collected $251.25 from pot
*** SUMMARY ***
Total pot $254 | Rake $2.75 
Board [Td Qd Th Js Ah]
Seat 1: prominente showed [As Ac] and won ($251.25) with a full house, Aces full of Tens
Seat 2: peevoajax folded before Flop (didn't bet)
Seat 3: InsomniaRU mucked [Ad Kh]
Seat 4: ersevi6 folded before Flop (didn't bet)
Seat 5: pretender 19 (button) folded before Flop (didn't bet)
Seat 6: matiko09 (small blind) folded before Flop
Seat 9: rmanjkeee (big blind) folded before Flop





PokerStars Hand #152558695838:  Hold'em No Limit ($0.50/$1.00 USD) - 2016/04/28 14:47:04 CET [2016/04/28 8:47:04 ET]
Table 'Azimech' 9-max Seat #4 is the button
Seat 1: peevoajax ($100.20 in chips) 
Seat 2: adikier ($236.35 in chips) 
Seat 3: matiko09 ($100 in chips) 
Seat 4: ruslik_by ($81.40 in chips) 
Seat 5: ozone2003 ($111.38 in chips) 
Seat 6: sanpidk ($100 in chips) 
Seat 7: azzad2007 ($103.20 in chips) 
Seat 8: vrnMike ($100 in chips) 
Seat 9: scottinsf ($62.90 in chips) 
ozone2003: posts small blind $0.50
sanpidk: posts big blind $1
*** HOLE CARDS ***
Dealt to matiko09 [7d 9h]
azzad2007: folds 
vrnMike: folds 
scottinsf: folds 
peevoajax: raises $2 to $3
adikier: folds 
matiko09: folds 
ruslik_by: folds 
ozone2003: folds 
sanpidk: raises $7.50 to $10.50
peevoajax: calls $7.50
*** FLOP *** [8c 3c 2c]
sanpidk: bets $16
peevoajax: calls $16
*** TURN *** [8c 3c 2c] [9c]
sanpidk: checks 
peevoajax: checks 
*** RIVER *** [8c 3c 2c 9c] [Jh]
sanpidk: checks 
peevoajax: bets $30
sanpidk: folds 
Uncalled bet ($30) returned to peevoajax
peevoajax collected $51 from pot
peevoajax: doesn't show hand 
*** SUMMARY ***
Total pot $53.50 | Rake $2.50 
Board [8c 3c 2c 9c Jh]
Seat 1: peevoajax collected ($51)
Seat 2: adikier folded before Flop (didn't bet)
Seat 3: matiko09 folded before Flop (didn't bet)
Seat 4: ruslik_by (button) folded before Flop (didn't bet)
Seat 5: ozone2003 (small blind) folded before Flop
Seat 6: sanpidk (big blind) folded on the River
Seat 7: azzad2007 folded before Flop (didn't bet)
Seat 8: vrnMike folded before Flop (didn't bet)
Seat 9: scottinsf folded before Flop (didn't bet)





PokerStars Hand #152558696979:  Hold'em No Limit (€0.50/€1.00 EUR) - 2016/04/28 14:47:06 CET [2016/04/28 8:47:06 ET]
Table 'Lumiere II' 9-max Seat #8 is the button
Seat 1: vrnMike (€100 in chips) 
Seat 2: Racushniak (€103 in chips) 
Seat 3: ozone2003 (€104.73 in chips) 
Seat 4: ruslik_by (€49.92 in chips) 
Seat 5: Schmidy7 (€39 in chips) 
Seat 6: HasBigBiceps (€100 in chips) 
Seat 7: hammerwife (€106.62 in chips) 
Seat 8: WDW3 (€103 in chips) 
Seat 9: matiko09 (€100 in chips) 
matiko09: posts small blind €0.50
vrnMike: posts big blind €1
*** HOLE CARDS ***
Dealt to matiko09 [8s Qd]
Racushniak: raises €2 to €3
ozone2003: folds 
ruslik_by: calls €3
Schmidy7: folds 
HasBigBiceps: folds 
hammerwife: folds 
WDW3: folds 
matiko09: folds 
vrnMike: folds 
*** FLOP *** [3s 5s 9c]
Racushniak: bets €2.34
ruslik_by: calls €2.34
*** TURN *** [3s 5s 9c] [9d]
Racushniak: checks 
ruslik_by: bets €4.50
Racushniak: calls €4.50
*** RIVER *** [3s 5s 9c 9d] [Ac]
Racushniak: bets €5
ruslik_by: raises €35.08 to €40.08 and is all-in
Racushniak: folds 
Uncalled bet (€35.08) returned to ruslik_by
ruslik_by collected €29.62 from pot
ruslik_by: doesn't show hand 
*** SUMMARY ***
Total pot €31.18 | Rake €1.56 
Board [3s 5s 9c 9d Ac]
Seat 1: vrnMike (big blind) folded before Flop
Seat 2: Racushniak folded on the River
Seat 3: ozone2003 folded before Flop (didn't bet)
Seat 4: ruslik_by collected (€29.62)
Seat 5: Schmidy7 folded before Flop (didn't bet)
Seat 6: HasBigBiceps folded before Flop (didn't bet)
Seat 7: hammerwife folded before Flop (didn't bet)
Seat 8: WDW3 (button) folded before Flop (didn't bet)
Seat 9: matiko09 (small blind) folded before Flop





PokerStars Hand #152558698990:  Hold'em No Limit ($0.50/$1.00 USD) - 2016/04/28 14:47:09 CET [2016/04/28 8:47:09 ET]
Table 'Bruwer' 9-max Seat #2 is the button
Seat 2: ruslik_by ($40 in chips) 
Seat 3: koksskrt ($111.61 in chips) 
Seat 4: matiko09 ($144.04 in chips) 
Seat 5: Carloszhang ($124.78 in chips) 
Seat 6: I The King I ($111.02 in chips) 
Seat 7: R1aki ($248.58 in chips) 
Seat 8: WDW3 ($109.52 in chips) 
Seat 9: Dantist1122 ($124.41 in chips) 
koksskrt: posts small blind $0.50
matiko09: posts big blind $1
*** HOLE CARDS ***
Dealt to matiko09 [5d 9c]
Carloszhang: folds 
I The King I: raises $2 to $3
R1aki: folds 
WDW3: folds 
Dantist1122: folds 
ruslik_by: folds 
koksskrt: folds 
matiko09: folds 
Uncalled bet ($2) returned to I The King I
I The King I collected $2.50 from pot
I The King I: doesn't show hand 
*** SUMMARY ***
Total pot $2.50 | Rake $0 
Seat 2: ruslik_by (button) folded before Flop (didn't bet)
Seat 3: koksskrt (small blind) folded before Flop
Seat 4: matiko09 (big blind) folded before Flop
Seat 5: Carloszhang folded before Flop (didn't bet)
Seat 6: I The King I collected ($2.50)
Seat 7: R1aki folded before Flop (didn't bet)
Seat 8: WDW3 folded before Flop (didn't bet)
Seat 9: Dantist1122 folded before Flop (didn't bet)





PokerStars Hand #152558699961:  Hold'em No Limit ($0.50/$1.00 USD) - 2016/04/28 14:47:11 CET [2016/04/28 8:47:11 ET]
Table 'Lyot' 9-max Seat #4 is the button
Seat 1: matiko09 ($115.31 in chips) 
Seat 2: vrnMike ($140.05 in chips) 
Seat 4: WDW3 ($101.24 in chips) 
Seat 6: Monglaer ($99.87 in chips) 
Seat 7: PreMoze ($73.51 in chips) 
Seat 8: Patz B ($36.45 in chips) 
Seat 9: koksskrt ($100 in chips) 
Monglaer: posts small blind $0.50
PreMoze: posts big blind $1
matiko09: posts the ante $0.20
vrnMike: posts the ante $0.20
WDW3: posts the ante $0.20
Monglaer: posts the ante $0.20
PreMoze: posts the ante $0.20
Patz B: posts the ante $0.20
koksskrt: posts the ante $0.20
*** HOLE CARDS ***
Dealt to matiko09 [3d Qs]
Patz B: raises $1 to $2
koksskrt: folds 
matiko09: folds 
vrnMike: folds 
WDW3: folds 
Monglaer: calls $1.50
PreMoze: calls $1
*** FLOP *** [Ts 8s Tc]
Monglaer: checks 
PreMoze: checks 
Patz B: bets $3
Monglaer: folds 
PreMoze: calls $3
*** TURN *** [Ts 8s Tc] [Kh]
PreMoze: checks 
Patz B: bets $6.36
PreMoze: calls $6.36
*** RIVER *** [Ts 8s Tc Kh] [6s]
PreMoze: checks 
Patz B: bets $12.40
aseban11 is disconnected 
PreMoze: raises $49.55 to $61.95 and is all-in
Patz B: folds 
Uncalled bet ($49.55) returned to PreMoze
PreMoze collected $48.42 from pot
*** SUMMARY ***
Total pot $50.92 | Rake $2.50 
Board [Ts 8s Tc Kh 6s]
Seat 1: matiko09 folded before Flop (didn't bet)
Seat 2: vrnMike folded before Flop (didn't bet)
Seat 4: WDW3 (button) folded before Flop (didn't bet)
Seat 6: Monglaer (small blind) folded on the Flop
Seat 7: PreMoze (big blind) collected ($48.42)
Seat 8: Patz B folded on the River
Seat 9: koksskrt folded before Flop (didn't bet)





PokerStars Hand #152558701044:  Hold'em No Limit ($1/$2 USD) - 2016/04/28 14:47:13 CET [2016/04/28 8:47:13 ET]
Table 'Simonida II' 9-max Seat #7 is the button
Seat 1: 13Ghosts ($203 in chips) 
Seat 2: snow937022 ($226.58 in chips) 
Seat 3: WDW3 ($207.05 in chips) 
Seat 4: a-talash ($171.92 in chips) 
Seat 5: matiko09 ($203 in chips) 
Seat 6: ocarey86 ($151.47 in chips) 
Seat 7: Fish4trips ($200.73 in chips) 
Seat 8: Sutt_420 ($120.49 in chips) 
Seat 9: prominente ($206 in chips) 
Sutt_420: posts small blind $1
prominente: posts big blind $2
*** HOLE CARDS ***
Dealt to matiko09 [Th Ts]
13Ghosts: folds 
snow937022: folds 
WDW3: folds 
a-talash: folds 
matiko09: raises $3 to $5
ocarey86: folds 
Fish4trips: folds 
Sutt_420: folds 
prominente: folds 
Uncalled bet ($3) returned to matiko09
matiko09 collected $5 from pot
matiko09: doesn't show hand 
*** SUMMARY ***
Total pot $5 | Rake $0 
Seat 1: 13Ghosts folded before Flop (didn't bet)
Seat 2: snow937022 folded before Flop (didn't bet)
Seat 3: WDW3 folded before Flop (didn't bet)
Seat 4: a-talash folded before Flop (didn't bet)
Seat 5: matiko09 collected ($5)
Seat 6: ocarey86 folded before Flop (didn't bet)
Seat 7: Fish4trips (button) folded before Flop (didn't bet)
Seat 8: Sutt_420 (small blind) folded before Flop
Seat 9: prominente (big blind) folded before Flop





PokerStars Hand #152558702221:  Hold'em No Limit ($1/$2 USD) - 2016/04/28 14:47:15 CET [2016/04/28 8:47:15 ET]
Table 'Idomeneus II' 9-max Seat #2 is the button
Seat 1: 13Ghosts ($214.22 in chips) 
Seat 2: libbyyww ($301.54 in chips) 
Seat 3: adrenalin333 ($177.37 in chips) 
Seat 4: SoNe1988 ($90.48 in chips) 
Seat 5: matiko09 ($211.36 in chips) 
Seat 7: ersevi6 ($156.61 in chips) 
Seat 9: Fish4trips ($207.68 in chips) 
adrenalin333: posts small blind $1
SoNe1988: posts big blind $2
*** HOLE CARDS ***
Dealt to matiko09 [2c 3c]
matiko09: folds 
ersevi6: folds 
Fish4trips: folds 
13Ghosts: folds 
libbyyww: raises $2.24 to $4.24
adrenalin333: folds 
SoNe1988: calls $2.24
*** FLOP *** [3d 9s 7c]
SoNe1988: checks 
libbyyww: checks 
*** TURN *** [3d 9s 7c] [2d]
SoNe1988: checks 
libbyyww: checks 
*** RIVER *** [3d 9s 7c 2d] [9c]
SoNe1988: checks 
libbyyww: checks 
*** SHOW DOWN ***
SoNe1988: shows [5c Tc] (a pair of Nines)
libbyyww: shows [Ac 6c] (a pair of Nines - Ace kicker)
libbyyww collected $9.01 from pot
*** SUMMARY ***
Total pot $9.48 | Rake $0.47 
Board [3d 9s 7c 2d 9c]
Seat 1: 13Ghosts folded before Flop (didn't bet)
Seat 2: libbyyww (button) showed [Ac 6c] and won ($9.01) with a pair of Nines
Seat 3: adrenalin333 (small blind) folded before Flop
Seat 4: SoNe1988 (big blind) showed [5c Tc] and lost with a pair of Nines
Seat 5: matiko09 folded before Flop (didn't bet)
Seat 7: ersevi6 folded before Flop (didn't bet)
Seat 9: Fish4trips folded before Flop (didn't bet)





PokerStars Hand #152558705204:  Hold'em No Limit ($0.50/$1.00 USD) - 2016/04/28 14:47:21 CET [2016/04/28 8:47:21 ET]
Table 'Zachia II' 9-max Seat #2 is the button
Seat 1: greyman571 ($92.84 in chips) 
Seat 2: sanpidk ($153.95 in chips) 
Seat 3: matiko09 ($100 in chips) 
Seat 4: omorfadramou ($105.97 in chips) 
Seat 5: vrnMike ($101.50 in chips) 
Seat 6: maxxmeister ($103.50 in chips) 
Seat 7: ozone2003 ($100 in chips) 
Seat 9: I The King I ($101.50 in chips) 
matiko09: posts small blind $0.50
omorfadramou: posts big blind $1
*** HOLE CARDS ***
Dealt to matiko09 [4s 4h]
vrnMike: folds 
maxxmeister: folds 
ozone2003: raises $2 to $3
I The King I: folds 
greyman571: folds 
sanpidk: folds 
matiko09: folds 
omorfadramou: folds 
Uncalled bet ($2) returned to ozone2003
ozone2003 collected $2.50 from pot
ozone2003: doesn't show hand 
*** SUMMARY ***
Total pot $2.50 | Rake $0 
Seat 1: greyman571 folded before Flop (didn't bet)
Seat 2: sanpidk (button) folded before Flop (didn't bet)
Seat 3: matiko09 (small blind) folded before Flop
Seat 4: omorfadramou (big blind) folded before Flop
Seat 5: vrnMike folded before Flop (didn't bet)
Seat 6: maxxmeister folded before Flop (didn't bet)
Seat 7: ozone2003 collected ($2.50)
Seat 9: I The King I folded before Flop (didn't bet)





PokerStars Hand #152558711137:  Hold'em No Limit ($0.50/$1.00 USD) - 2016/04/28 14:47:31 CET [2016/04/28 8:47:31 ET]
Table 'Erynia' 9-max Seat #2 is the button
Seat 2: matiko09 ($157.30 in chips) 
Seat 4: WDW3 ($127.62 in chips) 
Seat 5: scottinsf ($40.49 in chips) 
Seat 7: vrnMike ($113.30 in chips) 
Seat 8: YourKicker78 ($46.04 in chips) 
Seat 9: ruslik_by ($71.85 in chips) 
WDW3: posts small blind $0.50
scottinsf: posts big blind $1
peevoajax: sits out 
*** HOLE CARDS ***
Dealt to matiko09 [7c Ad]
vrnMike: folds 
YourKicker78: folds 
ruslik_by: folds 
matiko09: raises $1.27 to $2.27
WDW3: raises $6.23 to $8.50
scottinsf: folds 
matiko09: folds 
Uncalled bet ($6.23) returned to WDW3
WDW3 collected $5.54 from pot
WDW3: doesn't show hand 
*** SUMMARY ***
Total pot $5.54 | Rake $0 
Seat 2: matiko09 (button) folded before Flop
Seat 4: WDW3 (small blind) collected ($5.54)
Seat 5: scottinsf (big blind) folded before Flop
Seat 7: vrnMike folded before Flop (didn't bet)
Seat 8: YourKicker78 folded before Flop (didn't bet)
Seat 9: ruslik_by folded before Flop (didn't bet)





PokerStars Hand #152558713438:  Hold'em No Limit ($1/$2 USD) - 2016/04/28 14:47:35 CET [2016/04/28 8:47:35 ET]
Table 'Libera II' 9-max Seat #9 is the button
Seat 1: libbyyww ($201 in chips) 
Seat 2: peevoajax ($216.35 in chips) 
Seat 3: maverick7614 ($49.68 in chips) 
Seat 4: Sly-Hustler ($90.80 in chips) 
Seat 5: ersevi6 ($138.30 in chips) 
Seat 6: matiko09 ($200 in chips) 
Seat 7: Fish4trips ($400.25 in chips) 
Seat 8: WDW3 ($206.89 in chips) 
Seat 9: InsomniaRU ($224 in chips) 
libbyyww: posts small blind $1
peevoajax: posts big blind $2
*** HOLE CARDS ***
Dealt to matiko09 [Jc 6s]
maverick7614: calls $2
Sly-Hustler: folds 
ersevi6: folds 
matiko09: folds 
Fish4trips: folds 
WDW3: folds 
InsomniaRU: raises $5 to $7
libbyyww: folds 
peevoajax: folds 
maverick7614: calls $5
*** FLOP *** [Qs 4d Qh]
maverick7614: checks 
InsomniaRU: checks 
*** TURN *** [Qs 4d Qh] [Kc]
maverick7614: checks 
InsomniaRU: bets $12.92
maverick7614: calls $12.92
*** RIVER *** [Qs 4d Qh Kc] [5s]
maverick7614: bets $14
InsomniaRU: raises $75.57 to $89.57
maverick7614: calls $15.76 and is all-in
Uncalled bet ($59.81) returned to InsomniaRU
*** SHOW DOWN ***
InsomniaRU: shows [Qd Jh] (three of a kind, Queens)
maverick7614: shows [4s 4h] (a full house, Fours full of Queens)
maverick7614 collected $99.61 from pot
*** SUMMARY ***
Total pot $102.36 | Rake $2.75 
Board [Qs 4d Qh Kc 5s]
Seat 1: libbyyww (small blind) folded before Flop
Seat 2: peevoajax (big blind) folded before Flop
Seat 3: maverick7614 showed [4s 4h] and won ($99.61) with a full house, Fours full of Queens
Seat 4: Sly-Hustler folded before Flop (didn't bet)
Seat 5: ersevi6 folded before Flop (didn't bet)
Seat 6: matiko09 folded before Flop (didn't bet)
Seat 7: Fish4trips folded before Flop (didn't bet)
Seat 8: WDW3 folded before Flop (didn't bet)
Seat 9: InsomniaRU (button) showed [Qd Jh] and lost with three of a kind, Queens





PokerStars Hand #152558716096:  Hold'em No Limit ($0.50/$1.00 USD) - 2016/04/28 14:47:40 CET [2016/04/28 8:47:40 ET]
Table 'Bruwer' 9-max Seat #3 is the button
Seat 2: ruslik_by ($40 in chips) 
Seat 3: koksskrt ($111.11 in chips) 
Seat 4: matiko09 ($143.04 in chips) 
Seat 5: Carloszhang ($124.78 in chips) 
Seat 6: I The King I ($112.52 in chips) 
Seat 7: R1aki ($248.58 in chips) 
Seat 8: WDW3 ($109.52 in chips) 
Seat 9: Dantist1122 ($124.41 in chips) 
matiko09: posts small blind $0.50
Carloszhang: posts big blind $1
*** HOLE CARDS ***
Dealt to matiko09 [Ks Js]
I The King I: folds 
R1aki: folds 
WDW3: folds 
Dantist1122: folds 
ruslik_by: folds 
koksskrt: raises $1 to $2
matiko09: calls $1.50
Carloszhang: calls $1
*** FLOP *** [Ac 4c 8c]
matiko09: checks 
aseban11 is disconnected 
Carloszhang: checks 
koksskrt: checks 
*** TURN *** [Ac 4c 8c] [2d]
matiko09: checks 
Carloszhang: checks 
koksskrt: checks 
*** RIVER *** [Ac 4c 8c 2d] [As]
matiko09: checks 
Carloszhang: checks 
koksskrt: checks 
*** SHOW DOWN ***
matiko09: shows [Ks Js] (a pair of Aces)
Carloszhang: shows [5d 5c] (two pair, Aces and Fives)
koksskrt: mucks hand 
Carloszhang collected $5.70 from pot
*** SUMMARY ***
Total pot $6 | Rake $0.30 
Board [Ac 4c 8c 2d As]
Seat 2: ruslik_by folded before Flop (didn't bet)
Seat 3: koksskrt (button) mucked [Kd Jh]
Seat 4: matiko09 (small blind) showed [Ks Js] and lost with a pair of Aces
Seat 5: Carloszhang (big blind) showed [5d 5c] and won ($5.70) with two pair, Aces and Fives
Seat 6: I The King I folded before Flop (didn't bet)
Seat 7: R1aki folded before Flop (didn't bet)
Seat 8: WDW3 folded before Flop (didn't bet)
Seat 9: Dantist1122 folded before Flop (didn't bet)





PokerStars Hand #152558717853:  Hold'em No Limit ($0.50/$1.00 USD) - 2016/04/28 14:47:43 CET [2016/04/28 8:47:43 ET]
Table 'Paris' 9-max Seat #1 is the button
Seat 1: matiko09 ($153.97 in chips) 
Seat 2: birdie1970 ($216.10 in chips) 
Seat 3: vrnMike ($100 in chips) 
Seat 4: koksskrt ($100 in chips) 
Seat 6: aseban11 ($137.50 in chips) 
Seat 7: Westpants ($141.60 in chips) 
Seat 8: Muric05 ($52.01 in chips) 
Seat 9: ruslik_by ($40 in chips) 
birdie1970: posts small blind $0.50
vrnMike: posts big blind $1
*** HOLE CARDS ***
Dealt to matiko09 [Jc 6d]
koksskrt: folds 
aseban11: folds 
Westpants: folds 
Muric05: folds 
ruslik_by: folds 
matiko09: folds 
birdie1970: raises $1 to $2
vrnMike: calls $1
*** FLOP *** [2d Jd Qh]
birdie1970: checks 
vrnMike: checks 
*** TURN *** [2d Jd Qh] [4c]
birdie1970: checks 
vrnMike: checks 
*** RIVER *** [2d Jd Qh 4c] [4h]
birdie1970: checks 
vrnMike: bets $3
birdie1970: folds [As Ts]
Uncalled bet ($3) returned to vrnMike
vrnMike collected $3.80 from pot
*** SUMMARY ***
Total pot $4 | Rake $0.20 
Board [2d Jd Qh 4c 4h]
Seat 1: matiko09 (button) folded before Flop (didn't bet)
Seat 2: birdie1970 (small blind) folded on the River
Seat 3: vrnMike (big blind) collected ($3.80)
Seat 4: koksskrt folded before Flop (didn't bet)
Seat 6: aseban11 folded before Flop (didn't bet)
Seat 7: Westpants folded before Flop (didn't bet)
Seat 8: Muric05 folded before Flop (didn't bet)
Seat 9: ruslik_by folded before Flop (didn't bet)





PokerStars Hand #152558721246:  Hold'em No Limit ($1/$2 USD) - 2016/04/28 14:47:50 CET [2016/04/28 8:47:50 ET]
Table 'Simonida II' 9-max Seat #8 is the button
Seat 1: 13Ghosts ($203 in chips) 
Seat 2: snow937022 ($226.58 in chips) 
Seat 3: WDW3 ($207.05 in chips) 
Seat 4: a-talash ($171.92 in chips) 
Seat 5: matiko09 ($206 in chips) 
Seat 6: ocarey86 ($151.47 in chips) 
Seat 7: Fish4trips ($200.73 in chips) 
Seat 8: Sutt_420 ($119.49 in chips) 
Seat 9: prominente ($204 in chips) 
prominente: posts small blind $1
13Ghosts: posts big blind $2
*** HOLE CARDS ***
Dealt to matiko09 [Jh Qs]
snow937022: folds 
WDW3: raises $3.60 to $5.60
a-talash: folds 
matiko09: folds 
ocarey86: folds 
Fish4trips: calls $5.60
Sutt_420: folds 
prominente: folds 
13Ghosts: folds 
*** FLOP *** [8c 9h 5s]
WDW3: checks 
Fish4trips: bets $8.50
WDW3: calls $8.50
*** TURN *** [8c 9h 5s] [4d]
WDW3: checks 
Fish4trips: checks 
*** RIVER *** [8c 9h 5s 4d] [Kh]
WDW3: checks 
Fish4trips: checks 
*** SHOW DOWN ***
WDW3: shows [Th Td] (a pair of Tens)
Fish4trips: mucks hand 
WDW3 collected $29.64 from pot
*** SUMMARY ***
Total pot $31.20 | Rake $1.56 
Board [8c 9h 5s 4d Kh]
Seat 1: 13Ghosts (big blind) folded before Flop
Seat 2: snow937022 folded before Flop (didn't bet)
Seat 3: WDW3 showed [Th Td] and won ($29.64) with a pair of Tens
Seat 4: a-talash folded before Flop (didn't bet)
Seat 5: matiko09 folded before Flop (didn't bet)
Seat 6: ocarey86 folded before Flop (didn't bet)
Seat 7: Fish4trips mucked [Ah Qh]
Seat 8: Sutt_420 (button) folded before Flop (didn't bet)
Seat 9: prominente (small blind) folded before Flop





PokerStars Hand #152558724795:  Hold'em No Limit (€0.50/€1.00 EUR) - 2016/04/28 14:47:56 CET [2016/04/28 8:47:56 ET]
Table 'Clivia II' 9-max Seat #7 is the button
Seat 1: piperkova (€50.88 in chips) 
Seat 2: HasBigBiceps (€100 in chips) 
Seat 3: R1aki (€100 in chips) 
Seat 4: matiko09 (€100 in chips) 
Seat 5: WDW3 (€123 in chips) 
Seat 6: ruslik_by (€61.43 in chips) 
Seat 7: St.LaCoste (€100 in chips) 
Seat 8: Dantist1122 (€100 in chips) 
Seat 9: ozone2003 (€101.50 in chips) 
Dantist1122: posts small blind €0.50
ozone2003: posts big blind €1
*** HOLE CARDS ***
Dealt to matiko09 [3h Kc]
piperkova: calls €1
HasBigBiceps: folds 
R1aki: folds 
matiko09: folds 
WDW3: raises €3 to €4
ruslik_by: folds 
St.LaCoste: folds 
Dantist1122: folds 
ozone2003: folds 
piperkova: folds 
Uncalled bet (€3) returned to WDW3
WDW3 collected €3.50 from pot
WDW3: doesn't show hand 
*** SUMMARY ***
Total pot €3.50 | Rake €0 
Seat 1: piperkova folded before Flop
Seat 2: HasBigBiceps folded before Flop (didn't bet)
Seat 3: R1aki folded before Flop (didn't bet)
Seat 4: matiko09 folded before Flop (didn't bet)
Seat 5: WDW3 collected (€3.50)
Seat 6: ruslik_by folded before Flop (didn't bet)
Seat 7: St.LaCoste (button) folded before Flop (didn't bet)
Seat 8: Dantist1122 (small blind) folded before Flop
Seat 9: ozone2003 (big blind) folded before Flop





PokerStars Hand #152558727760:  Hold'em No Limit ($0.50/$1.00 USD) - 2016/04/28 14:48:01 CET [2016/04/28 8:48:01 ET]
Table 'Zachia II' 9-max Seat #3 is the button
Seat 1: greyman571 ($92.84 in chips) 
Seat 2: sanpidk ($153.95 in chips) 
Seat 3: matiko09 ($100 in chips) 
Seat 4: omorfadramou ($104.97 in chips) 
Seat 5: vrnMike ($101.50 in chips) 
Seat 6: maxxmeister ($103.50 in chips) 
Seat 7: ozone2003 ($101.50 in chips) 
Seat 9: I The King I ($101.50 in chips) 
omorfadramou: posts small blind $0.50
vrnMike: posts big blind $1
*** HOLE CARDS ***
Dealt to matiko09 [Kd 5s]
maxxmeister: folds 
ozone2003: folds 
I The King I: folds 
greyman571: raises $2 to $3
sanpidk: calls $3
matiko09: folds 
omorfadramou: folds 
vrnMike: folds 
*** FLOP *** [Qh 2c 8h]
greyman571: checks 
sanpidk: bets $4.50
aseban11 is disconnected 
greyman571: calls $4.50
*** TURN *** [Qh 2c 8h] [Td]
greyman571: checks 
sanpidk: bets $11
greyman571: folds 
Uncalled bet ($11) returned to sanpidk
sanpidk collected $15.68 from pot
sanpidk: doesn't show hand 
*** SUMMARY ***
Total pot $16.50 | Rake $0.82 
Board [Qh 2c 8h Td]
Seat 1: greyman571 folded on the Turn
Seat 2: sanpidk collected ($15.68)
Seat 3: matiko09 (button) folded before Flop (didn't bet)
Seat 4: omorfadramou (small blind) folded before Flop
Seat 5: vrnMike (big blind) folded before Flop
Seat 6: maxxmeister folded before Flop (didn't bet)
Seat 7: ozone2003 folded before Flop (didn't bet)
Seat 9: I The King I folded before Flop (didn't bet)





PokerStars Hand #152558727778:  Hold'em No Limit ($0.50/$1.00 USD) - 2016/04/28 14:48:01 CET [2016/04/28 8:48:01 ET]
Table 'Erynia' 9-max Seat #4 is the button
Seat 2: matiko09 ($155.03 in chips) 
Seat 4: WDW3 ($130.89 in chips) 
Seat 5: scottinsf ($39.49 in chips) 
Seat 6: peevoajax ($100 in chips) 
Seat 7: vrnMike ($113.30 in chips) 
Seat 8: YourKicker78 ($46.04 in chips) 
Seat 9: ruslik_by ($71.85 in chips) 
scottinsf: posts small blind $0.50
peevoajax: posts big blind $1
*** HOLE CARDS ***
Dealt to matiko09 [4h 8c]
vrnMike: folds 
YourKicker78: folds 
ruslik_by: folds 
matiko09: folds 
WDW3: raises $1.40 to $2.40
scottinsf: folds 
peevoajax: folds 
Uncalled bet ($1.40) returned to WDW3
WDW3 collected $2.50 from pot
WDW3: doesn't show hand 
*** SUMMARY ***
Total pot $2.50 | Rake $0 
Seat 2: matiko09 folded before Flop (didn't bet)
Seat 4: WDW3 (button) collected ($2.50)
Seat 5: scottinsf (small blind) folded before Flop
Seat 6: peevoajax (big blind) folded before Flop
Seat 7: vrnMike folded before Flop (didn't bet)
Seat 8: YourKicker78 folded before Flop (didn't bet)
Seat 9: ruslik_by folded before Flop (didn't bet)





PokerStars Hand #152558728721:  Hold'em No Limit ($1/$2 USD) - 2016/04/28 14:48:03 CET [2016/04/28 8:48:03 ET]
Table 'Mireille' 9-max Seat #5 is the button
Seat 2: matiko09 ($200 in chips) 
Seat 3: MZ2502 ($213.65 in chips) 
Seat 4: Fish4trips ($230.23 in chips) 
Seat 5: SoNe1988 ($118.42 in chips) 
Seat 6: Yaaaazz ($222.44 in chips) 
Seat 8: KDJAll3 ($919.68 in chips) 
Seat 9: a-talash ($155.30 in chips) 
Yaaaazz: posts small blind $1
aseban11: is sitting out 
KDJAll3: posts big blind $2
*** HOLE CARDS ***
Dealt to matiko09 [4h 9h]
a-talash: folds 
matiko09: folds 
MZ2502: raises $10 to $12
Fish4trips: folds 
SoNe1988: folds 
Yaaaazz: raises $26 to $38
KDJAll3: folds 
aseban11 is disconnected 
MZ2502: calls $26
*** FLOP *** [8d 3h Ah]
Yaaaazz: checks 
MZ2502: bets $66
Yaaaazz: calls $66
*** TURN *** [8d 3h Ah] [2h]
Yaaaazz: checks 
MZ2502: bets $109.65 and is all-in
Yaaaazz: calls $109.65
*** RIVER *** [8d 3h Ah 2h] [3c]
*** SHOW DOWN ***
Yaaaazz: shows [Js Jh] (two pair, Jacks and Threes)
MZ2502: shows [8s 8c] (a full house, Eights full of Threes)
MZ2502 collected $426.55 from pot
*** SUMMARY ***
Total pot $429.30 | Rake $2.75 
Board [8d 3h Ah 2h 3c]
Seat 2: matiko09 folded before Flop (didn't bet)
Seat 3: MZ2502 showed [8s 8c] and won ($426.55) with a full house, Eights full of Threes
Seat 4: Fish4trips folded before Flop (didn't bet)
Seat 5: SoNe1988 (button) folded before Flop (didn't bet)
Seat 6: Yaaaazz (small blind) showed [Js Jh] and lost with two pair, Jacks and Threes
Seat 8: KDJAll3 (big blind) folded before Flop
Seat 9: a-talash folded before Flop (didn't bet)





PokerStars Hand #152558735706:  Hold'em No Limit ($1/$2 USD) - 2016/04/28 14:48:15 CET [2016/04/28 8:48:15 ET]
Table 'Idomeneus II' 9-max Seat #3 is the button
Seat 1: 13Ghosts ($214.22 in chips) 
Seat 2: libbyyww ($306.31 in chips) 
Seat 3: adrenalin333 ($176.37 in chips) 
Seat 4: SoNe1988 ($86.24 in chips) 
Seat 5: matiko09 ($211.36 in chips) 
Seat 7: ersevi6 ($156.61 in chips) 
Seat 9: Fish4trips ($207.68 in chips) 
SoNe1988: posts small blind $1
matiko09: posts big blind $2
*** HOLE CARDS ***
Dealt to matiko09 [2c 7s]
ersevi6: folds 
Fish4trips: raises $3 to $5
13Ghosts: folds 
libbyyww: folds 
aseban11 is disconnected 
adrenalin333 is disconnected 
adrenalin333 is connected 
adrenalin333: calls $5
SoNe1988: raises $13 to $18
matiko09: folds 
Fish4trips: folds 
adrenalin333: calls $13
*** FLOP *** [5c 7d 6c]
SoNe1988: checks 
adrenalin333: bets $24
SoNe1988: folds 
Uncalled bet ($24) returned to adrenalin333
adrenalin333 collected $40.85 from pot
adrenalin333: doesn't show hand 
*** SUMMARY ***
Total pot $43 | Rake $2.15 
Board [5c 7d 6c]
Seat 1: 13Ghosts folded before Flop (didn't bet)
Seat 2: libbyyww folded before Flop (didn't bet)
Seat 3: adrenalin333 (button) collected ($40.85)
Seat 4: SoNe1988 (small blind) folded on the Flop
Seat 5: matiko09 (big blind) folded before Flop
Seat 7: ersevi6 folded before Flop (didn't bet)
Seat 9: Fish4trips folded before Flop





PokerStars Hand #152558741681:  Hold'em No Limit ($0.50/$1.00 USD) - 2016/04/28 14:48:26 CET [2016/04/28 8:48:26 ET]
Table 'Azimech' 9-max Seat #5 is the button
Seat 1: peevoajax ($124.70 in chips) 
Seat 2: adikier ($236.35 in chips) 
Seat 3: matiko09 ($100 in chips) 
Seat 4: ruslik_by ($81.40 in chips) 
Seat 5: ozone2003 ($110.88 in chips) 
Seat 6: sanpidk ($100 in chips) 
Seat 7: azzad2007 ($103.20 in chips) 
Seat 8: vrnMike ($100 in chips) 
Seat 9: scottinsf ($62.90 in chips) 
sanpidk: posts small blind $0.50
azzad2007: posts big blind $1
*** HOLE CARDS ***
Dealt to matiko09 [4s 8h]
vrnMike: folds 
scottinsf: raises $2 to $3
peevoajax: calls $3
adikier: folds 
matiko09: folds 
ruslik_by: folds 
ozone2003: calls $3
sanpidk: folds 
azzad2007: folds 
*** FLOP *** [7h Qh Qs]
scottinsf: checks 
peevoajax: bets $6
ozone2003: folds 
scottinsf: folds 
Uncalled bet ($6) returned to peevoajax
peevoajax collected $9.98 from pot
peevoajax: doesn't show hand 
*** SUMMARY ***
Total pot $10.50 | Rake $0.52 
Board [7h Qh Qs]
Seat 1: peevoajax collected ($9.98)
Seat 2: adikier folded before Flop (didn't bet)
Seat 3: matiko09 folded before Flop (didn't bet)
Seat 4: ruslik_by folded before Flop (didn't bet)
Seat 5: ozone2003 (button) folded on the Flop
Seat 6: sanpidk (small blind) folded before Flop
Seat 7: azzad2007 (big blind) folded before Flop
Seat 8: vrnMike folded before Flop (didn't bet)
Seat 9: scottinsf folded on the Flop





PokerStars Hand #152558745066:  Hold'em No Limit ($0.50/$1.00 USD) - 2016/04/28 14:48:32 CET [2016/04/28 8:48:32 ET]
Table 'Ciurlionis' 9-max Seat #3 is the button
Seat 1: maxxmeister ($115.50 in chips) 
Seat 2: liuzhi14 ($237.63 in chips) 
Seat 3: koksskrt ($100 in chips) 
Seat 4: ruslik_by ($42 in chips) 
Seat 5: matiko09 ($100 in chips) 
Seat 6: I The King I ($100 in chips) 
Seat 7: Stopton ($91.68 in chips) 
Seat 8: WDW3 ($144.97 in chips) 
ruslik_by: posts small blind $0.50
matiko09: posts big blind $1
*** HOLE CARDS ***
Dealt to matiko09 [4c Ac]
aseban11 is disconnected 
I The King I: folds 
I The King I leaves the table
Stopton: folds 
WDW3: folds 
maxxmeister: folds 
peevoajax joins the table at seat #6 
liuzhi14: raises $1 to $2
koksskrt: folds 
ruslik_by: folds 
matiko09: calls $1
*** FLOP *** [Qd 3s Ad]
matiko09: checks 
liuzhi14: checks 
*** TURN *** [Qd 3s Ad] [Kc]
matiko09: bets $2.78
liuzhi14: calls $2.78
*** RIVER *** [Qd 3s Ad Kc] [Tc]
matiko09: checks 
liuzhi14: checks 
*** SHOW DOWN ***
matiko09: shows [4c Ac] (a pair of Aces)
liuzhi14: mucks hand 
matiko09 collected $9.56 from pot
*** SUMMARY ***
Total pot $10.06 | Rake $0.50 
Board [Qd 3s Ad Kc Tc]
Seat 1: maxxmeister folded before Flop (didn't bet)
Seat 2: liuzhi14 mucked [2h 3h]
Seat 3: koksskrt (button) folded before Flop (didn't bet)
Seat 4: ruslik_by (small blind) folded before Flop
Seat 5: matiko09 (big blind) showed [4c Ac] and won ($9.56) with a pair of Aces
Seat 6: I The King I folded before Flop (didn't bet)
Seat 7: Stopton folded before Flop (didn't bet)
Seat 8: WDW3 folded before Flop (didn't bet)





PokerStars Hand #152558745636:  Hold'em No Limit ($0.50/$1.00 USD) - 2016/04/28 14:48:33 CET [2016/04/28 8:48:33 ET]
Table 'Erynia' 9-max Seat #5 is the button
Seat 2: matiko09 ($155.03 in chips) 
Seat 4: WDW3 ($132.39 in chips) 
Seat 5: scottinsf ($38.99 in chips) 
Seat 6: peevoajax ($100 in chips) 
Seat 7: vrnMike ($113.30 in chips) 
Seat 8: YourKicker78 ($46.04 in chips) 
Seat 9: ruslik_by ($71.85 in chips) 
peevoajax: posts small blind $0.50
vrnMike: posts big blind $1
*** HOLE CARDS ***
Dealt to matiko09 [Ts Kd]
YourKicker78: folds 
aseban11 is disconnected 
ruslik_by: folds 
matiko09: folds 
WDW3: folds 
scottinsf: raises $2 to $3
peevoajax: folds 
vrnMike: folds 
Uncalled bet ($2) returned to scottinsf
scottinsf collected $2.50 from pot
scottinsf: doesn't show hand 
*** SUMMARY ***
Total pot $2.50 | Rake $0 
Seat 2: matiko09 folded before Flop (didn't bet)
Seat 4: WDW3 folded before Flop (didn't bet)
Seat 5: scottinsf (button) collected ($2.50)
Seat 6: peevoajax (small blind) folded before Flop
Seat 7: vrnMike (big blind) folded before Flop
Seat 8: YourKicker78 folded before Flop (didn't bet)
Seat 9: ruslik_by folded before Flop (didn't bet)





PokerStars Hand #152558746368:  Hold'em No Limit ($0.50/$1.00 USD) - 2016/04/28 14:48:35 CET [2016/04/28 8:48:35 ET]
Table 'Paris' 9-max Seat #2 is the button
Seat 1: matiko09 ($153.97 in chips) 
Seat 2: birdie1970 ($214.10 in chips) 
Seat 3: vrnMike ($101.80 in chips) 
Seat 4: koksskrt ($100 in chips) 
Seat 6: aseban11 ($137.50 in chips) 
Seat 7: Westpants ($141.60 in chips) 
Seat 8: Muric05 ($52.01 in chips) 
Seat 9: ruslik_by ($40 in chips) 
vrnMike: posts small blind $0.50
koksskrt: posts big blind $1
*** HOLE CARDS ***
Dealt to matiko09 [5c 6s]
aseban11: folds 
Westpants: folds 
aseban11 is disconnected 
Muric05: raises $3 to $4
ruslik_by: folds 
matiko09: folds 
birdie1970: calls $4
vrnMike: folds 
koksskrt: folds 
*** FLOP *** [5h Ts Tc]
Muric05: checks 
birdie1970: checks 
*** TURN *** [5h Ts Tc] [3c]
Muric05: checks 
birdie1970: bets $6
Muric05: folds 
Uncalled bet ($6) returned to birdie1970
birdie1970 collected $9.02 from pot
*** SUMMARY ***
Total pot $9.50 | Rake $0.48 
Board [5h Ts Tc 3c]
Seat 1: matiko09 folded before Flop (didn't bet)
Seat 2: birdie1970 (button) collected ($9.02)
Seat 3: vrnMike (small blind) folded before Flop
Seat 4: koksskrt (big blind) folded before Flop
Seat 6: aseban11 folded before Flop (didn't bet)
Seat 7: Westpants folded before Flop (didn't bet)
Seat 8: Muric05 folded on the Turn
Seat 9: ruslik_by folded before Flop (didn't bet)





PokerStars Hand #152558751106:  Hold'em No Limit (€0.50/€1.00 EUR) - 2016/04/28 14:48:43 CET [2016/04/28 8:48:43 ET]
Table 'Lumiere II' 9-max Seat #9 is the button
Seat 1: vrnMike (€100 in chips) 
Seat 2: Racushniak (€100 in chips) 
Seat 3: ozone2003 (€104.73 in chips) 
Seat 4: ruslik_by (€64.70 in chips) 
Seat 5: Schmidy7 (€39 in chips) 
Seat 6: HasBigBiceps (€100 in chips) 
Seat 7: hammerwife (€106.62 in chips) 
Seat 8: WDW3 (€103 in chips) 
Seat 9: matiko09 (€100 in chips) 
vrnMike: posts small blind €0.50
Racushniak: posts big blind €1
*** HOLE CARDS ***
Dealt to matiko09 [4h 5d]
ozone2003: folds 
ruslik_by: folds 
Schmidy7: folds 
HasBigBiceps: raises €1.06 to €2.06
hammerwife: raises €5.94 to €8
WDW3: folds 
matiko09: folds 
vrnMike: folds 
Racushniak: folds 
HasBigBiceps: folds 
Uncalled bet (€5.94) returned to hammerwife
hammerwife collected €5.62 from pot
hammerwife: doesn't show hand 
*** SUMMARY ***
Total pot €5.62 | Rake €0 
Seat 1: vrnMike (small blind) folded before Flop
Seat 2: Racushniak (big blind) folded before Flop
Seat 3: ozone2003 folded before Flop (didn't bet)
Seat 4: ruslik_by folded before Flop (didn't bet)
Seat 5: Schmidy7 folded before Flop (didn't bet)
Seat 6: HasBigBiceps folded before Flop
Seat 7: hammerwife collected (€5.62)
Seat 8: WDW3 folded before Flop (didn't bet)
Seat 9: matiko09 (button) folded before Flop (didn't bet)





PokerStars Hand #152558756853:  Hold'em No Limit (€0.50/€1.00 EUR) - 2016/04/28 14:48:53 CET [2016/04/28 8:48:53 ET]
Table 'Clivia II' 9-max Seat #8 is the button
Seat 1: piperkova (€49.88 in chips) 
Seat 2: HasBigBiceps (€100 in chips) 
Seat 3: R1aki (€100 in chips) 
Seat 4: matiko09 (€100 in chips) 
Seat 5: WDW3 (€125.50 in chips) 
Seat 6: ruslik_by (€61.43 in chips) 
Seat 7: St.LaCoste (€100 in chips) 
Seat 8: Dantist1122 (€100 in chips) 
Seat 9: ozone2003 (€100.50 in chips) 
ozone2003: posts small blind €0.50
piperkova: posts big blind €1
*** HOLE CARDS ***
Dealt to matiko09 [Ks 7s]
HasBigBiceps: folds 
R1aki: folds 
matiko09: folds 
WDW3: folds 
ruslik_by: raises €2 to €3
St.LaCoste: folds 
Dantist1122: folds 
ozone2003: folds 
piperkova: folds 
Uncalled bet (€2) returned to ruslik_by
ruslik_by collected €2.50 from pot
ruslik_by: doesn't show hand 
*** SUMMARY ***
Total pot €2.50 | Rake €0 
Seat 1: piperkova (big blind) folded before Flop
Seat 2: HasBigBiceps folded before Flop (didn't bet)
Seat 3: R1aki folded before Flop (didn't bet)
Seat 4: matiko09 folded before Flop (didn't bet)
Seat 5: WDW3 folded before Flop (didn't bet)
Seat 6: ruslik_by collected (€2.50)
Seat 7: St.LaCoste folded before Flop (didn't bet)
Seat 8: Dantist1122 (button) folded before Flop (didn't bet)
Seat 9: ozone2003 (small blind) folded before Flop





PokerStars Hand #152558757868:  Hold'em No Limit ($0.50/$1.00 USD) - 2016/04/28 14:48:55 CET [2016/04/28 8:48:55 ET]
Table 'Lyot' 9-max Seat #6 is the button
Seat 1: matiko09 ($115.11 in chips) 
Seat 2: vrnMike ($139.85 in chips) 
Seat 4: WDW3 ($101.04 in chips) 
Seat 6: Monglaer ($97.67 in chips) 
Seat 7: PreMoze ($97.97 in chips) 
Seat 8: Patz B ($12.49 in chips) 
Seat 9: koksskrt ($100 in chips) 
PreMoze: posts small blind $0.50
Patz B: posts big blind $1
matiko09: posts the ante $0.20
vrnMike: posts the ante $0.20
WDW3: posts the ante $0.20
Monglaer: posts the ante $0.20
PreMoze: posts the ante $0.20
Patz B: posts the ante $0.20
koksskrt: posts the ante $0.20
*** HOLE CARDS ***
Dealt to matiko09 [3h Kd]
koksskrt: folds 
matiko09: folds 
vrnMike: folds 
WDW3: folds 
Monglaer: raises $2 to $3
PreMoze: calls $2.50
Patz B: folds 
*** FLOP *** [7s Tc 9s]
PreMoze: checks 
Monglaer: checks 
*** TURN *** [7s Tc 9s] [4d]
PreMoze: bets $2
Monglaer: raises $4 to $6
PreMoze: calls $4
*** RIVER *** [7s Tc 9s 4d] [As]
PreMoze: bets $20
Monglaer: calls $20
*** SHOW DOWN ***
PreMoze: shows [5h Jh] (high card Ace)
Monglaer: shows [Jc Js] (a pair of Jacks)
Monglaer collected $57.90 from pot
*** SUMMARY ***
Total pot $60.40 | Rake $2.50 
Board [7s Tc 9s 4d As]
Seat 1: matiko09 folded before Flop (didn't bet)
Seat 2: vrnMike folded before Flop (didn't bet)
Seat 4: WDW3 folded before Flop (didn't bet)
Seat 6: Monglaer (button) showed [Jc Js] and won ($57.90) with a pair of Jacks
Seat 7: PreMoze (small blind) showed [5h Jh] and lost with high card Ace
Seat 8: Patz B (big blind) folded before Flop
Seat 9: koksskrt folded before Flop (didn't bet)





PokerStars Hand #152558760036:  Hold'em No Limit ($0.50/$1.00 USD) - 2016/04/28 14:48:59 CET [2016/04/28 8:48:59 ET]
Table 'Erynia' 9-max Seat #6 is the button
Seat 2: matiko09 ($155.03 in chips) 
Seat 4: WDW3 ($132.39 in chips) 
Seat 5: scottinsf ($40.49 in chips) 
Seat 6: peevoajax ($100 in chips) 
Seat 7: vrnMike ($112.30 in chips) 
Seat 8: YourKicker78 ($46.04 in chips) 
Seat 9: ruslik_by ($71.85 in chips) 
vrnMike: posts small blind $0.50
YourKicker78: posts big blind $1
*** HOLE CARDS ***
Dealt to matiko09 [8h Ks]
ruslik_by: folds 
matiko09: folds 
WDW3: folds 
scottinsf: folds 
peevoajax: folds 
vrnMike: raises $1 to $2
YourKicker78: calls $1
*** FLOP *** [Jc 2c Tc]
vrnMike: bets $2
YourKicker78: calls $2
*** TURN *** [Jc 2c Tc] [6d]
vrnMike: bets $3
YourKicker78: calls $3
*** RIVER *** [Jc 2c Tc 6d] [Qd]
vrnMike: checks 
YourKicker78: checks 
*** SHOW DOWN ***
vrnMike: shows [2s Ac] (a pair of Deuces)
YourKicker78: mucks hand 
vrnMike collected $13.30 from pot
*** SUMMARY ***
Total pot $14 | Rake $0.70 
Board [Jc 2c Tc 6d Qd]
Seat 2: matiko09 folded before Flop (didn't bet)
Seat 4: WDW3 folded before Flop (didn't bet)
Seat 5: scottinsf folded before Flop (didn't bet)
Seat 6: peevoajax (button) folded before Flop (didn't bet)
Seat 7: vrnMike (small blind) showed [2s Ac] and won ($13.30) with a pair of Deuces
Seat 8: YourKicker78 (big blind) mucked [4c 5s]
Seat 9: ruslik_by folded before Flop (didn't bet)





PokerStars Hand #152558765660:  Hold'em No Limit ($0.50/$1.00 USD) - 2016/04/28 14:49:09 CET [2016/04/28 8:49:09 ET]
Table 'Zachia II' 9-max Seat #4 is the button
Seat 1: greyman571 ($85.34 in chips) 
Seat 2: sanpidk ($162.13 in chips) 
Seat 3: matiko09 ($100 in chips) 
Seat 4: omorfadramou ($104.47 in chips) 
Seat 5: vrnMike ($100.50 in chips) 
Seat 6: maxxmeister ($103.50 in chips) 
Seat 7: ozone2003 ($101.50 in chips) 
Seat 9: I The King I ($101.50 in chips) 
vrnMike: posts small blind $0.50
maxxmeister: posts big blind $1
*** HOLE CARDS ***
Dealt to matiko09 [6d 8d]
ozone2003: folds 
I The King I: folds 
greyman571: raises $2 to $3
sanpidk: raises $5 to $8
matiko09: folds 
omorfadramou: folds 
vrnMike: raises $11 to $19
maxxmeister: folds 
greyman571: folds 
sanpidk: folds 
Uncalled bet ($11) returned to vrnMike
vrnMike collected $20 from pot
*** SUMMARY ***
Total pot $20 | Rake $0 
Seat 1: greyman571 folded before Flop
Seat 2: sanpidk folded before Flop
Seat 3: matiko09 folded before Flop (didn't bet)
Seat 4: omorfadramou (button) folded before Flop (didn't bet)
Seat 5: vrnMike (small blind) collected ($20)
Seat 6: maxxmeister (big blind) folded before Flop
Seat 7: ozone2003 folded before Flop (didn't bet)
Seat 9: I The King I folded before Flop (didn't bet)





PokerStars Hand #152558768921:  Hold'em No Limit (€0.50/€1.00 EUR) - 2016/04/28 14:49:15 CET [2016/04/28 8:49:15 ET]
Table 'Lumiere II' 9-max Seat #1 is the button
Seat 1: vrnMike (€100 in chips) 
Seat 2: Racushniak (€100 in chips) 
Seat 3: ozone2003 (€104.73 in chips) 
Seat 4: ruslik_by (€64.70 in chips) 
Seat 5: Schmidy7 (€39 in chips) 
Seat 6: HasBigBiceps (€100 in chips) 
Seat 7: hammerwife (€110.18 in chips) 
Seat 8: WDW3 (€103 in chips) 
Seat 9: matiko09 (€100 in chips) 
Racushniak: posts small blind €0.50
ozone2003: posts big blind €1
*** HOLE CARDS ***
Dealt to matiko09 [8c 6c]
ruslik_by: folds 
Schmidy7: folds 
HasBigBiceps: folds 
hammerwife: raises €1.50 to €2.50
WDW3: folds 
matiko09: folds 
vrnMike: folds 
Racushniak: raises €6.50 to €9
ozone2003: folds 
hammerwife: raises €13 to €22
Racushniak: folds 
Uncalled bet (€13) returned to hammerwife
hammerwife collected €19 from pot
hammerwife: doesn't show hand 
*** SUMMARY ***
Total pot €19 | Rake €0 
Seat 1: vrnMike (button) folded before Flop (didn't bet)
Seat 2: Racushniak (small blind) folded before Flop
Seat 3: ozone2003 (big blind) folded before Flop
Seat 4: ruslik_by folded before Flop (didn't bet)
Seat 5: Schmidy7 folded before Flop (didn't bet)
Seat 6: HasBigBiceps folded before Flop (didn't bet)
Seat 7: hammerwife collected (€19)
Seat 8: WDW3 folded before Flop (didn't bet)
Seat 9: matiko09 folded before Flop (didn't bet)





PokerStars Hand #152558771349:  Hold'em No Limit ($0.50/$1.00 USD) - 2016/04/28 14:49:19 CET [2016/04/28 8:49:19 ET]
Table 'Azimech' 9-max Seat #6 is the button
Seat 1: peevoajax ($131.68 in chips) 
Seat 2: adikier ($236.35 in chips) 
Seat 3: matiko09 ($100 in chips) 
Seat 4: ruslik_by ($81.40 in chips) 
Seat 5: ozone2003 ($107.88 in chips) 
Seat 6: sanpidk ($100 in chips) 
Seat 7: azzad2007 ($102.20 in chips) 
Seat 8: vrnMike ($100 in chips) 
Seat 9: scottinsf ($59.90 in chips) 
azzad2007: posts small blind $0.50
vrnMike: posts big blind $1
*** HOLE CARDS ***
Dealt to matiko09 [2h 8h]
scottinsf: folds 
peevoajax: folds 
adikier: raises $2 to $3
matiko09: folds 
ruslik_by: folds 
ozone2003: folds 
sanpidk: folds 
azzad2007: folds 
vrnMike: folds 
Uncalled bet ($2) returned to adikier
adikier collected $2.50 from pot
adikier: doesn't show hand 
*** SUMMARY ***
Total pot $2.50 | Rake $0 
Seat 1: peevoajax folded before Flop (didn't bet)
Seat 2: adikier collected ($2.50)
Seat 3: matiko09 folded before Flop (didn't bet)
Seat 4: ruslik_by folded before Flop (didn't bet)
Seat 5: ozone2003 folded before Flop (didn't bet)
Seat 6: sanpidk (button) folded before Flop (didn't bet)
Seat 7: azzad2007 (small blind) folded before Flop
Seat 8: vrnMike (big blind) folded before Flop
Seat 9: scottinsf folded before Flop (didn't bet)





PokerStars Hand #152558774178:  Hold'em No Limit ($0.50/$1.00 USD) - 2016/04/28 14:49:24 CET [2016/04/28 8:49:24 ET]
Table 'Ciurlionis' 9-max Seat #4 is the button
Seat 1: maxxmeister ($115.50 in chips) 
Seat 2: liuzhi14 ($232.85 in chips) 
Seat 3: koksskrt ($100 in chips) 
Seat 4: ruslik_by ($41.50 in chips) 
Seat 5: matiko09 ($104.78 in chips) 
Seat 6: peevoajax ($100 in chips) 
Seat 7: Stopton ($91.68 in chips) 
Seat 8: WDW3 ($144.97 in chips) 
matiko09: posts small blind $0.50
peevoajax: posts big blind $1
*** HOLE CARDS ***
Dealt to matiko09 [Qh 9d]
Stopton: folds 
WDW3: raises $1.80 to $2.80
maxxmeister: folds 
liuzhi14: calls $2.80
koksskrt: folds 
ruslik_by: folds 
matiko09: folds 
peevoajax: folds 
*** FLOP *** [Qs 9h 4d]
WDW3: checks 
liuzhi14: bets $6
WDW3: folds 
Uncalled bet ($6) returned to liuzhi14
liuzhi14 collected $6.74 from pot
liuzhi14: doesn't show hand 
*** SUMMARY ***
Total pot $7.10 | Rake $0.36 
Board [Qs 9h 4d]
Seat 1: maxxmeister folded before Flop (didn't bet)
Seat 2: liuzhi14 collected ($6.74)
Seat 3: koksskrt folded before Flop (didn't bet)
Seat 4: ruslik_by (button) folded before Flop (didn't bet)
Seat 5: matiko09 (small blind) folded before Flop
Seat 6: peevoajax (big blind) folded before Flop
Seat 7: Stopton folded before Flop (didn't bet)
Seat 8: WDW3 folded on the Flop





PokerStars Hand #152558776193:  Hold'em No Limit ($1/$2 USD) - 2016/04/28 14:49:28 CET [2016/04/28 8:49:28 ET]
Table 'Simonida II' 9-max Seat #9 is the button
Seat 1: 13Ghosts ($201 in chips) 
Seat 2: snow937022 ($226.58 in chips) 
Seat 3: WDW3 ($222.59 in chips) 
Seat 4: a-talash ($171.92 in chips) 
Seat 5: matiko09 ($206 in chips) 
Seat 6: ocarey86 ($151.47 in chips) 
Seat 7: Fish4trips ($200 in chips) 
Seat 8: Sutt_420 ($119.49 in chips) 
Seat 9: prominente ($203 in chips) 
13Ghosts: posts small blind $1
snow937022: posts big blind $2
*** HOLE CARDS ***
Dealt to matiko09 [Qc 6d]
WDW3: folds 
a-talash: folds 
matiko09: folds 
ocarey86: folds 
Fish4trips: folds 
Sutt_420: raises $2 to $4
prominente: folds 
13Ghosts: folds 
snow937022: folds 
Uncalled bet ($2) returned to Sutt_420
Sutt_420 collected $5 from pot
*** SUMMARY ***
Total pot $5 | Rake $0 
Seat 1: 13Ghosts (small blind) folded before Flop
Seat 2: snow937022 (big blind) folded before Flop
Seat 3: WDW3 folded before Flop (didn't bet)
Seat 4: a-talash folded before Flop (didn't bet)
Seat 5: matiko09 folded before Flop (didn't bet)
Seat 6: ocarey86 folded before Flop (didn't bet)
Seat 7: Fish4trips folded before Flop (didn't bet)
Seat 8: Sutt_420 collected ($5)
Seat 9: prominente (button) folded before Flop (didn't bet)





PokerStars Hand #152558780111:  Hold'em No Limit ($1/$2 USD) - 2016/04/28 14:49:35 CET [2016/04/28 8:49:35 ET]
Table 'Helio' 9-max Seat #6 is the button
Seat 1: prominente ($411.35 in chips) 
Seat 2: peevoajax ($206 in chips) 
Seat 3: InsomniaRU ($200 in chips) 
Seat 4: ersevi6 ($129.66 in chips) 
Seat 5: pretender 19 ($191.42 in chips) 
Seat 6: matiko09 ($200 in chips) 
Seat 9: rmanjkeee ($89.75 in chips) 
wiseyoyo will be allowed to play after the button
rmanjkeee: posts small blind $1
prominente: posts big blind $2
*** HOLE CARDS ***
Dealt to matiko09 [Kd 6c]
peevoajax: folds 
InsomniaRU: raises $3 to $5
ersevi6: calls $5
pretender 19: folds 
matiko09: folds 
rmanjkeee: folds 
prominente: raises $19 to $24
InsomniaRU: folds 
ersevi6: folds 
Uncalled bet ($19) returned to prominente
prominente collected $16 from pot
prominente: doesn't show hand 
*** SUMMARY ***
Total pot $16 | Rake $0 
Seat 1: prominente (big blind) collected ($16)
Seat 2: peevoajax folded before Flop (didn't bet)
Seat 3: InsomniaRU folded before Flop
Seat 4: ersevi6 folded before Flop
Seat 5: pretender 19 folded before Flop (didn't bet)
Seat 6: matiko09 (button) folded before Flop (didn't bet)
Seat 9: rmanjkeee (small blind) folded before Flop





PokerStars Hand #152558782310:  Hold'em No Limit (€0.50/€1.00 EUR) - 2016/04/28 14:49:39 CET [2016/04/28 8:49:39 ET]
Table 'Clivia II' 9-max Seat #9 is the button
Seat 1: piperkova (€48.88 in chips) 
Seat 2: HasBigBiceps (€100 in chips) 
Seat 3: R1aki (€100 in chips) 
Seat 4: matiko09 (€100 in chips) 
Seat 5: WDW3 (€125.50 in chips) 
Seat 6: ruslik_by (€62.93 in chips) 
Seat 7: St.LaCoste (€100 in chips) 
Seat 8: Dantist1122 (€100 in chips) 
Seat 9: ozone2003 (€100 in chips) 
piperkova: posts small blind €0.50
HasBigBiceps: posts big blind €1
*** HOLE CARDS ***
Dealt to matiko09 [2s 5c]
R1aki: folds 
matiko09: folds 
WDW3: folds 
ruslik_by: folds 
St.LaCoste: folds 
Dantist1122: folds 
ozone2003: folds 
piperkova: calls €0.50
HasBigBiceps: checks 
*** FLOP *** [Ac Kd Js]
piperkova: bets €1
HasBigBiceps: calls €1
*** TURN *** [Ac Kd Js] [7h]
piperkova: bets €1
HasBigBiceps: calls €1
*** RIVER *** [Ac Kd Js 7h] [9c]
piperkova: bets €2.85
HasBigBiceps: calls €2.85
*** SHOW DOWN ***
piperkova: shows [Kc 8h] (a pair of Kings)
HasBigBiceps: shows [Ks 8c] (a pair of Kings)
piperkova collected €5.56 from pot
HasBigBiceps collected €5.56 from pot
*** SUMMARY ***
Total pot €11.70 | Rake €0.58 
Board [Ac Kd Js 7h 9c]
Seat 1: piperkova (small blind) showed [Kc 8h] and won (€5.56) with a pair of Kings
Seat 2: HasBigBiceps (big blind) showed [Ks 8c] and won (€5.56) with a pair of Kings
Seat 3: R1aki folded before Flop (didn't bet)
Seat 4: matiko09 folded before Flop (didn't bet)
Seat 5: WDW3 folded before Flop (didn't bet)
Seat 6: ruslik_by folded before Flop (didn't bet)
Seat 7: St.LaCoste folded before Flop (didn't bet)
Seat 8: Dantist1122 folded before Flop (didn't bet)
Seat 9: ozone2003 (button) folded before Flop (didn't bet)





PokerStars Hand #152558783884:  Hold'em No Limit ($0.50/$1.00 USD) - 2016/04/28 14:49:42 CET [2016/04/28 8:49:42 ET]
Table 'Bruwer' 9-max Seat #4 is the button
Seat 2: ruslik_by ($40 in chips) 
Seat 3: koksskrt ($109.11 in chips) 
Seat 4: matiko09 ($141.04 in chips) 
Seat 5: Carloszhang ($128.48 in chips) 
Seat 6: I The King I ($112.52 in chips) 
Seat 7: R1aki ($248.58 in chips) 
Seat 8: WDW3 ($109.52 in chips) 
Seat 9: Dantist1122 ($124.41 in chips) 
Carloszhang: posts small blind $0.50
I The King I: posts big blind $1
*** HOLE CARDS ***
Dealt to matiko09 [7d Th]
R1aki: folds 
WDW3: raises $1.80 to $2.80
Dantist1122: calls $2.80
ruslik_by: folds 
koksskrt: folds 
matiko09: folds 
Carloszhang: folds 
I The King I: folds 
*** FLOP *** [Ks 6s 4s]
WDW3: checks 
Dantist1122: checks 
*** TURN *** [Ks 6s 4s] [Jh]
WDW3: bets $4
Dantist1122: folds 
Uncalled bet ($4) returned to WDW3
WDW3 collected $6.74 from pot
WDW3: doesn't show hand 
*** SUMMARY ***
Total pot $7.10 | Rake $0.36 
Board [Ks 6s 4s Jh]
Seat 2: ruslik_by folded before Flop (didn't bet)
Seat 3: koksskrt folded before Flop (didn't bet)
Seat 4: matiko09 (button) folded before Flop (didn't bet)
Seat 5: Carloszhang (small blind) folded before Flop
Seat 6: I The King I (big blind) folded before Flop
Seat 7: R1aki folded before Flop (didn't bet)
Seat 8: WDW3 collected ($6.74)
Seat 9: Dantist1122 folded on the Turn





PokerStars Hand #152558784111:  Hold'em No Limit ($0.50/$1.00 USD) - 2016/04/28 14:49:42 CET [2016/04/28 8:49:42 ET]
Table 'Erynia' 9-max Seat #7 is the button
Seat 2: matiko09 ($155.03 in chips) 
Seat 4: WDW3 ($132.39 in chips) 
Seat 5: scottinsf ($40.49 in chips) 
Seat 6: peevoajax ($100 in chips) 
Seat 7: vrnMike ($118.60 in chips) 
Seat 8: YourKicker78 ($39.04 in chips) 
Seat 9: ruslik_by ($71.85 in chips) 
YourKicker78: posts small blind $0.50
ruslik_by: posts big blind $1
*** HOLE CARDS ***
Dealt to matiko09 [Js 4h]
matiko09: folds 
WDW3: folds 
scottinsf: folds 
peevoajax: folds 
vrnMike: folds 
YourKicker78: raises $2 to $3
ruslik_by: calls $2
*** FLOP *** [3d 9h 6d]
YourKicker78: bets $4
ruslik_by: calls $4
*** TURN *** [3d 9h 6d] [5h]
YourKicker78: checks 
ruslik_by: bets $4.50
YourKicker78: calls $4.50
*** RIVER *** [3d 9h 6d 5h] [4d]
YourKicker78: checks 
ruslik_by: checks 
*** SHOW DOWN ***
YourKicker78: shows [3s Qc] (a pair of Threes)
ruslik_by: mucks hand 
YourKicker78 collected $21.85 from pot
*** SUMMARY ***
Total pot $23 | Rake $1.15 
Board [3d 9h 6d 5h 4d]
Seat 2: matiko09 folded before Flop (didn't bet)
Seat 4: WDW3 folded before Flop (didn't bet)
Seat 5: scottinsf folded before Flop (didn't bet)
Seat 6: peevoajax folded before Flop (didn't bet)
Seat 7: vrnMike (button) folded before Flop (didn't bet)
Seat 8: YourKicker78 (small blind) showed [3s Qc] and won ($21.85) with a pair of Threes
Seat 9: ruslik_by (big blind) mucked [8h Qh]





PokerStars Hand #152558785542:  Hold'em No Limit ($0.50/$1.00 USD) - 2016/04/28 14:49:45 CET [2016/04/28 8:49:45 ET]
Table 'Paris' 9-max Seat #3 is the button
Seat 1: matiko09 ($153.97 in chips) 
Seat 2: birdie1970 ($219.12 in chips) 
Seat 3: vrnMike ($101.30 in chips) 
Seat 4: koksskrt ($100 in chips) 
Seat 7: Westpants ($141.60 in chips) 
Seat 8: Muric05 ($48.01 in chips) 
Seat 9: ruslik_by ($40 in chips) 
koksskrt: posts small blind $0.50
aseban11 has timed out while disconnected
aseban11: is sitting out 
Westpants: posts big blind $1
*** HOLE CARDS ***
Dealt to matiko09 [Kd 5s]
Muric05: folds 
ruslik_by: folds 
matiko09: folds 
birdie1970: raises $1.50 to $2.50
vrnMike: folds 
koksskrt: folds 
Westpants: calls $1.50
*** FLOP *** [2d 4s 5h]
Westpants: checks 
birdie1970: bets $4
Westpants: calls $4
*** TURN *** [2d 4s 5h] [8s]
Westpants: checks 
birdie1970: bets $6
Westpants: folds 
Uncalled bet ($6) returned to birdie1970
birdie1970 collected $12.82 from pot
*** SUMMARY ***
Total pot $13.50 | Rake $0.68 
Board [2d 4s 5h 8s]
Seat 1: matiko09 folded before Flop (didn't bet)
Seat 2: birdie1970 collected ($12.82)
Seat 3: vrnMike (button) folded before Flop (didn't bet)
Seat 4: koksskrt (small blind) folded before Flop
Seat 7: Westpants (big blind) folded on the Turn
Seat 8: Muric05 folded before Flop (didn't bet)
Seat 9: ruslik_by folded before Flop (didn't bet)





PokerStars Hand #152558787280:  Hold'em No Limit ($0.50/$1.00 USD) - 2016/04/28 14:49:48 CET [2016/04/28 8:49:48 ET]
Table 'Azimech' 9-max Seat #7 is the button
Seat 1: peevoajax ($131.68 in chips) 
Seat 2: adikier ($237.85 in chips) 
Seat 3: matiko09 ($100 in chips) 
Seat 4: ruslik_by ($81.40 in chips) 
Seat 5: ozone2003 ($107.88 in chips) 
Seat 6: sanpidk ($100 in chips) 
Seat 7: azzad2007 ($101.70 in chips) 
Seat 8: vrnMike ($100 in chips) 
Seat 9: scottinsf ($59.90 in chips) 
vrnMike: posts small blind $0.50
scottinsf: posts big blind $1
*** HOLE CARDS ***
Dealt to matiko09 [Tc 2h]
peevoajax: raises $2 to $3
adikier: folds 
matiko09: folds 
ruslik_by: folds 
ozone2003: folds 
sanpidk: folds 
azzad2007: folds 
vrnMike: folds 
scottinsf: folds 
Uncalled bet ($2) returned to peevoajax
peevoajax collected $2.50 from pot
peevoajax: doesn't show hand 
*** SUMMARY ***
Total pot $2.50 | Rake $0 
Seat 1: peevoajax collected ($2.50)
Seat 2: adikier folded before Flop (didn't bet)
Seat 3: matiko09 folded before Flop (didn't bet)
Seat 4: ruslik_by folded before Flop (didn't bet)
Seat 5: ozone2003 folded before Flop (didn't bet)
Seat 6: sanpidk folded before Flop (didn't bet)
Seat 7: azzad2007 (button) folded before Flop (didn't bet)
Seat 8: vrnMike (small blind) folded before Flop
Seat 9: scottinsf (big blind) folded before Flop





PokerStars Hand #152558792194:  Hold'em No Limit ($1/$2 USD) - 2016/04/28 14:49:57 CET [2016/04/28 8:49:57 ET]
Table 'Libera II' 9-max Seat #1 is the button
Seat 1: libbyyww ($200 in chips) 
Seat 2: peevoajax ($214.35 in chips) 
Seat 3: maverick7614 ($200 in chips) 
Seat 4: Sly-Hustler ($90.80 in chips) 
Seat 5: ersevi6 ($138.30 in chips) 
Seat 6: matiko09 ($200 in chips) 
Seat 7: Fish4trips ($400.25 in chips) 
Seat 8: WDW3 ($206.89 in chips) 
Seat 9: InsomniaRU ($200 in chips) 
peevoajax: posts small blind $1
maverick7614: posts big blind $2
*** HOLE CARDS ***
Dealt to matiko09 [7c Ad]
Sly-Hustler: folds 
ersevi6: folds 
matiko09: folds 
Fish4trips: raises $3 to $5
WDW3: folds 
InsomniaRU: folds 
libbyyww: calls $5
peevoajax: calls $4
maverick7614: folds 
*** FLOP *** [6h Qd 3s]
peevoajax: checks 
Fish4trips: checks 
libbyyww: bets $9.69
peevoajax: calls $9.69
Fish4trips: folds 
*** TURN *** [6h Qd 3s] [3d]
peevoajax: checks 
libbyyww: checks 
*** RIVER *** [6h Qd 3s 3d] [2c]
peevoajax: checks 
libbyyww: checks 
*** SHOW DOWN ***
peevoajax: shows [4c 4d] (two pair, Fours and Threes)
libbyyww: mucks hand 
peevoajax collected $34.56 from pot
*** SUMMARY ***
Total pot $36.38 | Rake $1.82 
Board [6h Qd 3s 3d 2c]
Seat 1: libbyyww (button) mucked [Ac Ks]
Seat 2: peevoajax (small blind) showed [4c 4d] and won ($34.56) with two pair, Fours and Threes
Seat 3: maverick7614 (big blind) folded before Flop
Seat 4: Sly-Hustler folded before Flop (didn't bet)
Seat 5: ersevi6 folded before Flop (didn't bet)
Seat 6: matiko09 folded before Flop (didn't bet)
Seat 7: Fish4trips folded on the Flop
Seat 8: WDW3 folded before Flop (didn't bet)
Seat 9: InsomniaRU folded before Flop (didn't bet)





PokerStars Hand #152558794735:  Hold'em No Limit ($1/$2 USD) - 2016/04/28 14:50:01 CET [2016/04/28 8:50:01 ET]
Table 'Mireille' 9-max Seat #6 is the button
Seat 2: matiko09 ($200 in chips) 
Seat 3: MZ2502 ($426.55 in chips) 
Seat 4: Fish4trips ($230.23 in chips) 
Seat 5: SoNe1988 ($118.42 in chips) 
Seat 6: Yaaaazz ($200 in chips) 
Seat 8: KDJAll3 ($917.68 in chips) 
Seat 9: a-talash ($155.30 in chips) 
KDJAll3: posts small blind $1
a-talash: posts big blind $2
*** HOLE CARDS ***
Dealt to matiko09 [2s Jc]
matiko09: folds 
MZ2502: folds 
Fish4trips: folds 
SoNe1988: folds 
Yaaaazz: raises $2.40 to $4.40
KDJAll3: calls $3.40
a-talash: folds 
*** FLOP *** [4s Tc 5d]
KDJAll3: checks 
Yaaaazz: checks 
*** TURN *** [4s Tc 5d] [4c]
KDJAll3: bets $4
Yaaaazz: calls $4
*** RIVER *** [4s Tc 5d 4c] [3s]
KDJAll3: bets $10
Yaaaazz: calls $10
*** SHOW DOWN ***
KDJAll3: shows [Kd Td] (two pair, Tens and Fours)
Yaaaazz: mucks hand 
KDJAll3 collected $36.86 from pot
*** SUMMARY ***
Total pot $38.80 | Rake $1.94 
Board [4s Tc 5d 4c 3s]
Seat 2: matiko09 folded before Flop (didn't bet)
Seat 3: MZ2502 folded before Flop (didn't bet)
Seat 4: Fish4trips folded before Flop (didn't bet)
Seat 5: SoNe1988 folded before Flop (didn't bet)
Seat 6: Yaaaazz (button) mucked [5h Kh]
Seat 8: KDJAll3 (small blind) showed [Kd Td] and won ($36.86) with two pair, Tens and Fours
Seat 9: a-talash (big blind) folded before Flop





PokerStars Hand #152558795513:  Hold'em No Limit ($0.50/$1.00 USD) - 2016/04/28 14:50:03 CET [2016/04/28 8:50:03 ET]
Table 'Lyot' 9-max Seat #7 is the button
Seat 1: matiko09 ($114.91 in chips) 
Seat 2: vrnMike ($139.65 in chips) 
Seat 4: WDW3 ($100.84 in chips) 
Seat 6: Monglaer ($126.37 in chips) 
Seat 7: PreMoze ($68.77 in chips) 
Seat 8: Patz B ($11.29 in chips) 
Seat 9: koksskrt ($100 in chips) 
Patz B: posts small blind $0.50
koksskrt: posts big blind $1
matiko09: posts the ante $0.20
vrnMike: posts the ante $0.20
WDW3: posts the ante $0.20
Monglaer: posts the ante $0.20
PreMoze: posts the ante $0.20
Patz B: posts the ante $0.20
koksskrt: posts the ante $0.20
*** HOLE CARDS ***
Dealt to matiko09 [2h 5s]
matiko09: folds 
vrnMike: folds 
WDW3: folds 
Monglaer: folds 
PreMoze: calls $1
Patz B: calls $0.50
koksskrt: checks 
*** FLOP *** [Th Qs Ac]
PreMoze said, "how dis you call that!"
Patz B: checks 
koksskrt: checks 
PreMoze: checks 
*** TURN *** [Th Qs Ac] [Jh]
Patz B: checks 
koksskrt: checks 
PreMoze: bets $1
Patz B: raises $2 to $3
koksskrt: folds 
PreMoze: calls $2
*** RIVER *** [Th Qs Ac Jh] [Ks]
Patz B: bets $7.09 and is all-in
PreMoze: calls $7.09
*** SHOW DOWN ***
Patz B: shows [7c Kc] (a straight, Ten to Ace)
PreMoze: shows [Kd Kh] (a straight, Ten to Ace)
Patz B collected $11.68 from pot
PreMoze collected $11.67 from pot
*** SUMMARY ***
Total pot $24.58 | Rake $1.23 
Board [Th Qs Ac Jh Ks]
Seat 1: matiko09 folded before Flop (didn't bet)
Seat 2: vrnMike folded before Flop (didn't bet)
Seat 4: WDW3 folded before Flop (didn't bet)
Seat 6: Monglaer folded before Flop (didn't bet)
Seat 7: PreMoze (button) showed [Kd Kh] and won ($11.67) with a straight, Ten to Ace
Seat 8: Patz B (small blind) showed [7c Kc] and won ($11.68) with a straight, Ten to Ace
Seat 9: koksskrt (big blind) folded on the Turn





PokerStars Hand #152558804561:  Hold'em No Limit (€0.50/€1.00 EUR) - 2016/04/28 14:50:19 CET [2016/04/28 8:50:19 ET]
Table 'Lumiere II' 9-max Seat #2 is the button
Seat 1: vrnMike (€100 in chips) 
Seat 2: Racushniak (€100 in chips) 
Seat 3: ozone2003 (€103.73 in chips) 
Seat 4: ruslik_by (€64.70 in chips) 
Seat 5: Schmidy7 (€39 in chips) 
Seat 6: HasBigBiceps (€100 in chips) 
Seat 7: hammerwife (€120.18 in chips) 
Seat 8: WDW3 (€103 in chips) 
Seat 9: matiko09 (€100 in chips) 
ozone2003: posts small blind €0.50
ruslik_by: posts big blind €1
*** HOLE CARDS ***
Dealt to matiko09 [6s 4h]
Schmidy7: calls €1
HasBigBiceps: folds 
hammerwife: raises €3 to €4
WDW3: folds 
matiko09: folds 
vrnMike: calls €4
Racushniak: folds 
ozone2003: folds 
ruslik_by: folds 
Schmidy7: calls €3
*** FLOP *** [5d 7c 7s]
Schmidy7: checks 
hammerwife: checks 
vrnMike: checks 
*** TURN *** [5d 7c 7s] [6d]
Schmidy7: checks 
hammerwife: checks 
vrnMike: bets €10
Schmidy7: folds 
hammerwife: folds 
Uncalled bet (€10) returned to vrnMike
vrnMike collected €12.82 from pot
*** SUMMARY ***
Total pot €13.50 | Rake €0.68 
Board [5d 7c 7s 6d]
Seat 1: vrnMike collected (€12.82)
Seat 2: Racushniak (button) folded before Flop (didn't bet)
Seat 3: ozone2003 (small blind) folded before Flop
Seat 4: ruslik_by (big blind) folded before Flop
Seat 5: Schmidy7 folded on the Turn
Seat 6: HasBigBiceps folded before Flop (didn't bet)
Seat 7: hammerwife folded on the Turn
Seat 8: WDW3 folded before Flop (didn't bet)
Seat 9: matiko09 folded before Flop (didn't bet)





PokerStars Hand #152558804534:  Hold'em No Limit ($0.50/$1.00 USD) - 2016/04/28 14:50:19 CET [2016/04/28 8:50:19 ET]
Table 'Ciurlionis' 9-max Seat #5 is the button
Seat 1: maxxmeister ($115.50 in chips) 
Seat 2: liuzhi14 ($236.79 in chips) 
Seat 3: koksskrt ($100 in chips) 
Seat 4: ruslik_by ($41.50 in chips) 
Seat 5: matiko09 ($104.28 in chips) 
Seat 6: peevoajax ($100 in chips) 
Seat 7: Stopton ($91.68 in chips) 
Seat 8: WDW3 ($142.17 in chips) 
peevoajax: posts small blind $0.50
Stopton: posts big blind $1
*** HOLE CARDS ***
Dealt to matiko09 [5s Ah]
WDW3: folds 
maxxmeister: folds 
liuzhi14: folds 
koksskrt: folds 
ruslik_by: raises $1.50 to $2.50
matiko09: folds 
peevoajax: folds 
Stopton: calls $1.50
*** FLOP *** [6c 9s 4h]
Stopton: checks 
ruslik_by: bets $2.20
Stopton: raises $4.20 to $6.40
ruslik_by: calls $4.20
*** TURN *** [6c 9s 4h] [2s]
Stopton: checks 
ruslik_by: checks 
*** RIVER *** [6c 9s 4h 2s] [3s]
Stopton: bets $10
ruslik_by: calls $10
*** SHOW DOWN ***
Stopton: shows [Th As] (high card Ace)
ruslik_by: shows [8d 5d] (a straight, Deuce to Six)
ruslik_by collected $36.38 from pot
*** SUMMARY ***
Total pot $38.30 | Rake $1.92 
Board [6c 9s 4h 2s 3s]
Seat 1: maxxmeister folded before Flop (didn't bet)
Seat 2: liuzhi14 folded before Flop (didn't bet)
Seat 3: koksskrt folded before Flop (didn't bet)
Seat 4: ruslik_by showed [8d 5d] and won ($36.38) with a straight, Deuce to Six
Seat 5: matiko09 (button) folded before Flop (didn't bet)
Seat 6: peevoajax (small blind) folded before Flop
Seat 7: Stopton (big blind) showed [Th As] and lost with high card Ace
Seat 8: WDW3 folded before Flop (didn't bet)





PokerStars Hand #152558809702:  Hold'em No Limit ($1/$2 USD) - 2016/04/28 14:50:28 CET [2016/04/28 8:50:28 ET]
Table 'Idomeneus II' 9-max Seat #4 is the button
Seat 1: 13Ghosts ($214.22 in chips) 
Seat 2: libbyyww ($306.31 in chips) 
Seat 3: adrenalin333 ($199.22 in chips) 
Seat 4: SoNe1988 ($80 in chips) 
Seat 5: matiko09 ($209.36 in chips) 
Seat 7: ersevi6 ($156.61 in chips) 
Seat 9: Fish4trips ($202.68 in chips) 
matiko09: posts small blind $1
ersevi6: posts big blind $2
*** HOLE CARDS ***
Dealt to matiko09 [Js 2s]
Fish4trips: folds 
13Ghosts: folds 
libbyyww: folds 
adrenalin333: calls $2
SoNe1988: folds 
matiko09: folds 
ersevi6: checks 
*** FLOP *** [5c 8d 5h]
ersevi6: checks 
adrenalin333: checks 
*** TURN *** [5c 8d 5h] [9h]
ersevi6: checks 
adrenalin333: checks 
*** RIVER *** [5c 8d 5h 9h] [Ac]
ersevi6: checks 
adrenalin333: checks 
*** SHOW DOWN ***
ersevi6: shows [8s 5s] (a full house, Fives full of Eights)
adrenalin333: mucks hand 
ersevi6 collected $4.75 from pot
*** SUMMARY ***
Total pot $5 | Rake $0.25 
Board [5c 8d 5h 9h Ac]
Seat 1: 13Ghosts folded before Flop (didn't bet)
Seat 2: libbyyww folded before Flop (didn't bet)
Seat 3: adrenalin333 mucked [Tc Jh]
Seat 4: SoNe1988 (button) folded before Flop (didn't bet)
Seat 5: matiko09 (small blind) folded before Flop
Seat 7: ersevi6 (big blind) showed [8s 5s] and won ($4.75) with a full house, Fives full of Eights
Seat 9: Fish4trips folded before Flop (didn't bet)





PokerStars Hand #152558812063:  Hold'em No Limit ($1/$2 USD) - 2016/04/28 14:50:32 CET [2016/04/28 8:50:32 ET]
Table 'Helio' 9-max Seat #9 is the button
Seat 1: prominente ($422.35 in chips) 
Seat 2: peevoajax ($206 in chips) 
Seat 3: InsomniaRU ($200 in chips) 
Seat 4: ersevi6 ($124.66 in chips) 
Seat 5: pretender 19 ($191.42 in chips) 
Seat 6: matiko09 ($200 in chips) 
Seat 9: rmanjkeee ($88.75 in chips) 
prominente: posts small blind $1
peevoajax: posts big blind $2
wiseyoyo: sits out 
*** HOLE CARDS ***
Dealt to matiko09 [6d 6s]
InsomniaRU: folds 
ersevi6: folds 
pretender 19: folds 
matiko09: raises $3 to $5
rmanjkeee: folds 
prominente: raises $13 to $18
peevoajax: folds 
matiko09: folds 
Uncalled bet ($13) returned to prominente
prominente collected $12 from pot
prominente: doesn't show hand 
*** SUMMARY ***
Total pot $12 | Rake $0 
Seat 1: prominente (small blind) collected ($12)
Seat 2: peevoajax (big blind) folded before Flop
Seat 3: InsomniaRU folded before Flop (didn't bet)
Seat 4: ersevi6 folded before Flop (didn't bet)
Seat 5: pretender 19 folded before Flop (didn't bet)
Seat 6: matiko09 folded before Flop
Seat 9: rmanjkeee (button) folded before Flop (didn't bet)





PokerStars Hand #152558816303:  Hold'em No Limit ($0.50/$1.00 USD) - 2016/04/28 14:50:40 CET [2016/04/28 8:50:40 ET]
Table 'Zachia II' 9-max Seat #5 is the button
Seat 1: greyman571 ($82.34 in chips) 
Seat 2: sanpidk ($154.13 in chips) 
Seat 3: matiko09 ($100 in chips) 
Seat 4: omorfadramou ($104.47 in chips) 
Seat 5: vrnMike ($112.50 in chips) 
Seat 6: maxxmeister ($102.50 in chips) 
Seat 7: ozone2003 ($101.50 in chips) 
Seat 9: I The King I ($101.50 in chips) 
maxxmeister: posts small blind $0.50
ozone2003: posts big blind $1
*** HOLE CARDS ***
Dealt to matiko09 [9h 3d]
I The King I: folds 
greyman571: folds 
sanpidk: folds 
matiko09: folds 
omorfadramou: raises $2 to $3
vrnMike: folds 
maxxmeister: folds 
ozone2003: folds 
Uncalled bet ($2) returned to omorfadramou
omorfadramou collected $2.50 from pot
omorfadramou: doesn't show hand 
*** SUMMARY ***
Total pot $2.50 | Rake $0 
Seat 1: greyman571 folded before Flop (didn't bet)
Seat 2: sanpidk folded before Flop (didn't bet)
Seat 3: matiko09 folded before Flop (didn't bet)
Seat 4: omorfadramou collected ($2.50)
Seat 5: vrnMike (button) folded before Flop (didn't bet)
Seat 6: maxxmeister (small blind) folded before Flop
Seat 7: ozone2003 (big blind) folded before Flop
Seat 9: I The King I folded before Flop (didn't bet)





PokerStars Hand #152558817716:  Hold'em No Limit ($0.50/$1.00 USD) - 2016/04/28 14:50:42 CET [2016/04/28 8:50:42 ET]
Table 'Bruwer' 9-max Seat #5 is the button
Seat 2: ruslik_by ($40 in chips) 
Seat 3: koksskrt ($109.11 in chips) 
Seat 4: matiko09 ($141.04 in chips) 
Seat 5: Carloszhang ($127.98 in chips) 
Seat 6: I The King I ($111.52 in chips) 
Seat 7: R1aki ($248.58 in chips) 
Seat 8: WDW3 ($113.46 in chips) 
Seat 9: Dantist1122 ($121.61 in chips) 
I The King I: posts small blind $0.50
R1aki: posts big blind $1
*** HOLE CARDS ***
Dealt to matiko09 [Jc Ah]
WDW3: folds 
Dantist1122: raises $2 to $3
ruslik_by: folds 
koksskrt: folds 
matiko09: folds 
Carloszhang: calls $3
I The King I: folds 
R1aki: folds 
*** FLOP *** [9d 4d 9h]
Dantist1122: bets $3.91
Carloszhang: calls $3.91
*** TURN *** [9d 4d 9h] [4h]
Dantist1122: checks 
Carloszhang: checks 
*** RIVER *** [9d 4d 9h 4h] [5s]
Dantist1122: bets $5
Carloszhang: calls $5
*** SHOW DOWN ***
Dantist1122: shows [6c 6h] (two pair, Nines and Sixes)
Carloszhang: mucks hand 
Dantist1122 collected $24.05 from pot
*** SUMMARY ***
Total pot $25.32 | Rake $1.27 
Board [9d 4d 9h 4h 5s]
Seat 2: ruslik_by folded before Flop (didn't bet)
Seat 3: koksskrt folded before Flop (didn't bet)
Seat 4: matiko09 folded before Flop (didn't bet)
Seat 5: Carloszhang (button) mucked [Ac Qh]
Seat 6: I The King I (small blind) folded before Flop
Seat 7: R1aki (big blind) folded before Flop
Seat 8: WDW3 folded before Flop (didn't bet)
Seat 9: Dantist1122 showed [6c 6h] and won ($24.05) with two pair, Nines and Sixes





PokerStars Hand #152558819318:  Hold'em No Limit ($0.50/$1.00 USD) - 2016/04/28 14:50:45 CET [2016/04/28 8:50:45 ET]
Table 'Azimech' 9-max Seat #8 is the button
Seat 1: peevoajax ($133.18 in chips) 
Seat 2: adikier ($237.85 in chips) 
Seat 3: matiko09 ($100 in chips) 
Seat 4: ruslik_by ($81.40 in chips) 
Seat 5: ozone2003 ($107.88 in chips) 
Seat 6: sanpidk ($100 in chips) 
Seat 7: azzad2007 ($101.70 in chips) 
Seat 8: vrnMike ($100 in chips) 
Seat 9: scottinsf ($58.90 in chips) 
scottinsf: posts small blind $0.50
peevoajax: posts big blind $1
*** HOLE CARDS ***
Dealt to matiko09 [5h 8h]
adikier: folds 
matiko09: folds 
ruslik_by: folds 
ozone2003: raises $2 to $3
sanpidk: folds 
azzad2007: folds 
vrnMike: folds 
scottinsf: folds 
peevoajax: calls $2
*** FLOP *** [Ks As Qh]
peevoajax: checks 
ozone2003: bets $5
peevoajax: calls $5
*** TURN *** [Ks As Qh] [6s]
peevoajax: checks 
ozone2003: bets $9.88
peevoajax: calls $9.88
*** RIVER *** [Ks As Qh 6s] [Js]
peevoajax: checks 
ozone2003: checks 
*** SHOW DOWN ***
peevoajax: shows [Qs Kd] (a flush, Ace high)
ozone2003: mucks hand 
peevoajax collected $34.45 from pot
*** SUMMARY ***
Total pot $36.26 | Rake $1.81 
Board [Ks As Qh 6s Js]
Seat 1: peevoajax (big blind) showed [Qs Kd] and won ($34.45) with a flush, Ace high
Seat 2: adikier folded before Flop (didn't bet)
Seat 3: matiko09 folded before Flop (didn't bet)
Seat 4: ruslik_by folded before Flop (didn't bet)
Seat 5: ozone2003 mucked [Ah Kc]
Seat 6: sanpidk folded before Flop (didn't bet)
Seat 7: azzad2007 folded before Flop (didn't bet)
Seat 8: vrnMike (button) folded before Flop (didn't bet)
Seat 9: scottinsf (small blind) folded before Flop





PokerStars Hand #152558826301:  Hold'em No Limit (€0.50/€1.00 EUR) - 2016/04/28 14:50:57 CET [2016/04/28 8:50:57 ET]
Table 'Clivia II' 9-max Seat #1 is the button
Seat 1: piperkova (€48.59 in chips) 
Seat 2: HasBigBiceps (€100 in chips) 
Seat 3: R1aki (€100 in chips) 
Seat 4: matiko09 (€100 in chips) 
Seat 5: WDW3 (€125.50 in chips) 
Seat 6: ruslik_by (€62.93 in chips) 
Seat 7: St.LaCoste (€100 in chips) 
Seat 8: Dantist1122 (€100 in chips) 
Seat 9: ozone2003 (€100 in chips) 
HasBigBiceps: posts small blind €0.50
R1aki: posts big blind €1
*** HOLE CARDS ***
Dealt to matiko09 [8h Kc]
matiko09: folds 
WDW3: folds 
ruslik_by: folds 
St.LaCoste: folds 
Dantist1122: folds 
ozone2003: folds 
piperkova: folds 
HasBigBiceps: folds 
Uncalled bet (€0.50) returned to R1aki
R1aki collected €1 from pot
R1aki: doesn't show hand 
*** SUMMARY ***
Total pot €1 | Rake €0 
Seat 1: piperkova (button) folded before Flop (didn't bet)
Seat 2: HasBigBiceps (small blind) folded before Flop
Seat 3: R1aki (big blind) collected (€1)
Seat 4: matiko09 folded before Flop (didn't bet)
Seat 5: WDW3 folded before Flop (didn't bet)
Seat 6: ruslik_by folded before Flop (didn't bet)
Seat 7: St.LaCoste folded before Flop (didn't bet)
Seat 8: Dantist1122 folded before Flop (didn't bet)
Seat 9: ozone2003 folded before Flop (didn't bet)





PokerStars Hand #152558827993:  Hold'em No Limit ($0.50/$1.00 USD) - 2016/04/28 14:51:01 CET [2016/04/28 8:51:01 ET]
Table 'Zachia II' 9-max Seat #6 is the button
Seat 1: greyman571 ($82.34 in chips) 
Seat 2: sanpidk ($154.13 in chips) 
Seat 3: matiko09 ($100 in chips) 
Seat 4: omorfadramou ($105.97 in chips) 
Seat 5: vrnMike ($112.50 in chips) 
Seat 6: maxxmeister ($102 in chips) 
Seat 7: ozone2003 ($100.50 in chips) 
Seat 9: I The King I ($101.50 in chips) 
ozone2003: posts small blind $0.50
I The King I: posts big blind $1
*** HOLE CARDS ***
Dealt to matiko09 [7h 3c]
greyman571: raises $2 to $3
sanpidk: calls $3
matiko09: folds 
omorfadramou: calls $3
vrnMike: folds 
maxxmeister: folds 
ozone2003: folds 
I The King I: raises $14 to $17
greyman571: calls $14
sanpidk: folds 
omorfadramou: folds 
*** FLOP *** [4d 9h 3s]
I The King I: checks 
greyman571: checks 
*** TURN *** [4d 9h 3s] [8c]
I The King I: bets $17
greyman571: calls $17
*** RIVER *** [4d 9h 3s 8c] [4c]
I The King I: checks 
greyman571: bets $36
I The King I: calls $36
*** SHOW DOWN ***
greyman571: shows [9d 9c] (a full house, Nines full of Fours)
I The King I: mucks hand 
greyman571 collected $144 from pot
*** SUMMARY ***
Total pot $146.50 | Rake $2.50 
Board [4d 9h 3s 8c 4c]
Seat 1: greyman571 showed [9d 9c] and won ($144) with a full house, Nines full of Fours
Seat 2: sanpidk folded before Flop
Seat 3: matiko09 folded before Flop (didn't bet)
Seat 4: omorfadramou folded before Flop
Seat 5: vrnMike folded before Flop (didn't bet)
Seat 6: maxxmeister (button) folded before Flop (didn't bet)
Seat 7: ozone2003 (small blind) folded before Flop
Seat 9: I The King I (big blind) mucked [Ah Qs]





PokerStars Hand #152558828721:  Hold'em No Limit ($0.50/$1.00 USD) - 2016/04/28 14:51:02 CET [2016/04/28 8:51:02 ET]
Table 'Erynia' 9-max Seat #8 is the button
Seat 2: matiko09 ($155.03 in chips) 
Seat 4: WDW3 ($132.39 in chips) 
Seat 5: scottinsf ($40.49 in chips) 
Seat 6: peevoajax ($100 in chips) 
Seat 7: vrnMike ($118.60 in chips) 
Seat 8: YourKicker78 ($49.39 in chips) 
Seat 9: ruslik_by ($60.35 in chips) 
ruslik_by: posts small blind $0.50
matiko09: posts big blind $1
*** HOLE CARDS ***
Dealt to matiko09 [Kd 5s]
WDW3: folds 
scottinsf: folds 
peevoajax: folds 
vrnMike: folds 
YourKicker78: raises $2 to $3
ruslik_by: folds 
matiko09: folds 
Uncalled bet ($2) returned to YourKicker78
YourKicker78 collected $2.50 from pot
YourKicker78: doesn't show hand 
*** SUMMARY ***
Total pot $2.50 | Rake $0 
Seat 2: matiko09 (big blind) folded before Flop
Seat 4: WDW3 folded before Flop (didn't bet)
Seat 5: scottinsf folded before Flop (didn't bet)
Seat 6: peevoajax folded before Flop (didn't bet)
Seat 7: vrnMike folded before Flop (didn't bet)
Seat 8: YourKicker78 (button) collected ($2.50)
Seat 9: ruslik_by (small blind) folded before Flop





PokerStars Hand #152558832249:  Hold'em No Limit ($1/$2 USD) - 2016/04/28 14:51:08 CET [2016/04/28 8:51:08 ET]
Table 'Helio' 9-max Seat #1 is the button
Seat 1: prominente ($429.35 in chips) 
Seat 2: peevoajax ($204 in chips) 
Seat 3: InsomniaRU ($200 in chips) 
Seat 4: ersevi6 ($124.66 in chips) 
Seat 5: pretender 19 ($191.42 in chips) 
Seat 6: matiko09 ($200 in chips) 
Seat 9: rmanjkeee ($88.75 in chips) 
peevoajax: posts small blind $1
InsomniaRU: posts big blind $2
wiseyoyo: sits out 
*** HOLE CARDS ***
Dealt to matiko09 [2d 9s]
ersevi6: folds 
pretender 19: folds 
matiko09: folds 
rmanjkeee: raises $2 to $4
prominente: folds 
peevoajax: folds 
InsomniaRU: folds 
Uncalled bet ($2) returned to rmanjkeee
rmanjkeee collected $5 from pot
rmanjkeee: doesn't show hand 
*** SUMMARY ***
Total pot $5 | Rake $0 
Seat 1: prominente (button) folded before Flop (didn't bet)
Seat 2: peevoajax (small blind) folded before Flop
Seat 3: InsomniaRU (big blind) folded before Flop
Seat 4: ersevi6 folded before Flop (didn't bet)
Seat 5: pretender 19 folded before Flop (didn't bet)
Seat 6: matiko09 folded before Flop (didn't bet)
Seat 9: rmanjkeee collected ($5)





PokerStars Hand #152558835448:  Hold'em No Limit ($0.50/$1.00 USD) - 2016/04/28 14:51:14 CET [2016/04/28 8:51:14 ET]
Table 'Lyot' 9-max Seat #8 is the button
Seat 1: matiko09 ($114.71 in chips) 
Seat 2: vrnMike ($139.45 in chips) 
Seat 4: WDW3 ($100.64 in chips) 
Seat 6: Monglaer ($126.17 in chips) 
Seat 7: PreMoze ($69.15 in chips) 
Seat 8: Patz B ($11.68 in chips) 
Seat 9: koksskrt ($100 in chips) 
koksskrt: posts small blind $0.50
matiko09: posts big blind $1
matiko09: posts the ante $0.20
vrnMike: posts the ante $0.20
WDW3: posts the ante $0.20
Monglaer: posts the ante $0.20
PreMoze: posts the ante $0.20
Patz B: posts the ante $0.20
koksskrt: posts the ante $0.20
*** HOLE CARDS ***
Dealt to matiko09 [2c Jc]
vrnMike: folds 
WDW3: folds 
Monglaer: folds 
PreMoze: raises $1 to $2
Patz B: folds 
koksskrt: folds 
matiko09: folds 
Uncalled bet ($1) returned to PreMoze
PreMoze collected $3.90 from pot
*** SUMMARY ***
Total pot $3.90 | Rake $0 
Seat 1: matiko09 (big blind) folded before Flop
Seat 2: vrnMike folded before Flop (didn't bet)
Seat 4: WDW3 folded before Flop (didn't bet)
Seat 6: Monglaer folded before Flop (didn't bet)
Seat 7: PreMoze collected ($3.90)
Seat 8: Patz B (button) folded before Flop (didn't bet)
Seat 9: koksskrt (small blind) folded before Flop





PokerStars Hand #152558836732:  Hold'em No Limit ($0.50/$1.00 USD) - 2016/04/28 14:51:16 CET [2016/04/28 8:51:16 ET]
Table 'Agapenor III' 9-max Seat #2 is the button
Seat 1: I The King I ($100 in chips) 
Seat 2: cerbisor1 ($41.50 in chips) 
Seat 3: sanpidk ($100 in chips) 
Seat 4: matiko09 ($100 in chips) 
Seat 5: Painkiller72 ($107.55 in chips) 
Seat 7: tylerz71 ($80 in chips) 
Seat 9: DYO1000 ($35 in chips) 
sanpidk: posts small blind $0.50
matiko09: posts big blind $1
azzad2007: sits out 
tylerz71: posts big blind $1
*** HOLE CARDS ***
Dealt to matiko09 [Ah 8c]
Painkiller72: raises $2.50 to $3.50
tylerz71: folds 
DYO1000: folds 
I The King I: folds 
cerbisor1: folds 
sanpidk: folds 
matiko09: folds 
Uncalled bet ($2.50) returned to Painkiller72
Painkiller72 collected $3.50 from pot
Painkiller72: doesn't show hand 
*** SUMMARY ***
Total pot $3.50 | Rake $0 
Seat 1: I The King I folded before Flop (didn't bet)
Seat 2: cerbisor1 (button) folded before Flop (didn't bet)
Seat 3: sanpidk (small blind) folded before Flop
Seat 4: matiko09 (big blind) folded before Flop
Seat 5: Painkiller72 collected ($3.50)
Seat 7: tylerz71 folded before Flop
Seat 9: DYO1000 folded before Flop (didn't bet)





PokerStars Hand #152558837258:  Hold'em No Limit ($1/$2 USD) - 2016/04/28 14:51:17 CET [2016/04/28 8:51:17 ET]
Table 'Idomeneus II' 9-max Seat #5 is the button
Seat 1: 13Ghosts ($214.22 in chips) 
Seat 2: libbyyww ($306.31 in chips) 
Seat 3: adrenalin333 ($197.22 in chips) 
Seat 4: SoNe1988 ($80 in chips) 
Seat 5: matiko09 ($208.36 in chips) 
Seat 7: ersevi6 ($159.36 in chips) 
Seat 9: Fish4trips ($202.68 in chips) 
ersevi6: posts small blind $1
Fish4trips: posts big blind $2
*** HOLE CARDS ***
Dealt to matiko09 [Ts 4c]
13Ghosts: folds 
libbyyww: folds 
adrenalin333: folds 
SoNe1988: raises $3 to $5
matiko09: folds 
ersevi6: folds 
Fish4trips: folds 
Uncalled bet ($3) returned to SoNe1988
SoNe1988 collected $5 from pot
SoNe1988: doesn't show hand 
*** SUMMARY ***
Total pot $5 | Rake $0 
Seat 1: 13Ghosts folded before Flop (didn't bet)
Seat 2: libbyyww folded before Flop (didn't bet)
Seat 3: adrenalin333 folded before Flop (didn't bet)
Seat 4: SoNe1988 collected ($5)
Seat 5: matiko09 (button) folded before Flop (didn't bet)
Seat 7: ersevi6 (small blind) folded before Flop
Seat 9: Fish4trips (big blind) folded before Flop





PokerStars Hand #152558837860:  Hold'em No Limit ($1/$2 USD) - 2016/04/28 14:51:18 CET [2016/04/28 8:51:18 ET]
Table 'Mireille' 9-max Seat #8 is the button
Seat 2: matiko09 ($200 in chips) 
Seat 3: MZ2502 ($426.55 in chips) 
Seat 4: Fish4trips ($230.23 in chips) 
Seat 5: SoNe1988 ($118.42 in chips) 
Seat 6: Yaaaazz ($200 in chips) 
Seat 8: KDJAll3 ($936.14 in chips) 
Seat 9: a-talash ($153.30 in chips) 
a-talash: posts small blind $1
matiko09: posts big blind $2
*** HOLE CARDS ***
Dealt to matiko09 [7h 4h]
MZ2502: folds 
Fish4trips: folds 
SoNe1988: folds 
Yaaaazz: raises $3 to $5
KDJAll3: calls $5
a-talash: folds 
matiko09: folds 
*** FLOP *** [5c Ac Qs]
Yaaaazz: bets $8.15
KDJAll3: folds 
Uncalled bet ($8.15) returned to Yaaaazz
Yaaaazz collected $12.35 from pot
*** SUMMARY ***
Total pot $13 | Rake $0.65 
Board [5c Ac Qs]
Seat 2: matiko09 (big blind) folded before Flop
Seat 3: MZ2502 folded before Flop (didn't bet)
Seat 4: Fish4trips folded before Flop (didn't bet)
Seat 5: SoNe1988 folded before Flop (didn't bet)
Seat 6: Yaaaazz collected ($12.35)
Seat 8: KDJAll3 (button) folded on the Flop
Seat 9: a-talash (small blind) folded before Flop





PokerStars Hand #152558842239:  Hold'em No Limit ($0.50/$1.00 USD) - 2016/04/28 14:51:26 CET [2016/04/28 8:51:26 ET]
Table 'Erynia' 9-max Seat #9 is the button
Seat 2: matiko09 ($154.03 in chips) 
Seat 5: scottinsf ($40.49 in chips) 
Seat 6: peevoajax ($100 in chips) 
Seat 7: vrnMike ($118.60 in chips) 
Seat 8: YourKicker78 ($50.89 in chips) 
Seat 9: ruslik_by ($59.85 in chips) 
matiko09: posts small blind $0.50
WDW3: is sitting out 
scottinsf: posts big blind $1
*** HOLE CARDS ***
Dealt to matiko09 [Ts 2h]
WDW3 leaves the table
peevoajax: folds 
vrnMike: folds 
YourKicker78: folds 
sanpidk joins the table at seat #4 
ruslik_by: raises $1 to $2
matiko09: folds 
scottinsf: calls $1
*** FLOP *** [Ad Qd 7d]
scottinsf: checks 
ruslik_by: bets $2
scottinsf: folds 
Uncalled bet ($2) returned to ruslik_by
ruslik_by collected $4.28 from pot
ruslik_by: doesn't show hand 
*** SUMMARY ***
Total pot $4.50 | Rake $0.22 
Board [Ad Qd 7d]
Seat 2: matiko09 (small blind) folded before Flop
Seat 5: scottinsf (big blind) folded on the Flop
Seat 6: peevoajax folded before Flop (didn't bet)
Seat 7: vrnMike folded before Flop (didn't bet)
Seat 8: YourKicker78 folded before Flop (didn't bet)
Seat 9: ruslik_by (button) collected ($4.28)





PokerStars Hand #152558842628:  Hold'em No Limit ($0.50/$1.00 USD) - 2016/04/28 14:51:27 CET [2016/04/28 8:51:27 ET]
Table 'Paris' 9-max Seat #4 is the button
Seat 1: matiko09 ($153.97 in chips) 
Seat 2: birdie1970 ($225.44 in chips) 
Seat 3: vrnMike ($101.30 in chips) 
Seat 4: koksskrt ($100 in chips) 
Seat 7: Westpants ($135.10 in chips) 
Seat 8: Muric05 ($48.01 in chips) 
Seat 9: ruslik_by ($40 in chips) 
Westpants: posts small blind $0.50
Muric05: posts big blind $1
*** HOLE CARDS ***
Dealt to matiko09 [Qs 7h]
ruslik_by: folds 
matiko09: folds 
birdie1970: raises $1.50 to $2.50
vrnMike: calls $2.50
koksskrt: folds 
Westpants: folds 
Muric05: calls $1.50
*** FLOP *** [Qd 3s 7c]
Muric05: checks 
birdie1970: checks 
vrnMike: checks 
*** TURN *** [Qd 3s 7c] [Jd]
Muric05: bets $4
birdie1970: folds 
vrnMike: calls $4
*** RIVER *** [Qd 3s 7c Jd] [8d]
Muric05: checks 
vrnMike: checks 
*** SHOW DOWN ***
Muric05: shows [Qh 3h] (two pair, Queens and Threes)
vrnMike: mucks hand 
Muric05 collected $15.20 from pot
*** SUMMARY ***
Total pot $16 | Rake $0.80 
Board [Qd 3s 7c Jd 8d]
Seat 1: matiko09 folded before Flop (didn't bet)
Seat 2: birdie1970 folded on the Turn
Seat 3: vrnMike mucked [Jh Kc]
Seat 4: koksskrt (button) folded before Flop (didn't bet)
Seat 7: Westpants (small blind) folded before Flop
Seat 8: Muric05 (big blind) showed [Qh 3h] and won ($15.20) with two pair, Queens and Threes
Seat 9: ruslik_by folded before Flop (didn't bet)





PokerStars Hand #152558846056:  Hold'em No Limit ($0.50/$1.00 USD) - 2016/04/28 14:51:33 CET [2016/04/28 8:51:33 ET]
Table 'Lyot' 9-max Seat #9 is the button
Seat 1: matiko09 ($113.51 in chips) 
Seat 2: vrnMike ($139.25 in chips) 
Seat 4: WDW3 ($100.44 in chips) 
Seat 6: Monglaer ($125.97 in chips) 
Seat 7: PreMoze ($71.85 in chips) 
Seat 8: Patz B ($11.48 in chips) 
Seat 9: koksskrt ($100 in chips) 
matiko09: posts small blind $0.50
vrnMike: posts big blind $1
matiko09: posts the ante $0.20
vrnMike: posts the ante $0.20
WDW3: posts the ante $0.20
Monglaer: posts the ante $0.20
PreMoze: posts the ante $0.20
Patz B: posts the ante $0.20
koksskrt: posts the ante $0.20
*** HOLE CARDS ***
Dealt to matiko09 [7s 5d]
WDW3: folds 
Monglaer said, "why u bluff me?"
Monglaer: folds 
PreMoze: calls $1
Patz B: folds 
koksskrt: folds 
Monglaer said, "Do u know Iam fish?"
matiko09: folds 
vrnMike: checks 
*** FLOP *** [Ks 6s Ad]
vrnMike: checks 
PreMoze: checks 
*** TURN *** [Ks 6s Ad] [4d]
vrnMike: checks 
PreMoze: checks 
*** RIVER *** [Ks 6s Ad 4d] [Kc]
vrnMike: checks 
PreMoze: bets $1
vrnMike: folds 
Uncalled bet ($1) returned to PreMoze
PreMoze collected $3.70 from pot
*** SUMMARY ***
Total pot $3.90 | Rake $0.20 
Board [Ks 6s Ad 4d Kc]
Seat 1: matiko09 (small blind) folded before Flop
Seat 2: vrnMike (big blind) folded on the River
Seat 4: WDW3 folded before Flop (didn't bet)
Seat 6: Monglaer folded before Flop (didn't bet)
Seat 7: PreMoze collected ($3.70)
Seat 8: Patz B folded before Flop (didn't bet)
Seat 9: koksskrt (button) folded before Flop (didn't bet)





PokerStars Hand #152558848948:  Hold'em No Limit (€0.50/€1.00 EUR) - 2016/04/28 14:51:38 CET [2016/04/28 8:51:38 ET]
Table 'Lumiere II' 9-max Seat #3 is the button
Seat 1: vrnMike (€108.82 in chips) 
Seat 2: Racushniak (€100 in chips) 
Seat 3: ozone2003 (€103.23 in chips) 
Seat 4: ruslik_by (€63.70 in chips) 
Seat 5: Schmidy7 (€35 in chips) 
Seat 6: HasBigBiceps (€100 in chips) 
Seat 7: hammerwife (€116.18 in chips) 
Seat 8: WDW3 (€103 in chips) 
Seat 9: matiko09 (€100 in chips) 
ruslik_by: posts small blind €0.50
Schmidy7: posts big blind €1
*** HOLE CARDS ***
Dealt to matiko09 [Td Ks]
HasBigBiceps: folds 
hammerwife: folds 
WDW3: folds 
matiko09: folds 
vrnMike: folds 
Racushniak: raises €1.40 to €2.40
ozone2003: folds 
ruslik_by: folds 
Schmidy7: folds 
Uncalled bet (€1.40) returned to Racushniak
Racushniak collected €2.50 from pot
Racushniak: doesn't show hand 
*** SUMMARY ***
Total pot €2.50 | Rake €0 
Seat 1: vrnMike folded before Flop (didn't bet)
Seat 2: Racushniak collected (€2.50)
Seat 3: ozone2003 (button) folded before Flop (didn't bet)
Seat 4: ruslik_by (small blind) folded before Flop
Seat 5: Schmidy7 (big blind) folded before Flop
Seat 6: HasBigBiceps folded before Flop (didn't bet)
Seat 7: hammerwife folded before Flop (didn't bet)
Seat 8: WDW3 folded before Flop (didn't bet)
Seat 9: matiko09 folded before Flop (didn't bet)





PokerStars Hand #152558853841:  Hold'em No Limit (€0.50/€1.00 EUR) - 2016/04/28 14:51:47 CET [2016/04/28 8:51:47 ET]
Table 'Clivia II' 9-max Seat #2 is the button
Seat 1: piperkova (€48.59 in chips) 
Seat 2: HasBigBiceps (€100 in chips) 
Seat 3: R1aki (€100.50 in chips) 
Seat 4: matiko09 (€100 in chips) 
Seat 5: WDW3 (€125.50 in chips) 
Seat 6: ruslik_by (€62.93 in chips) 
Seat 7: St.LaCoste (€100 in chips) 
Seat 8: Dantist1122 (€100 in chips) 
Seat 9: ozone2003 (€100 in chips) 
R1aki: posts small blind €0.50
matiko09: posts big blind €1
*** HOLE CARDS ***
Dealt to matiko09 [Jh 8c]
WDW3: folds 
ruslik_by: raises €2 to €3
St.LaCoste: calls €3
Dantist1122: folds 
ozone2003: folds 
piperkova: folds 
HasBigBiceps: folds 
R1aki: folds 
matiko09: folds 
*** FLOP *** [Th 4c Qc]
ruslik_by: bets €2.50
St.LaCoste: folds 
Uncalled bet (€2.50) returned to ruslik_by
ruslik_by collected €7.12 from pot
ruslik_by: doesn't show hand 
*** SUMMARY ***
Total pot €7.50 | Rake €0.38 
Board [Th 4c Qc]
Seat 1: piperkova folded before Flop (didn't bet)
Seat 2: HasBigBiceps (button) folded before Flop (didn't bet)
Seat 3: R1aki (small blind) folded before Flop
Seat 4: matiko09 (big blind) folded before Flop
Seat 5: WDW3 folded before Flop (didn't bet)
Seat 6: ruslik_by collected (€7.12)
Seat 7: St.LaCoste folded on the Flop
Seat 8: Dantist1122 folded before Flop (didn't bet)
Seat 9: ozone2003 folded before Flop (didn't bet)





PokerStars Hand #152558854186:  Hold'em No Limit ($1/$2 USD) - 2016/04/28 14:51:47 CET [2016/04/28 8:51:47 ET]
Table 'Idomeneus II' 9-max Seat #7 is the button
Seat 1: 13Ghosts ($214.22 in chips) 
Seat 2: libbyyww ($306.31 in chips) 
Seat 3: adrenalin333 ($197.22 in chips) 
Seat 4: SoNe1988 ($83 in chips) 
Seat 5: matiko09 ($208.36 in chips) 
Seat 7: ersevi6 ($158.36 in chips) 
Seat 9: Fish4trips ($200.68 in chips) 
Fish4trips: posts small blind $1
13Ghosts: posts big blind $2
*** HOLE CARDS ***
Dealt to matiko09 [4s 7c]
libbyyww: raises $4 to $6
adrenalin333: calls $6
SoNe1988: folds 
matiko09: folds 
ersevi6: folds 
Fish4trips: folds 
13Ghosts: calls $4
*** FLOP *** [Ks 2s Ah]
13Ghosts: checks 
libbyyww: bets $13.53
adrenalin333: calls $13.53
13Ghosts: folds 
*** TURN *** [Ks 2s Ah] [Kd]
libbyyww: bets $26
adrenalin333: folds [Ac]
Uncalled bet ($26) returned to libbyyww
libbyyww collected $43.76 from pot
libbyyww: doesn't show hand 
*** SUMMARY ***
Total pot $46.06 | Rake $2.30 
Board [Ks 2s Ah Kd]
Seat 1: 13Ghosts (big blind) folded on the Flop
Seat 2: libbyyww collected ($43.76)
Seat 3: adrenalin333 folded on the Turn
Seat 4: SoNe1988 folded before Flop (didn't bet)
Seat 5: matiko09 folded before Flop (didn't bet)
Seat 7: ersevi6 (button) folded before Flop (didn't bet)
Seat 9: Fish4trips (small blind) folded before Flop





PokerStars Hand #152558854274:  Hold'em No Limit ($1/$2 USD) - 2016/04/28 14:51:47 CET [2016/04/28 8:51:47 ET]
Table 'Libera II' 9-max Seat #2 is the button
Seat 1: libbyyww ($200 in chips) 
Seat 2: peevoajax ($234.22 in chips) 
Seat 3: maverick7614 ($198 in chips) 
Seat 4: Sly-Hustler ($90.80 in chips) 
Seat 5: ersevi6 ($138.30 in chips) 
Seat 6: matiko09 ($200 in chips) 
Seat 7: Fish4trips ($395.25 in chips) 
Seat 8: WDW3 ($206.89 in chips) 
Seat 9: InsomniaRU ($200 in chips) 
maverick7614: posts small blind $1
Sly-Hustler: posts big blind $2
*** HOLE CARDS ***
Dealt to matiko09 [7s Kc]
ersevi6: folds 
matiko09: folds 
Fish4trips: folds 
WDW3: raises $3.60 to $5.60
InsomniaRU: folds 
libbyyww: folds 
peevoajax: calls $5.60
maverick7614: folds 
Sly-Hustler: folds 
*** FLOP *** [Jc 9d 4c]
WDW3: checks 
peevoajax: bets $7.28
WDW3: calls $7.28
*** TURN *** [Jc 9d 4c] [8s]
WDW3: checks 
peevoajax: bets $28
WDW3: calls $28
*** RIVER *** [Jc 9d 4c 8s] [8d]
WDW3: checks 
peevoajax: checks 
*** SHOW DOWN ***
WDW3: shows [Ac Ad] (two pair, Aces and Eights)
peevoajax: mucks hand 
WDW3 collected $82.01 from pot
*** SUMMARY ***
Total pot $84.76 | Rake $2.75 
Board [Jc 9d 4c 8s 8d]
Seat 1: libbyyww folded before Flop (didn't bet)
Seat 2: peevoajax (button) mucked [Qd Ah]
Seat 3: maverick7614 (small blind) folded before Flop
Seat 4: Sly-Hustler (big blind) folded before Flop
Seat 5: ersevi6 folded before Flop (didn't bet)
Seat 6: matiko09 folded before Flop (didn't bet)
Seat 7: Fish4trips folded before Flop (didn't bet)
Seat 8: WDW3 showed [Ac Ad] and won ($82.01) with two pair, Aces and Eights
Seat 9: InsomniaRU folded before Flop (didn't bet)





PokerStars Hand #152558854688:  Hold'em No Limit ($1/$2 USD) - 2016/04/28 14:51:48 CET [2016/04/28 8:51:48 ET]
Table 'Helio' 9-max Seat #2 is the button
Seat 1: prominente ($429.35 in chips) 
Seat 2: peevoajax ($203 in chips) 
Seat 3: InsomniaRU ($200 in chips) 
Seat 4: ersevi6 ($124.66 in chips) 
Seat 5: pretender 19 ($191.42 in chips) 
Seat 6: matiko09 ($200 in chips) 
Seat 9: rmanjkeee ($91.75 in chips) 
InsomniaRU: posts small blind $1
ersevi6: posts big blind $2
wiseyoyo: sits out 
*** HOLE CARDS ***
Dealt to matiko09 [Ts 4s]
pretender 19: folds 
matiko09: folds 
rmanjkeee: folds 
prominente: raises $3 to $5
peevoajax: folds 
InsomniaRU: folds 
ersevi6: folds 
Uncalled bet ($3) returned to prominente
prominente collected $5 from pot
prominente: doesn't show hand 
*** SUMMARY ***
Total pot $5 | Rake $0 
Seat 1: prominente collected ($5)
Seat 2: peevoajax (button) folded before Flop (didn't bet)
Seat 3: InsomniaRU (small blind) folded before Flop
Seat 4: ersevi6 (big blind) folded before Flop
Seat 5: pretender 19 folded before Flop (didn't bet)
Seat 6: matiko09 folded before Flop (didn't bet)
Seat 9: rmanjkeee folded before Flop (didn't bet)





PokerStars Hand #152558860592:  Hold'em No Limit ($0.50/$1.00 USD) - 2016/04/28 14:51:58 CET [2016/04/28 8:51:58 ET]
Table 'Azimech' 9-max Seat #9 is the button
Seat 1: peevoajax ($149.75 in chips) 
Seat 2: adikier ($237.85 in chips) 
Seat 3: matiko09 ($100 in chips) 
Seat 4: ruslik_by ($81.40 in chips) 
Seat 5: ozone2003 ($100 in chips) 
Seat 6: sanpidk ($100 in chips) 
Seat 7: azzad2007 ($101.70 in chips) 
Seat 8: vrnMike ($100 in chips) 
Seat 9: scottinsf ($58.40 in chips) 
peevoajax: posts small blind $0.50
adikier: posts big blind $1
*** HOLE CARDS ***
Dealt to matiko09 [7h Jh]
matiko09: folds 
ruslik_by: raises $2 to $3
ozone2003: folds 
sanpidk: folds 
azzad2007: folds 
vrnMike: folds 
scottinsf: folds 
peevoajax: folds 
adikier: folds 
Uncalled bet ($2) returned to ruslik_by
ruslik_by collected $2.50 from pot
ruslik_by: doesn't show hand 
*** SUMMARY ***
Total pot $2.50 | Rake $0 
Seat 1: peevoajax (small blind) folded before Flop
Seat 2: adikier (big blind) folded before Flop
Seat 3: matiko09 folded before Flop (didn't bet)
Seat 4: ruslik_by collected ($2.50)
Seat 5: ozone2003 folded before Flop (didn't bet)
Seat 6: sanpidk folded before Flop (didn't bet)
Seat 7: azzad2007 folded before Flop (didn't bet)
Seat 8: vrnMike folded before Flop (didn't bet)
Seat 9: scottinsf (button) folded before Flop (didn't bet)





PokerStars Hand #152558863824:  Hold'em No Limit ($0.50/$1.00 USD) - 2016/04/28 14:52:04 CET [2016/04/28 8:52:04 ET]
Table 'Agapenor III' 9-max Seat #3 is the button
Seat 1: I The King I ($100 in chips) 
Seat 2: cerbisor1 ($41.50 in chips) 
Seat 3: sanpidk ($100 in chips) 
Seat 4: matiko09 ($100 in chips) 
Seat 5: Painkiller72 ($110.05 in chips) 
Seat 7: tylerz71 ($79 in chips) 
Seat 9: DYO1000 ($35 in chips) 
matiko09: posts small blind $0.50
Painkiller72: posts big blind $1
azzad2007: sits out 
*** HOLE CARDS ***
Dealt to matiko09 [8c Ac]
tylerz71: folds 
DYO1000: folds 
I The King I: folds 
cerbisor1: raises $1 to $2
sanpidk: calls $2
NoState11 joins the table at seat #8 
matiko09: folds 
Painkiller72: folds 
*** FLOP *** [7s 5h 2c]
cerbisor1: bets $4
sanpidk: calls $4
*** TURN *** [7s 5h 2c] [Ts]
cerbisor1: checks 
sanpidk: bets $5.50
cerbisor1: calls $5.50
*** RIVER *** [7s 5h 2c Ts] [2h]
cerbisor1: checks 
sanpidk: checks 
*** SHOW DOWN ***
cerbisor1: shows [5c As] (two pair, Fives and Deuces)
sanpidk: shows [9c 7c] (two pair, Sevens and Deuces)
sanpidk collected $23.28 from pot
*** SUMMARY ***
Total pot $24.50 | Rake $1.22 
Board [7s 5h 2c Ts 2h]
Seat 1: I The King I folded before Flop (didn't bet)
Seat 2: cerbisor1 showed [5c As] and lost with two pair, Fives and Deuces
Seat 3: sanpidk (button) showed [9c 7c] and won ($23.28) with two pair, Sevens and Deuces
Seat 4: matiko09 (small blind) folded before Flop
Seat 5: Painkiller72 (big blind) folded before Flop
Seat 7: tylerz71 folded before Flop (didn't bet)
Seat 9: DYO1000 folded before Flop (didn't bet)





PokerStars Hand #152558865020:  Hold'em No Limit ($0.50/$1.00 USD) - 2016/04/28 14:52:06 CET [2016/04/28 8:52:06 ET]
Table 'Ciurlionis' 9-max Seat #6 is the button
Seat 2: liuzhi14 ($236.79 in chips) 
Seat 3: koksskrt ($100 in chips) 
Seat 4: ruslik_by ($58.98 in chips) 
Seat 5: matiko09 ($104.28 in chips) 
Seat 6: peevoajax ($100 in chips) 
Seat 7: Stopton ($72.78 in chips) 
Stopton: posts small blind $0.50
WDW3: is sitting out 
maxxmeister: is sitting out 
WDW3 leaves the table
liuzhi14: posts big blind $1
*** HOLE CARDS ***
Dealt to matiko09 [3c 5h]
omorfadramou joins the table at seat #8 
koksskrt: folds 
maxxmeister leaves the table
sanpidk joins the table at seat #1 
ruslik_by: raises $2 to $3
matiko09: folds 
peevoajax: folds 
Stopton: folds 
liuzhi14: folds 
Uncalled bet ($2) returned to ruslik_by
ruslik_by collected $2.50 from pot
ruslik_by: doesn't show hand 
*** SUMMARY ***
Total pot $2.50 | Rake $0 
Seat 2: liuzhi14 (big blind) folded before Flop
Seat 3: koksskrt folded before Flop (didn't bet)
Seat 4: ruslik_by collected ($2.50)
Seat 5: matiko09 folded before Flop (didn't bet)
Seat 6: peevoajax (button) folded before Flop (didn't bet)
Seat 7: Stopton (small blind) folded before Flop





PokerStars Hand #152558865294:  Hold'em No Limit ($1/$2 USD) - 2016/04/28 14:52:07 CET [2016/04/28 8:52:07 ET]
Table 'Mireille' 9-max Seat #9 is the button
Seat 2: matiko09 ($200 in chips) 
Seat 3: MZ2502 ($426.55 in chips) 
Seat 4: Fish4trips ($230.23 in chips) 
Seat 5: SoNe1988 ($118.42 in chips) 
Seat 6: Yaaaazz ($207.35 in chips) 
Seat 8: KDJAll3 ($931.14 in chips) 
Seat 9: a-talash ($152.30 in chips) 
matiko09: posts small blind $1
MZ2502: posts big blind $2
*** HOLE CARDS ***
Dealt to matiko09 [2d 3d]
Fish4trips: folds 
SoNe1988: folds 
Yaaaazz: folds 
KDJAll3: raises $2 to $4
a-talash: folds 
matiko09: folds 
MZ2502: calls $2
*** FLOP *** [7d 3c 4h]
MZ2502: bets $12
KDJAll3: folds 
Uncalled bet ($12) returned to MZ2502
MZ2502 collected $8.55 from pot
MZ2502: doesn't show hand 
*** SUMMARY ***
Total pot $9 | Rake $0.45 
Board [7d 3c 4h]
Seat 2: matiko09 (small blind) folded before Flop
Seat 3: MZ2502 (big blind) collected ($8.55)
Seat 4: Fish4trips folded before Flop (didn't bet)
Seat 5: SoNe1988 folded before Flop (didn't bet)
Seat 6: Yaaaazz folded before Flop (didn't bet)
Seat 8: KDJAll3 folded on the Flop
Seat 9: a-talash (button) folded before Flop (didn't bet)





PokerStars Hand #152558870911:  Hold'em No Limit ($0.50/$1.00 USD) - 2016/04/28 14:52:17 CET [2016/04/28 8:52:17 ET]
Table 'Erynia' 9-max Seat #2 is the button
Seat 2: matiko09 ($153.53 in chips) 
Seat 5: scottinsf ($38.49 in chips) 
Seat 6: peevoajax ($100 in chips) 
Seat 7: vrnMike ($118.60 in chips) 
Seat 8: YourKicker78 ($50.89 in chips) 
Seat 9: ruslik_by ($62.13 in chips) 
sanpidk will be allowed to play after the button
scottinsf: posts small blind $0.50
peevoajax: posts big blind $1
*** HOLE CARDS ***
Dealt to matiko09 [6d 6c]
vrnMike: raises $1 to $2
YourKicker78: folds 
ruslik_by: folds 
matiko09: calls $2
scottinsf: folds 
peevoajax: folds 
*** FLOP *** [Tc 3c 2h]
vrnMike: checks 
matiko09: bets $2.71
vrnMike: calls $2.71
*** TURN *** [Tc 3c 2h] [Th]
vrnMike: checks 
matiko09: checks 
*** RIVER *** [Tc 3c 2h Th] [3s]
vrnMike: bets $6
matiko09: calls $6
*** SHOW DOWN ***
vrnMike: shows [Jh Jc] (two pair, Jacks and Tens)
matiko09: mucks hand 
vrnMike collected $21.77 from pot
*** SUMMARY ***
Total pot $22.92 | Rake $1.15 
Board [Tc 3c 2h Th 3s]
Seat 2: matiko09 (button) mucked [6d 6c]
Seat 5: scottinsf (small blind) folded before Flop
Seat 6: peevoajax (big blind) folded before Flop
Seat 7: vrnMike showed [Jh Jc] and won ($21.77) with two pair, Jacks and Tens
Seat 8: YourKicker78 folded before Flop (didn't bet)
Seat 9: ruslik_by folded before Flop (didn't bet)





PokerStars Hand #152558874492:  Hold'em No Limit (€0.50/€1.00 EUR) - 2016/04/28 14:52:23 CET [2016/04/28 8:52:23 ET]
Table 'Lumiere II' 9-max Seat #4 is the button
Seat 1: vrnMike (€108.82 in chips) 
Seat 2: Racushniak (€101.50 in chips) 
Seat 3: ozone2003 (€103.23 in chips) 
Seat 4: ruslik_by (€63.20 in chips) 
Seat 5: Schmidy7 (€34 in chips) 
Seat 6: HasBigBiceps (€100 in chips) 
Seat 7: hammerwife (€116.18 in chips) 
Seat 8: WDW3 (€103 in chips) 
Seat 9: matiko09 (€100 in chips) 
Schmidy7: posts small blind €0.50
HasBigBiceps: posts big blind €1
*** HOLE CARDS ***
Dealt to matiko09 [6d 2c]
hammerwife: folds 
WDW3: folds 
matiko09: folds 
vrnMike: folds 
Racushniak: raises €2 to €3
ozone2003: folds 
ruslik_by: folds 
Schmidy7: calls €2.50
HasBigBiceps: folds 
*** FLOP *** [6s Td 5s]
Schmidy7: checks 
Racushniak: checks 
*** TURN *** [6s Td 5s] [9s]
Schmidy7: bets €3.32
Racushniak: calls €3.32
*** RIVER *** [6s Td 5s 9s] [4s]
Schmidy7: checks 
Racushniak: bets €7.12
Schmidy7: calls €7.12
*** SHOW DOWN ***
Racushniak: shows [Ac 7c] (high card Ace)
Schmidy7: shows [4c 4d] (three of a kind, Fours)
Schmidy7 collected €26.49 from pot
*** SUMMARY ***
Total pot €27.88 | Rake €1.39 
Board [6s Td 5s 9s 4s]
Seat 1: vrnMike folded before Flop (didn't bet)
Seat 2: Racushniak showed [Ac 7c] and lost with high card Ace
Seat 3: ozone2003 folded before Flop (didn't bet)
Seat 4: ruslik_by (button) folded before Flop (didn't bet)
Seat 5: Schmidy7 (small blind) showed [4c 4d] and won (€26.49) with three of a kind, Fours
Seat 6: HasBigBiceps (big blind) folded before Flop
Seat 7: hammerwife folded before Flop (didn't bet)
Seat 8: WDW3 folded before Flop (didn't bet)
Seat 9: matiko09 folded before Flop (didn't bet)





PokerStars Hand #152558874268:  Hold'em No Limit ($1/$2 USD) - 2016/04/28 14:52:23 CET [2016/04/28 8:52:23 ET]
Table 'Helio' 9-max Seat #3 is the button
Seat 1: prominente ($432.35 in chips) 
Seat 2: peevoajax ($203 in chips) 
Seat 3: InsomniaRU ($200 in chips) 
Seat 4: ersevi6 ($122.66 in chips) 
Seat 5: pretender 19 ($191.42 in chips) 
Seat 6: matiko09 ($200 in chips) 
Seat 9: rmanjkeee ($91.75 in chips) 
ersevi6: posts small blind $1
pretender 19: posts big blind $2
wiseyoyo: sits out 
*** HOLE CARDS ***
Dealt to matiko09 [Ah 3c]
matiko09: folds 
rmanjkeee: folds 
prominente: folds 
peevoajax: folds 
InsomniaRU: folds 
ersevi6: raises $3 to $5
pretender 19: calls $3
*** FLOP *** [Qs Kc Td]
ersevi6: bets $6
pretender 19: calls $6
*** TURN *** [Qs Kc Td] [4h]
ersevi6: checks 
pretender 19: checks 
*** RIVER *** [Qs Kc Td 4h] [6c]
ersevi6: checks 
pretender 19: checks 
*** SHOW DOWN ***
ersevi6: shows [As 5h] (high card Ace)
pretender 19: shows [Kd Jh] (a pair of Kings)
pretender 19 collected $20.90 from pot
*** SUMMARY ***
Total pot $22 | Rake $1.10 
Board [Qs Kc Td 4h 6c]
Seat 1: prominente folded before Flop (didn't bet)
Seat 2: peevoajax folded before Flop (didn't bet)
Seat 3: InsomniaRU (button) folded before Flop (didn't bet)
Seat 4: ersevi6 (small blind) showed [As 5h] and lost with high card Ace
Seat 5: pretender 19 (big blind) showed [Kd Jh] and won ($20.90) with a pair of Kings
Seat 6: matiko09 folded before Flop (didn't bet)
Seat 9: rmanjkeee folded before Flop (didn't bet)





PokerStars Hand #152558877960:  Hold'em No Limit ($0.50/$1.00 USD) - 2016/04/28 14:52:29 CET [2016/04/28 8:52:29 ET]
Table 'Lyot' 9-max Seat #1 is the button
Seat 1: matiko09 ($112.81 in chips) 
Seat 2: vrnMike ($138.05 in chips) 
Seat 6: Monglaer ($125.77 in chips) 
Seat 7: PreMoze ($74.35 in chips) 
Seat 8: Patz B ($11.28 in chips) 
Seat 9: koksskrt ($100 in chips) 
vrnMike: posts small blind $0.50
WDW3: is sitting out 
WDW3 leaves the table
Monglaer: posts big blind $1
matiko09: posts the ante $0.20
vrnMike: posts the ante $0.20
Monglaer: posts the ante $0.20
PreMoze: posts the ante $0.20
Patz B: posts the ante $0.20
koksskrt: posts the ante $0.20
*** HOLE CARDS ***
Dealt to matiko09 [8c Qs]
PreMoze: calls $1
Patz B: folds 
koksskrt: folds 
matiko09: raises $3 to $4
vrnMike: folds 
Monglaer: folds 
PreMoze: calls $3
*** FLOP *** [Th Kc 5h]
PreMoze: checks 
matiko09: checks 
*** TURN *** [Th Kc 5h] [6d]
PreMoze: checks 
matiko09: checks 
*** RIVER *** [Th Kc 5h 6d] [6h]
PreMoze: bets $5
matiko09: folds 
Uncalled bet ($5) returned to PreMoze
PreMoze collected $10.16 from pot
*** SUMMARY ***
Total pot $10.70 | Rake $0.54 
Board [Th Kc 5h 6d 6h]
Seat 1: matiko09 (button) folded on the River
Seat 2: vrnMike (small blind) folded before Flop
Seat 6: Monglaer (big blind) folded before Flop
Seat 7: PreMoze collected ($10.16)
Seat 8: Patz B folded before Flop (didn't bet)
Seat 9: koksskrt folded before Flop (didn't bet)





PokerStars Hand #152558878007:  Hold'em No Limit ($0.50/$1.00 USD) - 2016/04/28 14:52:30 CET [2016/04/28 8:52:30 ET]
Table 'Azimech' 9-max Seat #1 is the button
Seat 1: peevoajax ($149.25 in chips) 
Seat 2: adikier ($236.85 in chips) 
Seat 3: matiko09 ($100 in chips) 
Seat 4: ruslik_by ($82.90 in chips) 
Seat 5: ozone2003 ($100 in chips) 
Seat 6: sanpidk ($100 in chips) 
Seat 7: azzad2007 ($101.70 in chips) 
Seat 8: vrnMike ($100 in chips) 
Seat 9: scottinsf ($58.40 in chips) 
adikier: posts small blind $0.50
matiko09: posts big blind $1
*** HOLE CARDS ***
Dealt to matiko09 [6c 4d]
ruslik_by: folds 
ozone2003: folds 
sanpidk: folds 
azzad2007: raises $2 to $3
vrnMike: folds 
scottinsf: folds 
peevoajax: raises $7 to $10
adikier: folds 
matiko09: folds 
azzad2007: calls $7
*** FLOP *** [8d Qs Ac]
azzad2007: checks 
peevoajax: checks 
*** TURN *** [8d Qs Ac] [Jd]
azzad2007: bets $10.21
peevoajax: calls $10.21
*** RIVER *** [8d Qs Ac Jd] [Kc]
azzad2007: checks 
peevoajax: bets $33
azzad2007: folds 
Uncalled bet ($33) returned to peevoajax
peevoajax collected $39.82 from pot
peevoajax: doesn't show hand 
*** SUMMARY ***
Total pot $41.92 | Rake $2.10 
Board [8d Qs Ac Jd Kc]
Seat 1: peevoajax (button) collected ($39.82)
Seat 2: adikier (small blind) folded before Flop
Seat 3: matiko09 (big blind) folded before Flop
Seat 4: ruslik_by folded before Flop (didn't bet)
Seat 5: ozone2003 folded before Flop (didn't bet)
Seat 6: sanpidk folded before Flop (didn't bet)
Seat 7: azzad2007 folded on the River
Seat 8: vrnMike folded before Flop (didn't bet)
Seat 9: scottinsf folded before Flop (didn't bet)





PokerStars Hand #152558882946:  Hold'em No Limit ($0.50/$1.00 USD) - 2016/04/28 14:52:38 CET [2016/04/28 8:52:38 ET]
Table 'Zachia II' 9-max Seat #7 is the button
Seat 1: greyman571 ($156.34 in chips) 
Seat 2: sanpidk ($151.13 in chips) 
Seat 3: matiko09 ($100 in chips) 
Seat 4: omorfadramou ($102.97 in chips) 
Seat 5: vrnMike ($112.50 in chips) 
Seat 6: maxxmeister ($102 in chips) 
Seat 7: ozone2003 ($100 in chips) 
Seat 9: I The King I ($100 in chips) 
I The King I: posts small blind $0.50
greyman571: posts big blind $1
*** HOLE CARDS ***
Dealt to matiko09 [5h 5d]
sanpidk: folds 
matiko09: raises $2 to $3
omorfadramou: folds 
vrnMike: folds 
maxxmeister: folds 
ozone2003: folds 
I The King I: folds 
greyman571: folds 
Uncalled bet ($2) returned to matiko09
matiko09 collected $2.50 from pot
matiko09: doesn't show hand 
*** SUMMARY ***
Total pot $2.50 | Rake $0 
Seat 1: greyman571 (big blind) folded before Flop
Seat 2: sanpidk folded before Flop (didn't bet)
Seat 3: matiko09 collected ($2.50)
Seat 4: omorfadramou folded before Flop (didn't bet)
Seat 5: vrnMike folded before Flop (didn't bet)
Seat 6: maxxmeister folded before Flop (didn't bet)
Seat 7: ozone2003 (button) folded before Flop (didn't bet)
Seat 9: I The King I (small blind) folded before Flop





PokerStars Hand #152558884686:  Hold'em No Limit ($0.50/$1.00 USD) - 2016/04/28 14:52:41 CET [2016/04/28 8:52:41 ET]
Table 'Ciurlionis' 9-max Seat #7 is the button
Seat 2: liuzhi14 ($235.79 in chips) 
Seat 3: koksskrt ($100 in chips) 
Seat 4: ruslik_by ($60.48 in chips) 
Seat 5: matiko09 ($104.28 in chips) 
Seat 6: peevoajax ($100 in chips) 
Seat 7: Stopton ($100 in chips) 
omorfadramou will be allowed to play after the button
sanpidk will be allowed to play after the button
liuzhi14: posts small blind $0.50
koksskrt: posts big blind $1
*** HOLE CARDS ***
Dealt to matiko09 [4s Tc]
ruslik_by: folds 
matiko09: folds 
peevoajax: folds 
Stopton: folds 
aseban11 leaves the table
liuzhi14: raises $2 to $3
koksskrt: folds 
Uncalled bet ($2) returned to liuzhi14
liuzhi14 collected $2 from pot
liuzhi14: doesn't show hand 
*** SUMMARY ***
Total pot $2 | Rake $0 
Seat 2: liuzhi14 (small blind) collected ($2)
Seat 3: koksskrt (big blind) folded before Flop
Seat 4: ruslik_by folded before Flop (didn't bet)
Seat 5: matiko09 folded before Flop (didn't bet)
Seat 6: peevoajax folded before Flop (didn't bet)
Seat 7: Stopton (button) folded before Flop (didn't bet)





PokerStars Hand #152558886961:  Hold'em No Limit ($1/$2 USD) - 2016/04/28 14:52:45 CET [2016/04/28 8:52:45 ET]
Table 'Mireille' 9-max Seat #2 is the button
Seat 2: matiko09 ($200 in chips) 
Seat 3: MZ2502 ($431.10 in chips) 
Seat 4: Fish4trips ($230.23 in chips) 
Seat 5: SoNe1988 ($118.42 in chips) 
Seat 6: Yaaaazz ($207.35 in chips) 
Seat 8: KDJAll3 ($927.14 in chips) 
Seat 9: a-talash ($152.30 in chips) 
MZ2502: posts small blind $1
Fish4trips: posts big blind $2
aseban11: sits out 
*** HOLE CARDS ***
Dealt to matiko09 [9h Ac]
SoNe1988: folds 
Yaaaazz: folds 
KDJAll3: folds 
a-talash: folds 
matiko09: raises $2.54 to $4.54
MZ2502: calls $3.54
Fish4trips: folds 
*** FLOP *** [5d 7d 2c]
MZ2502: bets $6
matiko09: folds 
Uncalled bet ($6) returned to MZ2502
MZ2502 collected $10.53 from pot
MZ2502: doesn't show hand 
*** SUMMARY ***
Total pot $11.08 | Rake $0.55 
Board [5d 7d 2c]
Seat 2: matiko09 (button) folded on the Flop
Seat 3: MZ2502 (small blind) collected ($10.53)
Seat 4: Fish4trips (big blind) folded before Flop
Seat 5: SoNe1988 folded before Flop (didn't bet)
Seat 6: Yaaaazz folded before Flop (didn't bet)
Seat 8: KDJAll3 folded before Flop (didn't bet)
Seat 9: a-talash folded before Flop (didn't bet)





PokerStars Hand #152558892534:  Hold'em No Limit ($0.50/$1.00 USD) - 2016/04/28 14:52:55 CET [2016/04/28 8:52:55 ET]
Table 'Paris' 9-max Seat #7 is the button
Seat 1: matiko09 ($153.97 in chips) 
Seat 2: birdie1970 ($222.94 in chips) 
Seat 3: vrnMike ($100 in chips) 
Seat 4: koksskrt ($100 in chips) 
Seat 7: Westpants ($134.60 in chips) 
Seat 8: Muric05 ($56.71 in chips) 
Seat 9: ruslik_by ($40 in chips) 
Muric05: posts small blind $0.50
ruslik_by: posts big blind $1
*** HOLE CARDS ***
Dealt to matiko09 [7s 5c]
matiko09: folds 
birdie1970: calls $1
WaldiQ leaves the table
I The King I joins the table at seat #5 
vrnMike: raises $4 to $5
koksskrt: folds 
Westpants: folds 
Muric05: calls $4.50
ruslik_by: folds 
aseban11 leaves the table
birdie1970: calls $4
*** FLOP *** [8h 8d 6d]
Muric05: bets $10
Yaaaazz joins the table at seat #6 
birdie1970: folds 
Yaaaazz leaves the table
vrnMike: raises $14.50 to $24.50
Muric05: raises $27.21 to $51.71 and is all-in
vrnMike: calls $27.21
*** TURN *** [8h 8d 6d] [Ad]
*** RIVER *** [8h 8d 6d Ad] [Jc]
*** SHOW DOWN ***
Muric05: shows [9c 9s] (two pair, Nines and Eights)
vrnMike: shows [Kd Kc] (two pair, Kings and Eights)
vrnMike collected $116.92 from pot
*** SUMMARY ***
Total pot $119.42 | Rake $2.50 
Board [8h 8d 6d Ad Jc]
Seat 1: matiko09 folded before Flop (didn't bet)
Seat 2: birdie1970 folded on the Flop
Seat 3: vrnMike showed [Kd Kc] and won ($116.92) with two pair, Kings and Eights
Seat 4: koksskrt folded before Flop (didn't bet)
Seat 7: Westpants (button) folded before Flop (didn't bet)
Seat 8: Muric05 (small blind) showed [9c 9s] and lost with two pair, Nines and Eights
Seat 9: ruslik_by (big blind) folded before Flop





PokerStars Hand #152558895286:  Hold'em No Limit ($0.50/$1.00 USD) - 2016/04/28 14:53:00 CET [2016/04/28 8:53:00 ET]
Table 'Bruwer' 9-max Seat #6 is the button
Seat 2: ruslik_by ($40 in chips) 
Seat 3: koksskrt ($109.11 in chips) 
Seat 4: matiko09 ($141.04 in chips) 
Seat 5: Carloszhang ($116.07 in chips) 
Seat 6: I The King I ($111.02 in chips) 
Seat 7: R1aki ($247.58 in chips) 
R1aki: posts small blind $0.50
WDW3: is sitting out 
WDW3 leaves the table
Dantist1122: is sitting out 
ruslik_by: posts big blind $1
*** HOLE CARDS ***
Dealt to matiko09 [Ks 9c]
lumen21 joins the table at seat #8 
koksskrt: folds 
matiko09: folds 
Carloszhang: raises $1 to $2
I The King I: folds 
R1aki: folds 
ruslik_by: calls $1
*** FLOP *** [6s 5h 3d]
ruslik_by: checks 
Carloszhang: bets $2
ruslik_by: folds 
Uncalled bet ($2) returned to Carloszhang
Carloszhang collected $4.28 from pot
*** SUMMARY ***
Total pot $4.50 | Rake $0.22 
Board [6s 5h 3d]
Seat 2: ruslik_by (big blind) folded on the Flop
Seat 3: koksskrt folded before Flop (didn't bet)
Seat 4: matiko09 folded before Flop (didn't bet)
Seat 5: Carloszhang collected ($4.28)
Seat 6: I The King I (button) folded before Flop (didn't bet)
Seat 7: R1aki (small blind) folded before Flop





PokerStars Hand #152558896643:  Hold'em No Limit ($0.50/$1.00 USD) - 2016/04/28 14:53:02 CET [2016/04/28 8:53:02 ET]
Table 'Erynia' 9-max Seat #5 is the button
Seat 2: matiko09 ($142.82 in chips) 
Seat 5: scottinsf ($37.99 in chips) 
Seat 6: peevoajax ($100 in chips) 
Seat 7: vrnMike ($129.66 in chips) 
Seat 8: YourKicker78 ($50.89 in chips) 
Seat 9: ruslik_by ($62.13 in chips) 
peevoajax: posts small blind $0.50
vrnMike: posts big blind $1
sanpidk: sits out 
*** HOLE CARDS ***
Dealt to matiko09 [Qh Th]
YourKicker78: raises $2 to $3
ruslik_by: folds 
matiko09: folds 
scottinsf: folds 
peevoajax: folds 
vrnMike: folds 
Uncalled bet ($2) returned to YourKicker78
YourKicker78 collected $2.50 from pot
YourKicker78: doesn't show hand 
*** SUMMARY ***
Total pot $2.50 | Rake $0 
Seat 2: matiko09 folded before Flop (didn't bet)
Seat 5: scottinsf (button) folded before Flop (didn't bet)
Seat 6: peevoajax (small blind) folded before Flop
Seat 7: vrnMike (big blind) folded before Flop
Seat 8: YourKicker78 collected ($2.50)
Seat 9: ruslik_by folded before Flop (didn't bet)





PokerStars Hand #152558898248:  Hold'em No Limit ($0.50/$1.00 USD) - 2016/04/28 14:53:05 CET [2016/04/28 8:53:05 ET]
Table 'Zachia II' 9-max Seat #9 is the button
Seat 1: greyman571 ($155.34 in chips) 
Seat 2: sanpidk ($151.13 in chips) 
Seat 3: matiko09 ($101.50 in chips) 
Seat 4: omorfadramou ($102.97 in chips) 
Seat 5: vrnMike ($112.50 in chips) 
Seat 6: maxxmeister ($102 in chips) 
Seat 7: ozone2003 ($100 in chips) 
Seat 9: I The King I ($100 in chips) 
greyman571: posts small blind $0.50
sanpidk: posts big blind $1
aseban11: sits out 
*** HOLE CARDS ***
Dealt to matiko09 [Ac 3s]
matiko09: folds 
omorfadramou: folds 
vrnMike: folds 
maxxmeister: folds 
ozone2003: folds 
I The King I: folds 
greyman571: folds 
Uncalled bet ($0.50) returned to sanpidk
sanpidk collected $1 from pot
sanpidk: doesn't show hand 
*** SUMMARY ***
Total pot $1 | Rake $0 
Seat 1: greyman571 (small blind) folded before Flop
Seat 2: sanpidk (big blind) collected ($1)
Seat 3: matiko09 folded before Flop (didn't bet)
Seat 4: omorfadramou folded before Flop (didn't bet)
Seat 5: vrnMike folded before Flop (didn't bet)
Seat 6: maxxmeister folded before Flop (didn't bet)
Seat 7: ozone2003 folded before Flop (didn't bet)
Seat 9: I The King I (button) folded before Flop (didn't bet)





PokerStars Hand #152558898774:  Hold'em No Limit ($1/$2 USD) - 2016/04/28 14:53:06 CET [2016/04/28 8:53:06 ET]
Table 'Idomeneus II' 9-max Seat #9 is the button
Seat 1: 13Ghosts ($208.22 in chips) 
Seat 2: libbyyww ($330.54 in chips) 
Seat 3: adrenalin333 ($177.69 in chips) 
Seat 4: SoNe1988 ($83 in chips) 
Seat 5: matiko09 ($208.36 in chips) 
Seat 7: ersevi6 ($158.36 in chips) 
Seat 9: Fish4trips ($200 in chips) 
13Ghosts: posts small blind $1
libbyyww: posts big blind $2
aseban11: sits out 
*** HOLE CARDS ***
Dealt to matiko09 [8s 2s]
libbyyww said, "nh"
adrenalin333: folds 
SoNe1988: folds 
matiko09: folds 
ersevi6: folds 
Fish4trips: raises $2 to $4
13Ghosts: folds 
libbyyww: folds 
Uncalled bet ($2) returned to Fish4trips
Fish4trips collected $5 from pot
Fish4trips: doesn't show hand 
*** SUMMARY ***
Total pot $5 | Rake $0 
Seat 1: 13Ghosts (small blind) folded before Flop
Seat 2: libbyyww (big blind) folded before Flop
Seat 3: adrenalin333 folded before Flop (didn't bet)
Seat 4: SoNe1988 folded before Flop (didn't bet)
Seat 5: matiko09 folded before Flop (didn't bet)
Seat 7: ersevi6 folded before Flop (didn't bet)
Seat 9: Fish4trips (button) collected ($5)





PokerStars Hand #152558900361:  Hold'em No Limit ($0.50/$1.00 USD) - 2016/04/28 14:53:09 CET [2016/04/28 8:53:09 ET]
Table 'Ciurlionis' 9-max Seat #2 is the button
Seat 2: liuzhi14 ($236.79 in chips) 
Seat 3: koksskrt ($100 in chips) 
Seat 4: ruslik_by ($60.48 in chips) 
Seat 5: matiko09 ($104.28 in chips) 
Seat 6: peevoajax ($100 in chips) 
Seat 7: Stopton ($100 in chips) 
koksskrt: posts small blind $0.50
ruslik_by: posts big blind $1
omorfadramou: sits out 
sanpidk: sits out 
*** HOLE CARDS ***
Dealt to matiko09 [9c Jd]
matiko09: folds 
peevoajax: folds 
Stopton: folds 
liuzhi14: raises $2 to $3
koksskrt: folds 
ruslik_by: folds 
Uncalled bet ($2) returned to liuzhi14
liuzhi14 collected $2.50 from pot
liuzhi14: doesn't show hand 
*** SUMMARY ***
Total pot $2.50 | Rake $0 
Seat 2: liuzhi14 (button) collected ($2.50)
Seat 3: koksskrt (small blind) folded before Flop
Seat 4: ruslik_by (big blind) folded before Flop
Seat 5: matiko09 folded before Flop (didn't bet)
Seat 6: peevoajax folded before Flop (didn't bet)
Seat 7: Stopton folded before Flop (didn't bet)





PokerStars Hand #152558902438:  Hold'em No Limit (€0.50/€1.00 EUR) - 2016/04/28 14:53:13 CET [2016/04/28 8:53:13 ET]
Table 'Clivia II' 9-max Seat #3 is the button
Seat 1: piperkova (€48.59 in chips) 
Seat 2: HasBigBiceps (€100 in chips) 
Seat 3: R1aki (€100 in chips) 
Seat 4: matiko09 (€100 in chips) 
Seat 6: ruslik_by (€67.05 in chips) 
Seat 7: St.LaCoste (€100 in chips) 
Seat 8: Dantist1122 (€100 in chips) 
Seat 9: ozone2003 (€100 in chips) 
matiko09: posts small blind €0.50
WDW3: is sitting out 
WDW3 leaves the table
ruslik_by: posts big blind €1
*** HOLE CARDS ***
Dealt to matiko09 [6h 7h]
St.LaCoste: folds 
Dantist1122: folds 
ozone2003: raises €2 to €3
piperkova: folds 
sanpidk joins the table at seat #5 
HasBigBiceps: folds 
R1aki: folds 
matiko09: folds 
ruslik_by: folds 
Uncalled bet (€2) returned to ozone2003
ozone2003 collected €2.50 from pot
ozone2003: doesn't show hand 
*** SUMMARY ***
Total pot €2.50 | Rake €0 
Seat 1: piperkova folded before Flop (didn't bet)
Seat 2: HasBigBiceps folded before Flop (didn't bet)
Seat 3: R1aki (button) folded before Flop (didn't bet)
Seat 4: matiko09 (small blind) folded before Flop
Seat 6: ruslik_by (big blind) folded before Flop
Seat 7: St.LaCoste folded before Flop (didn't bet)
Seat 8: Dantist1122 folded before Flop (didn't bet)
Seat 9: ozone2003 collected (€2.50)





PokerStars Hand #152558908010:  Hold'em No Limit ($0.50/$1.00 USD) - 2016/04/28 14:53:22 CET [2016/04/28 8:53:22 ET]
Table 'Lyot' 9-max Seat #2 is the button
Seat 1: matiko09 ($108.61 in chips) 
Seat 2: vrnMike ($137.35 in chips) 
Seat 6: Monglaer ($124.57 in chips) 
Seat 7: PreMoze ($80.31 in chips) 
Seat 8: Patz B ($11.08 in chips) 
Seat 9: koksskrt ($100 in chips) 
aseban11 will be allowed to play after the button
Monglaer: posts small blind $0.50
PreMoze: posts big blind $1
matiko09: posts the ante $0.20
vrnMike: posts the ante $0.20
Monglaer: posts the ante $0.20
PreMoze: posts the ante $0.20
Patz B: posts the ante $0.20
koksskrt: posts the ante $0.20
*** HOLE CARDS ***
Dealt to matiko09 [9h Qc]
Yaaaazz joins the table at seat #4 
Patz B: folds 
koksskrt: raises $2.50 to $3.50
matiko09: folds 
vrnMike: folds 
Monglaer: folds 
PreMoze: calls $2.50
*** FLOP *** [Jd 4s 4d]
PreMoze: checks 
koksskrt: bets $4.29
PreMoze: folds 
Uncalled bet ($4.29) returned to koksskrt
koksskrt collected $8.26 from pot
koksskrt: doesn't show hand 
*** SUMMARY ***
Total pot $8.70 | Rake $0.44 
Board [Jd 4s 4d]
Seat 1: matiko09 folded before Flop (didn't bet)
Seat 2: vrnMike (button) folded before Flop (didn't bet)
Seat 6: Monglaer (small blind) folded before Flop
Seat 7: PreMoze (big blind) folded on the Flop
Seat 8: Patz B folded before Flop (didn't bet)
Seat 9: koksskrt collected ($8.26)





PokerStars Hand #152558908549:  Hold'em No Limit ($1/$2 USD) - 2016/04/28 14:53:23 CET [2016/04/28 8:53:23 ET]
Table 'Helio' 9-max Seat #4 is the button
Seat 1: prominente ($432.35 in chips) 
Seat 2: peevoajax ($203 in chips) 
Seat 3: InsomniaRU ($200 in chips) 
Seat 4: ersevi6 ($111.66 in chips) 
Seat 5: pretender 19 ($201.32 in chips) 
Seat 6: matiko09 ($200 in chips) 
Seat 9: rmanjkeee ($91.75 in chips) 
pretender 19: posts small blind $1
matiko09: posts big blind $2
wiseyoyo: sits out 
*** HOLE CARDS ***
Dealt to matiko09 [3h 7h]
rmanjkeee: raises $3 to $5
prominente: folds 
peevoajax: folds 
InsomniaRU: folds 
ersevi6: folds 
pretender 19: folds 
matiko09: folds 
Uncalled bet ($3) returned to rmanjkeee
rmanjkeee collected $5 from pot
rmanjkeee: doesn't show hand 
*** SUMMARY ***
Total pot $5 | Rake $0 
Seat 1: prominente folded before Flop (didn't bet)
Seat 2: peevoajax folded before Flop (didn't bet)
Seat 3: InsomniaRU folded before Flop (didn't bet)
Seat 4: ersevi6 (button) folded before Flop (didn't bet)
Seat 5: pretender 19 (small blind) folded before Flop
Seat 6: matiko09 (big blind) folded before Flop
Seat 9: rmanjkeee collected ($5)





PokerStars Hand #152558908919:  Hold'em No Limit ($1/$2 USD) - 2016/04/28 14:53:24 CET [2016/04/28 8:53:24 ET]
Table 'Mireille' 9-max Seat #3 is the button
Seat 2: matiko09 ($200 in chips) 
Seat 3: MZ2502 ($437.09 in chips) 
Seat 4: Fish4trips ($228.23 in chips) 
Seat 5: SoNe1988 ($118.42 in chips) 
Seat 6: Yaaaazz ($207.35 in chips) 
Seat 8: KDJAll3 ($927.14 in chips) 
Seat 9: a-talash ($152.30 in chips) 
Fish4trips: posts small blind $1
SoNe1988: posts big blind $2
aseban11: sits out 
*** HOLE CARDS ***
Dealt to matiko09 [5c 8s]
Yaaaazz: raises $4 to $6
KDJAll3: folds 
a-talash: folds 
matiko09: folds 
MZ2502: folds 
Fish4trips: calls $5
NamesLefTy was removed from the table for failing to post
SoNe1988: calls $4
*** FLOP *** [2c 7d 8h]
I The King I joins the table at seat #1 
Fish4trips: checks 
SoNe1988: checks 
Yaaaazz: bets $9.23
Fish4trips: folds 
SoNe1988: folds 
Uncalled bet ($9.23) returned to Yaaaazz
Yaaaazz collected $17.10 from pot
*** SUMMARY ***
Total pot $18 | Rake $0.90 
Board [2c 7d 8h]
Seat 2: matiko09 folded before Flop (didn't bet)
Seat 3: MZ2502 (button) folded before Flop (didn't bet)
Seat 4: Fish4trips (small blind) folded on the Flop
Seat 5: SoNe1988 (big blind) folded on the Flop
Seat 6: Yaaaazz collected ($17.10)
Seat 8: KDJAll3 folded before Flop (didn't bet)
Seat 9: a-talash folded before Flop (didn't bet)





PokerStars Hand #152558910321:  Hold'em No Limit (€0.50/€1.00 EUR) - 2016/04/28 14:53:26 CET [2016/04/28 8:53:26 ET]
Table 'Lumiere II' 9-max Seat #5 is the button
Seat 1: vrnMike (€108.82 in chips) 
Seat 2: Racushniak (€100 in chips) 
Seat 3: ozone2003 (€103.23 in chips) 
Seat 4: ruslik_by (€63.20 in chips) 
Seat 5: Schmidy7 (€47.05 in chips) 
Seat 6: HasBigBiceps (€100 in chips) 
Seat 7: hammerwife (€116.18 in chips) 
Seat 8: WDW3 (€103 in chips) 
Seat 9: matiko09 (€100 in chips) 
HasBigBiceps: posts small blind €0.50
hammerwife: posts big blind €1
*** HOLE CARDS ***
Dealt to matiko09 [Td 8h]
WDW3: folds 
matiko09: folds 
vrnMike: raises €1 to €2
Racushniak: folds 
ozone2003: folds 
ruslik_by: folds 
Schmidy7: folds 
HasBigBiceps: raises €7 to €9
hammerwife: folds 
vrnMike: folds 
Uncalled bet (€7) returned to HasBigBiceps
HasBigBiceps collected €5 from pot
HasBigBiceps: doesn't show hand 
*** SUMMARY ***
Total pot €5 | Rake €0 
Seat 1: vrnMike folded before Flop
Seat 2: Racushniak folded before Flop (didn't bet)
Seat 3: ozone2003 folded before Flop (didn't bet)
Seat 4: ruslik_by folded before Flop (didn't bet)
Seat 5: Schmidy7 (button) folded before Flop (didn't bet)
Seat 6: HasBigBiceps (small blind) collected (€5)
Seat 7: hammerwife (big blind) folded before Flop
Seat 8: WDW3 folded before Flop (didn't bet)
Seat 9: matiko09 folded before Flop (didn't bet)





PokerStars Hand #152558910750:  Hold'em No Limit ($0.50/$1.00 USD) - 2016/04/28 14:53:27 CET [2016/04/28 8:53:27 ET]
Table 'Erynia' 9-max Seat #6 is the button
Seat 2: matiko09 ($142.82 in chips) 
Seat 5: scottinsf ($37.99 in chips) 
Seat 6: peevoajax ($100 in chips) 
Seat 7: vrnMike ($128.66 in chips) 
Seat 8: YourKicker78 ($52.39 in chips) 
Seat 9: ruslik_by ($62.13 in chips) 
vrnMike: posts small blind $0.50
YourKicker78: posts big blind $1
aseban11: sits out 
sanpidk: sits out 
*** HOLE CARDS ***
Dealt to matiko09 [7s Kh]
ruslik_by: folds 
matiko09: folds 
scottinsf: folds 
peevoajax: folds 
vrnMike: folds 
Uncalled bet ($0.50) returned to YourKicker78
YourKicker78 collected $1 from pot
YourKicker78: doesn't show hand 
*** SUMMARY ***
Total pot $1 | Rake $0 
Seat 2: matiko09 folded before Flop (didn't bet)
Seat 5: scottinsf folded before Flop (didn't bet)
Seat 6: peevoajax (button) folded before Flop (didn't bet)
Seat 7: vrnMike (small blind) folded before Flop
Seat 8: YourKicker78 (big blind) collected ($1)
Seat 9: ruslik_by folded before Flop (didn't bet)





PokerStars Hand #152558911498:  Hold'em No Limit ($1/$2 USD) - 2016/04/28 14:53:28 CET [2016/04/28 8:53:28 ET]
Table 'Idomeneus II' 9-max Seat #1 is the button
Seat 1: 13Ghosts ($207.22 in chips) 
Seat 2: libbyyww ($328.54 in chips) 
Seat 3: adrenalin333 ($177.69 in chips) 
Seat 4: SoNe1988 ($83 in chips) 
Seat 5: matiko09 ($208.36 in chips) 
Seat 7: ersevi6 ($158.36 in chips) 
Seat 9: Fish4trips ($203 in chips) 
libbyyww: posts small blind $1
adrenalin333: posts big blind $2
aseban11: sits out 
*** HOLE CARDS ***
Dealt to matiko09 [Qh 6c]
SoNe1988: raises $5 to $7
matiko09: folds 
ersevi6: folds 
Fish4trips: folds 
13Ghosts: folds 
libbyyww: folds 
adrenalin333: calls $5
*** FLOP *** [5h Tc 2s]
adrenalin333: checks 
SoNe1988: bets $7.88
adrenalin333: folds 
Uncalled bet ($7.88) returned to SoNe1988
SoNe1988 collected $14.25 from pot
SoNe1988: doesn't show hand 
*** SUMMARY ***
Total pot $15 | Rake $0.75 
Board [5h Tc 2s]
Seat 1: 13Ghosts (button) folded before Flop (didn't bet)
Seat 2: libbyyww (small blind) folded before Flop
Seat 3: adrenalin333 (big blind) folded on the Flop
Seat 4: SoNe1988 collected ($14.25)
Seat 5: matiko09 folded before Flop (didn't bet)
Seat 7: ersevi6 folded before Flop (didn't bet)
Seat 9: Fish4trips folded before Flop (didn't bet)





PokerStars Hand #152558911948:  Hold'em No Limit ($0.50/$1.00 USD) - 2016/04/28 14:53:29 CET [2016/04/28 8:53:29 ET]
Table 'Agapenor III' 9-max Seat #4 is the button
Seat 1: I The King I ($100 in chips) 
Seat 2: cerbisor1 ($30 in chips) 
Seat 3: sanpidk ($111.78 in chips) 
Seat 4: matiko09 ($100 in chips) 
Seat 5: Painkiller72 ($109.05 in chips) 
Seat 6: azzad2007 ($100 in chips) 
Seat 7: tylerz71 ($79 in chips) 
Seat 9: DYO1000 ($35 in chips) 
Painkiller72: posts small blind $0.50
azzad2007: posts big blind $1
NoState11: sits out 
*** HOLE CARDS ***
Dealt to matiko09 [9c 7h]
tylerz71: folds 
DYO1000: raises $2 to $3
I The King I: folds 
cerbisor1: raises $27 to $30 and is all-in
sanpidk: folds 
matiko09: folds 
Painkiller72: folds 
azzad2007: folds 
DYO1000: folds 
Uncalled bet ($27) returned to cerbisor1
cerbisor1 collected $7.50 from pot
cerbisor1: doesn't show hand 
*** SUMMARY ***
Total pot $7.50 | Rake $0 
Seat 1: I The King I folded before Flop (didn't bet)
Seat 2: cerbisor1 collected ($7.50)
Seat 3: sanpidk folded before Flop (didn't bet)
Seat 4: matiko09 (button) folded before Flop (didn't bet)
Seat 5: Painkiller72 (small blind) folded before Flop
Seat 6: azzad2007 (big blind) folded before Flop
Seat 7: tylerz71 folded before Flop (didn't bet)
Seat 9: DYO1000 folded before Flop





PokerStars Hand #152558914663:  Hold'em No Limit ($0.50/$1.00 USD) - 2016/04/28 14:53:34 CET [2016/04/28 8:53:34 ET]
Table 'Zachia II' 9-max Seat #1 is the button
Seat 1: greyman571 ($154.84 in chips) 
Seat 2: sanpidk ($151.63 in chips) 
Seat 3: matiko09 ($101.50 in chips) 
Seat 4: omorfadramou ($102.97 in chips) 
Seat 5: vrnMike ($112.50 in chips) 
Seat 6: maxxmeister ($102 in chips) 
Seat 7: ozone2003 ($100 in chips) 
Seat 9: I The King I ($100 in chips) 
sanpidk: posts small blind $0.50
matiko09: posts big blind $1
aseban11: sits out 
*** HOLE CARDS ***
Dealt to matiko09 [Ad 8c]
omorfadramou: folds 
vrnMike: folds 
maxxmeister: folds 
ozone2003: folds 
I The King I: folds 
greyman571: folds 
sanpidk: folds 
Uncalled bet ($0.50) returned to matiko09
matiko09 collected $1 from pot
matiko09: doesn't show hand 
*** SUMMARY ***
Total pot $1 | Rake $0 
Seat 1: greyman571 (button) folded before Flop (didn't bet)
Seat 2: sanpidk (small blind) folded before Flop
Seat 3: matiko09 (big blind) collected ($1)
Seat 4: omorfadramou folded before Flop (didn't bet)
Seat 5: vrnMike folded before Flop (didn't bet)
Seat 6: maxxmeister folded before Flop (didn't bet)
Seat 7: ozone2003 folded before Flop (didn't bet)
Seat 9: I The King I folded before Flop (didn't bet)





PokerStars Hand #152558919859:  Hold'em No Limit ($0.50/$1.00 USD) - 2016/04/28 14:53:43 CET [2016/04/28 8:53:43 ET]
Table 'Ciurlionis' 9-max Seat #3 is the button
Seat 2: liuzhi14 ($238.29 in chips) 
Seat 3: koksskrt ($100 in chips) 
Seat 4: ruslik_by ($59.48 in chips) 
Seat 5: matiko09 ($104.28 in chips) 
Seat 6: peevoajax ($100 in chips) 
Seat 7: Stopton ($100 in chips) 
ruslik_by: posts small blind $0.50
matiko09: posts big blind $1
omorfadramou: sits out 
sanpidk: sits out 
*** HOLE CARDS ***
Dealt to matiko09 [6d 7s]
peevoajax has timed out
peevoajax: folds 
Stopton: folds 
liuzhi14: folds 
koksskrt: raises $1 to $2
ruslik_by: folds 
matiko09: folds 
Uncalled bet ($1) returned to koksskrt
koksskrt collected $2.50 from pot
koksskrt: doesn't show hand 
*** SUMMARY ***
Total pot $2.50 | Rake $0 
Seat 2: liuzhi14 folded before Flop (didn't bet)
Seat 3: koksskrt (button) collected ($2.50)
Seat 4: ruslik_by (small blind) folded before Flop
Seat 5: matiko09 (big blind) folded before Flop
Seat 6: peevoajax folded before Flop (didn't bet)
Seat 7: Stopton folded before Flop (didn't bet)





PokerStars Hand #152558923176:  Hold'em No Limit ($0.50/$1.00 USD) - 2016/04/28 14:53:49 CET [2016/04/28 8:53:49 ET]
Table 'Erynia' 9-max Seat #7 is the button
Seat 2: matiko09 ($142.82 in chips) 
Seat 5: scottinsf ($37.99 in chips) 
Seat 6: peevoajax ($100 in chips) 
Seat 7: vrnMike ($128.16 in chips) 
Seat 8: YourKicker78 ($52.89 in chips) 
Seat 9: ruslik_by ($62.13 in chips) 
YourKicker78: posts small blind $0.50
ruslik_by: posts big blind $1
aseban11: sits out 
sanpidk: sits out 
*** HOLE CARDS ***
Dealt to matiko09 [5c 3c]
matiko09: folds 
scottinsf: folds 
peevoajax: folds 
vrnMike: folds 
YourKicker78: raises $2 to $3
ruslik_by: folds 
Uncalled bet ($2) returned to YourKicker78
YourKicker78 collected $2 from pot
YourKicker78: doesn't show hand 
*** SUMMARY ***
Total pot $2 | Rake $0 
Seat 2: matiko09 folded before Flop (didn't bet)
Seat 5: scottinsf folded before Flop (didn't bet)
Seat 6: peevoajax folded before Flop (didn't bet)
Seat 7: vrnMike (button) folded before Flop (didn't bet)
Seat 8: YourKicker78 (small blind) collected ($2)
Seat 9: ruslik_by (big blind) folded before Flop





PokerStars Hand #152558924546:  Hold'em No Limit ($1/$2 USD) - 2016/04/28 14:53:51 CET [2016/04/28 8:53:51 ET]
Table 'Libera II' 9-max Seat #3 is the button
Seat 1: libbyyww ($200 in chips) 
Seat 2: peevoajax ($200 in chips) 
Seat 3: maverick7614 ($197 in chips) 
Seat 4: Sly-Hustler ($88.80 in chips) 
Seat 5: ersevi6 ($138.30 in chips) 
Seat 6: matiko09 ($200 in chips) 
Seat 7: Fish4trips ($395.25 in chips) 
Seat 8: WDW3 ($248.02 in chips) 
Seat 9: InsomniaRU ($200 in chips) 
Sly-Hustler: posts small blind $1
ersevi6: posts big blind $2
*** HOLE CARDS ***
Dealt to matiko09 [4c 7c]
matiko09: folds 
Fish4trips: folds 
WDW3: folds 
InsomniaRU: folds 
libbyyww: folds 
peevoajax: folds 
maverick7614: folds 
Sly-Hustler: folds 
Uncalled bet ($1) returned to ersevi6
ersevi6 collected $2 from pot
ersevi6: doesn't show hand 
*** SUMMARY ***
Total pot $2 | Rake $0 
Seat 1: libbyyww folded before Flop (didn't bet)
Seat 2: peevoajax folded before Flop (didn't bet)
Seat 3: maverick7614 (button) folded before Flop (didn't bet)
Seat 4: Sly-Hustler (small blind) folded before Flop
Seat 5: ersevi6 (big blind) collected ($2)
Seat 6: matiko09 folded before Flop (didn't bet)
Seat 7: Fish4trips folded before Flop (didn't bet)
Seat 8: WDW3 folded before Flop (didn't bet)
Seat 9: InsomniaRU folded before Flop (didn't bet)





PokerStars Hand #152558925878:  Hold'em No Limit ($0.50/$1.00 USD) - 2016/04/28 14:53:54 CET [2016/04/28 8:53:54 ET]
Table 'Bruwer' 9-max Seat #7 is the button
Seat 2: ruslik_by ($40 in chips) 
Seat 3: koksskrt ($109.11 in chips) 
Seat 4: matiko09 ($141.04 in chips) 
Seat 5: Carloszhang ($118.35 in chips) 
Seat 6: I The King I ($111.02 in chips) 
Seat 7: R1aki ($247.08 in chips) 
lumen21 will be allowed to play after the button
aseban11 will be allowed to play after the button
ruslik_by: posts small blind $0.50
koksskrt: posts big blind $1
*** HOLE CARDS ***
Dealt to matiko09 [2h Th]
matiko09: folds 
Carloszhang: folds 
I The King I: folds 
R1aki: folds 
ruslik_by: raises $2 to $3
koksskrt: folds 
Uncalled bet ($2) returned to ruslik_by
ruslik_by collected $2 from pot
ruslik_by: doesn't show hand 
*** SUMMARY ***
Total pot $2 | Rake $0 
Seat 2: ruslik_by (small blind) collected ($2)
Seat 3: koksskrt (big blind) folded before Flop
Seat 4: matiko09 folded before Flop (didn't bet)
Seat 5: Carloszhang folded before Flop (didn't bet)
Seat 6: I The King I folded before Flop (didn't bet)
Seat 7: R1aki (button) folded before Flop (didn't bet)





PokerStars Hand #152558930479:  Hold'em No Limit (€0.50/€1.00 EUR) - 2016/04/28 14:54:02 CET [2016/04/28 8:54:02 ET]
Table 'Clivia II' 9-max Seat #4 is the button
Seat 1: piperkova (€48.59 in chips) 
Seat 2: HasBigBiceps (€100 in chips) 
Seat 3: R1aki (€100 in chips) 
Seat 4: matiko09 (€100 in chips) 
Seat 6: ruslik_by (€66.05 in chips) 
Seat 7: St.LaCoste (€100 in chips) 
Seat 8: Dantist1122 (€100 in chips) 
Seat 9: ozone2003 (€101.50 in chips) 
sanpidk will be allowed to play after the button
ruslik_by: posts small blind €0.50
St.LaCoste: posts big blind €1
*** HOLE CARDS ***
Dealt to matiko09 [5d 7h]
Dantist1122: folds 
ozone2003: folds 
piperkova: folds 
HasBigBiceps: folds 
R1aki: folds 
matiko09: folds 
ruslik_by: raises €2 to €3
St.LaCoste: folds 
Uncalled bet (€2) returned to ruslik_by
ruslik_by collected €2 from pot
ruslik_by: doesn't show hand 
*** SUMMARY ***
Total pot €2 | Rake €0 
Seat 1: piperkova folded before Flop (didn't bet)
Seat 2: HasBigBiceps folded before Flop (didn't bet)
Seat 3: R1aki folded before Flop (didn't bet)
Seat 4: matiko09 (button) folded before Flop (didn't bet)
Seat 6: ruslik_by (small blind) collected (€2)
Seat 7: St.LaCoste (big blind) folded before Flop
Seat 8: Dantist1122 folded before Flop (didn't bet)
Seat 9: ozone2003 folded before Flop (didn't bet)





PokerStars Hand #152558931364:  Hold'em No Limit ($1/$2 USD) - 2016/04/28 14:54:03 CET [2016/04/28 8:54:03 ET]
Table 'Helio' 9-max Seat #5 is the button
Seat 1: prominente ($432.35 in chips) 
Seat 2: peevoajax ($203 in chips) 
Seat 3: InsomniaRU ($200 in chips) 
Seat 4: ersevi6 ($111.66 in chips) 
Seat 5: pretender 19 ($200.32 in chips) 
Seat 6: matiko09 ($200 in chips) 
Seat 8: wiseyoyo ($200 in chips) 
Seat 9: rmanjkeee ($94.75 in chips) 
matiko09: posts small blind $1
wiseyoyo: posts big blind $2
*** HOLE CARDS ***
Dealt to matiko09 [3c 5h]
rmanjkeee: folds 
prominente: folds 
peevoajax: folds 
InsomniaRU: folds 
ersevi6: folds 
pretender 19: folds 
matiko09: folds 
Uncalled bet ($1) returned to wiseyoyo
wiseyoyo collected $2 from pot
wiseyoyo: doesn't show hand 
*** SUMMARY ***
Total pot $2 | Rake $0 
Seat 1: prominente folded before Flop (didn't bet)
Seat 2: peevoajax folded before Flop (didn't bet)
Seat 3: InsomniaRU folded before Flop (didn't bet)
Seat 4: ersevi6 folded before Flop (didn't bet)
Seat 5: pretender 19 (button) folded before Flop (didn't bet)
Seat 6: matiko09 (small blind) folded before Flop
Seat 8: wiseyoyo (big blind) collected ($2)
Seat 9: rmanjkeee folded before Flop (didn't bet)





PokerStars Hand #152558933785:  Hold'em No Limit ($0.50/$1.00 USD) - 2016/04/28 14:54:07 CET [2016/04/28 8:54:07 ET]
Table 'Lyot' 9-max Seat #6 is the button
Seat 1: matiko09 ($108.41 in chips) 
Seat 2: vrnMike ($137.15 in chips) 
Seat 6: Monglaer ($123.87 in chips) 
Seat 7: PreMoze ($76.61 in chips) 
Seat 8: Patz B ($10.88 in chips) 
Seat 9: koksskrt ($104.56 in chips) 
PreMoze: posts small blind $0.50
Patz B: posts big blind $1
aseban11: sits out 
Yaaaazz: sits out 
matiko09: posts the ante $0.20
vrnMike: posts the ante $0.20
Monglaer: posts the ante $0.20
PreMoze: posts the ante $0.20
Patz B: posts the ante $0.20
koksskrt: posts the ante $0.20
*** HOLE CARDS ***
Dealt to matiko09 [5h 2h]
koksskrt: folds 
matiko09: folds 
vrnMike: folds 
Monglaer: folds 
PreMoze: folds 
Uncalled bet ($0.50) returned to Patz B
Patz B collected $2.20 from pot
*** SUMMARY ***
Total pot $2.20 | Rake $0 
Seat 1: matiko09 folded before Flop (didn't bet)
Seat 2: vrnMike folded before Flop (didn't bet)
Seat 6: Monglaer (button) folded before Flop (didn't bet)
Seat 7: PreMoze (small blind) folded before Flop
Seat 8: Patz B (big blind) collected ($2.20)
Seat 9: koksskrt folded before Flop (didn't bet)





PokerStars Hand #152558934152:  Hold'em No Limit ($0.50/$1.00 USD) - 2016/04/28 14:54:08 CET [2016/04/28 8:54:08 ET]
Table 'Agapenor III' 9-max Seat #5 is the button
Seat 1: I The King I ($100 in chips) 
Seat 2: cerbisor1 ($34.50 in chips) 
Seat 3: sanpidk ($111.78 in chips) 
Seat 4: matiko09 ($100 in chips) 
Seat 5: Painkiller72 ($108.55 in chips) 
Seat 6: azzad2007 ($100 in chips) 
Seat 7: tylerz71 ($79 in chips) 
Seat 9: DYO1000 ($32 in chips) 
azzad2007: posts small blind $0.50
tylerz71: posts big blind $1
NoState11: sits out 
*** HOLE CARDS ***
Dealt to matiko09 [Ks 8c]
DYO1000: folds 
I The King I: raises $2 to $3
cerbisor1: folds 
sanpidk: folds 
matiko09: folds 
Painkiller72: calls $3
azzad2007: folds 
tylerz71: folds 
*** FLOP *** [3d 8s 6d]
I The King I: checks 
Painkiller72: checks 
*** TURN *** [3d 8s 6d] [4c]
I The King I: checks 
Painkiller72: checks 
*** RIVER *** [3d 8s 6d 4c] [Jd]
I The King I: checks 
Painkiller72: bets $4.98
I The King I: folds 
Uncalled bet ($4.98) returned to Painkiller72
Painkiller72 collected $7.12 from pot
Painkiller72: doesn't show hand 
*** SUMMARY ***
Total pot $7.50 | Rake $0.38 
Board [3d 8s 6d 4c Jd]
Seat 1: I The King I folded on the River
Seat 2: cerbisor1 folded before Flop (didn't bet)
Seat 3: sanpidk folded before Flop (didn't bet)
Seat 4: matiko09 folded before Flop (didn't bet)
Seat 5: Painkiller72 (button) collected ($7.12)
Seat 6: azzad2007 (small blind) folded before Flop
Seat 7: tylerz71 (big blind) folded before Flop
Seat 9: DYO1000 folded before Flop (didn't bet)





PokerStars Hand #152558934861:  Hold'em No Limit ($1/$2 USD) - 2016/04/28 14:54:09 CET [2016/04/28 8:54:09 ET]
Table 'Libera II' 9-max Seat #4 is the button
Seat 1: libbyyww ($200 in chips) 
Seat 2: peevoajax ($200 in chips) 
Seat 3: maverick7614 ($197 in chips) 
Seat 4: Sly-Hustler ($87.80 in chips) 
Seat 5: ersevi6 ($139.30 in chips) 
Seat 6: matiko09 ($200 in chips) 
Seat 7: Fish4trips ($395.25 in chips) 
Seat 8: WDW3 ($248.02 in chips) 
Seat 9: InsomniaRU ($200 in chips) 
ersevi6: posts small blind $1
matiko09: posts big blind $2
*** HOLE CARDS ***
Dealt to matiko09 [Kc 7d]
Fish4trips: folds 
WDW3: raises $3.60 to $5.60
InsomniaRU: folds 
libbyyww: folds 
peevoajax: folds 
maverick7614: folds 
Sly-Hustler: folds 
ersevi6: folds 
matiko09: folds 
Uncalled bet ($3.60) returned to WDW3
WDW3 collected $5 from pot
WDW3: doesn't show hand 
*** SUMMARY ***
Total pot $5 | Rake $0 
Seat 1: libbyyww folded before Flop (didn't bet)
Seat 2: peevoajax folded before Flop (didn't bet)
Seat 3: maverick7614 folded before Flop (didn't bet)
Seat 4: Sly-Hustler (button) folded before Flop (didn't bet)
Seat 5: ersevi6 (small blind) folded before Flop
Seat 6: matiko09 (big blind) folded before Flop
Seat 7: Fish4trips folded before Flop (didn't bet)
Seat 8: WDW3 collected ($5)
Seat 9: InsomniaRU folded before Flop (didn't bet)





PokerStars Hand #152558936234:  Hold'em No Limit ($0.50/$1.00 USD) - 2016/04/28 14:54:12 CET [2016/04/28 8:54:12 ET]
Table 'Erynia' 9-max Seat #8 is the button
Seat 2: matiko09 ($142.82 in chips) 
Seat 5: scottinsf ($37.99 in chips) 
Seat 6: peevoajax ($100 in chips) 
Seat 7: vrnMike ($128.16 in chips) 
Seat 8: YourKicker78 ($53.89 in chips) 
Seat 9: ruslik_by ($61.13 in chips) 
ruslik_by: posts small blind $0.50
matiko09: posts big blind $1
aseban11: sits out 
sanpidk: sits out 
*** HOLE CARDS ***
Dealt to matiko09 [8s 9c]
scottinsf: folds 
peevoajax: folds 
NamesLefTy was removed from the table for failing to post
I The King I joins the table at seat #1 
vrnMike: folds 
YourKicker78: folds 
ruslik_by: folds 
Uncalled bet ($0.50) returned to matiko09
matiko09 collected $1 from pot
matiko09: doesn't show hand 
*** SUMMARY ***
Total pot $1 | Rake $0 
Seat 2: matiko09 (big blind) collected ($1)
Seat 5: scottinsf folded before Flop (didn't bet)
Seat 6: peevoajax folded before Flop (didn't bet)
Seat 7: vrnMike folded before Flop (didn't bet)
Seat 8: YourKicker78 (button) folded before Flop (didn't bet)
Seat 9: ruslik_by (small blind) folded before Flop





PokerStars Hand #152558940346:  Hold'em No Limit ($0.50/$1.00 USD) - 2016/04/28 14:54:19 CET [2016/04/28 8:54:19 ET]
Table 'Zachia II' 9-max Seat #2 is the button
Seat 1: greyman571 ($154.84 in chips) 
Seat 2: sanpidk ($151.13 in chips) 
Seat 3: matiko09 ($102 in chips) 
Seat 4: omorfadramou ($102.97 in chips) 
Seat 5: vrnMike ($112.50 in chips) 
Seat 6: maxxmeister ($102 in chips) 
Seat 7: ozone2003 ($100 in chips) 
Seat 9: I The King I ($100 in chips) 
matiko09: posts small blind $0.50
omorfadramou: posts big blind $1
aseban11: sits out 
*** HOLE CARDS ***
Dealt to matiko09 [4d 2c]
vrnMike: folds 
maxxmeister: folds 
ozone2003: folds 
I The King I: folds 
greyman571: folds 
sanpidk: folds 
matiko09: folds 
Uncalled bet ($0.50) returned to omorfadramou
omorfadramou collected $1 from pot
omorfadramou: doesn't show hand 
*** SUMMARY ***
Total pot $1 | Rake $0 
Seat 1: greyman571 folded before Flop (didn't bet)
Seat 2: sanpidk (button) folded before Flop (didn't bet)
Seat 3: matiko09 (small blind) folded before Flop
Seat 4: omorfadramou (big blind) collected ($1)
Seat 5: vrnMike folded before Flop (didn't bet)
Seat 6: maxxmeister folded before Flop (didn't bet)
Seat 7: ozone2003 folded before Flop (didn't bet)
Seat 9: I The King I folded before Flop (didn't bet)





PokerStars Hand #152558941559:  Hold'em No Limit ($1/$2 USD) - 2016/04/28 14:54:21 CET [2016/04/28 8:54:21 ET]
Table 'Helio' 9-max Seat #6 is the button
Seat 1: prominente ($432.35 in chips) 
Seat 2: peevoajax ($203 in chips) 
Seat 3: InsomniaRU ($200 in chips) 
Seat 4: ersevi6 ($111.66 in chips) 
Seat 5: pretender 19 ($200.32 in chips) 
Seat 6: matiko09 ($200 in chips) 
Seat 8: wiseyoyo ($201 in chips) 
Seat 9: rmanjkeee ($94.75 in chips) 
wiseyoyo: posts small blind $1
rmanjkeee: posts big blind $2
*** HOLE CARDS ***
Dealt to matiko09 [Th 9s]
prominente: folds 
peevoajax: folds 
InsomniaRU: folds 
ersevi6: folds 
pretender 19: folds 
matiko09: folds 
wiseyoyo: raises $3.02 to $5.02
rmanjkeee: calls $3.02
*** FLOP *** [Kh 4h 9d]
wiseyoyo: checks 
rmanjkeee: checks 
*** TURN *** [Kh 4h 9d] [As]
wiseyoyo: bets $7
rmanjkeee: raises $19 to $26
wiseyoyo: calls $19
*** RIVER *** [Kh 4h 9d As] [Ac]
wiseyoyo: checks 
rmanjkeee: checks 
*** SHOW DOWN ***
wiseyoyo: shows [Qh Ah] (three of a kind, Aces)
rmanjkeee: mucks hand 
wiseyoyo collected $59.29 from pot
*** SUMMARY ***
Total pot $62.04 | Rake $2.75 
Board [Kh 4h 9d As Ac]
Seat 1: prominente folded before Flop (didn't bet)
Seat 2: peevoajax folded before Flop (didn't bet)
Seat 3: InsomniaRU folded before Flop (didn't bet)
Seat 4: ersevi6 folded before Flop (didn't bet)
Seat 5: pretender 19 folded before Flop (didn't bet)
Seat 6: matiko09 (button) folded before Flop (didn't bet)
Seat 8: wiseyoyo (small blind) showed [Qh Ah] and won ($59.29) with three of a kind, Aces
Seat 9: rmanjkeee (big blind) mucked [9c Ks]





PokerStars Hand #152558941594:  Hold'em No Limit ($1/$2 USD) - 2016/04/28 14:54:21 CET [2016/04/28 8:54:21 ET]
Table 'Idomeneus II' 9-max Seat #2 is the button
Seat 1: 13Ghosts ($207.22 in chips) 
Seat 2: libbyyww ($327.54 in chips) 
Seat 3: adrenalin333 ($170.69 in chips) 
Seat 4: SoNe1988 ($90.25 in chips) 
Seat 5: matiko09 ($208.36 in chips) 
Seat 7: ersevi6 ($158.36 in chips) 
Seat 9: Fish4trips ($203 in chips) 
adrenalin333: posts small blind $1
SoNe1988: posts big blind $2
aseban11: sits out 
*** HOLE CARDS ***
Dealt to matiko09 [6d Kd]
matiko09: folds 
ersevi6: raises $3 to $5
Fish4trips: calls $5
13Ghosts: folds 
libbyyww: calls $5
adrenalin333: folds 
SoNe1988: folds 
*** FLOP *** [Ac 7s 6s]
ersevi6: bets $11.45
Fish4trips: folds 
libbyyww: calls $11.45
*** TURN *** [Ac 7s 6s] [3s]
ersevi6: checks 
libbyyww: checks 
*** RIVER *** [Ac 7s 6s 3s] [Ts]
ersevi6: checks 
libbyyww: bets $23.31
ersevi6: folds 
Uncalled bet ($23.31) returned to libbyyww
libbyyww collected $38.86 from pot
libbyyww: doesn't show hand 
*** SUMMARY ***
Total pot $40.90 | Rake $2.04 
Board [Ac 7s 6s 3s Ts]
Seat 1: 13Ghosts folded before Flop (didn't bet)
Seat 2: libbyyww (button) collected ($38.86)
Seat 3: adrenalin333 (small blind) folded before Flop
Seat 4: SoNe1988 (big blind) folded before Flop
Seat 5: matiko09 folded before Flop (didn't bet)
Seat 7: ersevi6 folded on the River
Seat 9: Fish4trips folded on the Flop





PokerStars Hand #152558941217:  Hold'em No Limit (€0.50/€1.00 EUR) - 2016/04/28 14:54:21 CET [2016/04/28 8:54:21 ET]
Table 'Lumiere II' 9-max Seat #6 is the button
Seat 1: vrnMike (€106.82 in chips) 
Seat 2: Racushniak (€100 in chips) 
Seat 3: ozone2003 (€103.23 in chips) 
Seat 4: ruslik_by (€63.20 in chips) 
Seat 5: Schmidy7 (€47.05 in chips) 
Seat 6: HasBigBiceps (€103 in chips) 
Seat 7: hammerwife (€115.18 in chips) 
Seat 9: matiko09 (€100 in chips) 
hammerwife: posts small blind €0.50
WDW3: is sitting out 
matiko09: posts big blind €1
*** HOLE CARDS ***
Dealt to matiko09 [Ah 3c]
WDW3 leaves the table
sanpidk joins the table at seat #8 
vrnMike: raises €1 to €2
Racushniak: folds 
ozone2003: folds 
ruslik_by: folds 
Schmidy7: folds 
HasBigBiceps: folds 
hammerwife: folds 
matiko09: folds 
Uncalled bet (€1) returned to vrnMike
vrnMike collected €2.50 from pot
*** SUMMARY ***
Total pot €2.50 | Rake €0 
Seat 1: vrnMike collected (€2.50)
Seat 2: Racushniak folded before Flop (didn't bet)
Seat 3: ozone2003 folded before Flop (didn't bet)
Seat 4: ruslik_by folded before Flop (didn't bet)
Seat 5: Schmidy7 folded before Flop (didn't bet)
Seat 6: HasBigBiceps (button) folded before Flop (didn't bet)
Seat 7: hammerwife (small blind) folded before Flop
Seat 9: matiko09 (big blind) folded before Flop





PokerStars Hand #152558942174:  Hold'em No Limit ($0.50/$1.00 USD) - 2016/04/28 14:54:22 CET [2016/04/28 8:54:22 ET]
Table 'Ciurlionis' 9-max Seat #4 is the button
Seat 2: liuzhi14 ($238.29 in chips) 
Seat 3: koksskrt ($101.50 in chips) 
Seat 4: ruslik_by ($58.98 in chips) 
Seat 5: matiko09 ($103.28 in chips) 
Seat 6: peevoajax ($100 in chips) 
Seat 7: Stopton ($100 in chips) 
matiko09: posts small blind $0.50
peevoajax: posts big blind $1
omorfadramou: sits out 
sanpidk: sits out 
*** HOLE CARDS ***
Dealt to matiko09 [Tc Qd]
Stopton: folds 
liuzhi14: folds 
koksskrt: folds 
ruslik_by: raises $1 to $2
matiko09: folds 
Painkiller72 joins the table at seat #9 
peevoajax: calls $1
*** FLOP *** [Td 9d Ac]
peevoajax: checks 
ruslik_by: bets $2
peevoajax: calls $2
*** TURN *** [Td 9d Ac] [7c]
peevoajax: checks 
ruslik_by: bets $3
peevoajax: calls $3
*** RIVER *** [Td 9d Ac 7c] [Kc]
peevoajax: checks 
ruslik_by: bets $6.50
peevoajax: folds 
Uncalled bet ($6.50) returned to ruslik_by
ruslik_by collected $13.78 from pot
ruslik_by: doesn't show hand 
*** SUMMARY ***
Total pot $14.50 | Rake $0.72 
Board [Td 9d Ac 7c Kc]
Seat 2: liuzhi14 folded before Flop (didn't bet)
Seat 3: koksskrt folded before Flop (didn't bet)
Seat 4: ruslik_by (button) collected ($13.78)
Seat 5: matiko09 (small blind) folded before Flop
Seat 6: peevoajax (big blind) folded on the River
Seat 7: Stopton folded before Flop (didn't bet)





PokerStars Hand #152558943410:  Hold'em No Limit ($0.50/$1.00 USD) - 2016/04/28 14:54:24 CET [2016/04/28 8:54:24 ET]
Table 'Azimech' 9-max Seat #2 is the button
Seat 1: peevoajax ($168.86 in chips) 
Seat 2: adikier ($236.35 in chips) 
Seat 3: matiko09 ($100 in chips) 
Seat 4: ruslik_by ($82.90 in chips) 
Seat 5: ozone2003 ($100 in chips) 
Seat 6: sanpidk ($100 in chips) 
Seat 7: azzad2007 ($100 in chips) 
Seat 8: vrnMike ($100 in chips) 
Seat 9: scottinsf ($58.40 in chips) 
matiko09: posts small blind $0.50
ruslik_by: posts big blind $1
*** HOLE CARDS ***
Dealt to matiko09 [8d Ac]
ozone2003: folds 
sanpidk: folds 
azzad2007: folds 
vrnMike: raises $1 to $2
scottinsf: folds 
peevoajax: folds 
adikier: folds 
matiko09: folds 
ruslik_by: calls $1
*** FLOP *** [Ad Ks 2c]
ruslik_by: checks 
vrnMike: checks 
*** TURN *** [Ad Ks 2c] [Qs]
ruslik_by: bets $1.50
vrnMike: raises $2.50 to $4
ruslik_by: calls $2.50
*** RIVER *** [Ad Ks 2c Qs] [Th]
ruslik_by: bets $4.50
vrnMike: folds 
Uncalled bet ($4.50) returned to ruslik_by
ruslik_by collected $11.88 from pot
ruslik_by: doesn't show hand 
*** SUMMARY ***
Total pot $12.50 | Rake $0.62 
Board [Ad Ks 2c Qs Th]
Seat 1: peevoajax folded before Flop (didn't bet)
Seat 2: adikier (button) folded before Flop (didn't bet)
Seat 3: matiko09 (small blind) folded before Flop
Seat 4: ruslik_by (big blind) collected ($11.88)
Seat 5: ozone2003 folded before Flop (didn't bet)
Seat 6: sanpidk folded before Flop (didn't bet)
Seat 7: azzad2007 folded before Flop (didn't bet)
Seat 8: vrnMike folded on the River
Seat 9: scottinsf folded before Flop (didn't bet)





PokerStars Hand #152558946121:  Hold'em No Limit ($0.50/$1.00 USD) - 2016/04/28 14:54:29 CET [2016/04/28 8:54:29 ET]
Table 'Bruwer' 9-max Seat #2 is the button
Seat 2: ruslik_by ($41 in chips) 
Seat 3: koksskrt ($108.11 in chips) 
Seat 4: matiko09 ($141.04 in chips) 
Seat 5: Carloszhang ($118.35 in chips) 
Seat 6: I The King I ($111.02 in chips) 
Seat 7: R1aki ($247.08 in chips) 
koksskrt: posts small blind $0.50
matiko09: posts big blind $1
lumen21: sits out 
aseban11: sits out 
*** HOLE CARDS ***
Dealt to matiko09 [4c 9c]
Carloszhang: folds 
I The King I: folds 
R1aki: folds 
ruslik_by: raises $1 to $2
koksskrt: folds 
matiko09: folds 
Uncalled bet ($1) returned to ruslik_by
ruslik_by collected $2.50 from pot
ruslik_by: doesn't show hand 
*** SUMMARY ***
Total pot $2.50 | Rake $0 
Seat 2: ruslik_by (button) collected ($2.50)
Seat 3: koksskrt (small blind) folded before Flop
Seat 4: matiko09 (big blind) folded before Flop
Seat 5: Carloszhang folded before Flop (didn't bet)
Seat 6: I The King I folded before Flop (didn't bet)
Seat 7: R1aki folded before Flop (didn't bet)





PokerStars Hand #152558946558:  Hold'em No Limit ($0.50/$1.00 USD) - 2016/04/28 14:54:30 CET [2016/04/28 8:54:30 ET]
Table 'Lyot' 9-max Seat #7 is the button
Seat 1: matiko09 ($108.21 in chips) 
Seat 2: vrnMike ($136.95 in chips) 
Seat 6: Monglaer ($123.67 in chips) 
Seat 7: PreMoze ($75.91 in chips) 
Seat 8: Patz B ($12.38 in chips) 
Seat 9: koksskrt ($104.36 in chips) 
Patz B: posts small blind $0.50
koksskrt: posts big blind $1
aseban11: sits out 
Yaaaazz: sits out 
matiko09: posts the ante $0.20
vrnMike: posts the ante $0.20
Monglaer: posts the ante $0.20
PreMoze: posts the ante $0.20
Patz B: posts the ante $0.20
koksskrt: posts the ante $0.20
*** HOLE CARDS ***
Dealt to matiko09 [As 6s]
matiko09: folds 
vrnMike: folds 
Monglaer: folds 
PreMoze: folds 
Patz B: raises $2 to $3
koksskrt: folds 
Uncalled bet ($2) returned to Patz B
Patz B collected $3.20 from pot
*** SUMMARY ***
Total pot $3.20 | Rake $0 
Seat 1: matiko09 folded before Flop (didn't bet)
Seat 2: vrnMike folded before Flop (didn't bet)
Seat 6: Monglaer folded before Flop (didn't bet)
Seat 7: PreMoze (button) folded before Flop (didn't bet)
Seat 8: Patz B (small blind) collected ($3.20)
Seat 9: koksskrt (big blind) folded before Flop





PokerStars Hand #152558946895:  Hold'em No Limit ($0.50/$1.00 USD) - 2016/04/28 14:54:31 CET [2016/04/28 8:54:31 ET]
Table 'Erynia' 9-max Seat #9 is the button
Seat 2: matiko09 ($143.32 in chips) 
Seat 3: aseban11 ($115.04 in chips) 
Seat 5: scottinsf ($37.99 in chips) 
Seat 6: peevoajax ($100 in chips) 
Seat 7: vrnMike ($128.16 in chips) 
Seat 8: YourKicker78 ($53.89 in chips) 
Seat 9: ruslik_by ($60.63 in chips) 
I The King I will be allowed to play after the button
matiko09: posts small blind $0.50
aseban11: posts big blind $1
sanpidk: sits out 
*** HOLE CARDS ***
Dealt to matiko09 [3c 9d]
scottinsf: folds 
peevoajax: folds 
vrnMike: folds 
YourKicker78: raises $2 to $3
ruslik_by: folds 
matiko09: folds 
aseban11: calls $2
*** FLOP *** [4s 6d 2h]
aseban11: checks 
YourKicker78: checks 
*** TURN *** [4s 6d 2h] [5s]
aseban11: checks 
YourKicker78: bets $4
aseban11: folds 
Uncalled bet ($4) returned to YourKicker78
YourKicker78 collected $6.18 from pot
YourKicker78: doesn't show hand 
*** SUMMARY ***
Total pot $6.50 | Rake $0.32 
Board [4s 6d 2h 5s]
Seat 2: matiko09 (small blind) folded before Flop
Seat 3: aseban11 (big blind) folded on the Turn
Seat 5: scottinsf folded before Flop (didn't bet)
Seat 6: peevoajax folded before Flop (didn't bet)
Seat 7: vrnMike folded before Flop (didn't bet)
Seat 8: YourKicker78 collected ($6.18)
Seat 9: ruslik_by (button) folded before Flop (didn't bet)





PokerStars Hand #152558949509:  Hold'em No Limit ($1/$2 USD) - 2016/04/28 14:54:35 CET [2016/04/28 8:54:35 ET]
Table 'Libera II' 9-max Seat #5 is the button
Seat 1: libbyyww ($200 in chips) 
Seat 2: peevoajax ($200 in chips) 
Seat 3: maverick7614 ($197 in chips) 
Seat 4: Sly-Hustler ($87.80 in chips) 
Seat 5: ersevi6 ($138.30 in chips) 
Seat 6: matiko09 ($200 in chips) 
Seat 7: Fish4trips ($395.25 in chips) 
Seat 8: WDW3 ($251.02 in chips) 
Seat 9: InsomniaRU ($200 in chips) 
matiko09: posts small blind $1
Fish4trips: posts big blind $2
*** HOLE CARDS ***
Dealt to matiko09 [7c Jd]
WDW3: folds 
InsomniaRU: folds 
libbyyww: folds 
peevoajax: folds 
maverick7614: raises $2 to $4
Sly-Hustler: folds 
ersevi6: folds 
matiko09: folds 
Fish4trips: folds 
Uncalled bet ($2) returned to maverick7614
maverick7614 collected $5 from pot
maverick7614: doesn't show hand 
*** SUMMARY ***
Total pot $5 | Rake $0 
Seat 1: libbyyww folded before Flop (didn't bet)
Seat 2: peevoajax folded before Flop (didn't bet)
Seat 3: maverick7614 collected ($5)
Seat 4: Sly-Hustler folded before Flop (didn't bet)
Seat 5: ersevi6 (button) folded before Flop (didn't bet)
Seat 6: matiko09 (small blind) folded before Flop
Seat 7: Fish4trips (big blind) folded before Flop
Seat 8: WDW3 folded before Flop (didn't bet)
Seat 9: InsomniaRU folded before Flop (didn't bet)





PokerStars Hand #152558950565:  Hold'em No Limit ($0.50/$1.00 USD) - 2016/04/28 14:54:37 CET [2016/04/28 8:54:37 ET]
Table 'Paris' 9-max Seat #9 is the button
Seat 1: matiko09 ($153.97 in chips) 
Seat 2: birdie1970 ($217.94 in chips) 
Seat 3: vrnMike ($160.21 in chips) 
Seat 4: koksskrt ($100 in chips) 
Seat 7: Westpants ($134.60 in chips) 
Seat 9: ruslik_by ($40 in chips) 
matiko09: posts small blind $0.50
birdie1970: posts big blind $1
I The King I: sits out 
*** HOLE CARDS ***
Dealt to matiko09 [2h 3c]
vrnMike: folds 
koksskrt: raises $2 to $3
peevoajax joins the table at seat #6 
peevoajax leaves the table
Westpants: folds 
ruslik_by: folds 
sanpidk joins the table at seat #6 
sanpidk leaves the table
matiko09: folds 
birdie1970: folds 
Uncalled bet ($2) returned to koksskrt
koksskrt collected $2.50 from pot
koksskrt: doesn't show hand 
*** SUMMARY ***
Total pot $2.50 | Rake $0 
Seat 1: matiko09 (small blind) folded before Flop
Seat 2: birdie1970 (big blind) folded before Flop
Seat 3: vrnMike folded before Flop (didn't bet)
Seat 4: koksskrt collected ($2.50)
Seat 7: Westpants folded before Flop (didn't bet)
Seat 9: ruslik_by (button) folded before Flop (didn't bet)





PokerStars Hand #152558953356:  Hold'em No Limit ($0.50/$1.00 USD) - 2016/04/28 14:54:42 CET [2016/04/28 8:54:42 ET]
Table 'Zachia II' 9-max Seat #3 is the button
Seat 1: greyman571 ($154.84 in chips) 
Seat 2: sanpidk ($151.13 in chips) 
Seat 3: matiko09 ($101.50 in chips) 
Seat 4: omorfadramou ($103.47 in chips) 
Seat 5: vrnMike ($112.50 in chips) 
Seat 6: maxxmeister ($102 in chips) 
Seat 7: ozone2003 ($100 in chips) 
Seat 9: I The King I ($100 in chips) 
omorfadramou: posts small blind $0.50
vrnMike: posts big blind $1
aseban11: sits out 
*** HOLE CARDS ***
Dealt to matiko09 [Ts 6c]
maxxmeister: raises $2 to $3
ozone2003: folds 
I The King I: folds 
greyman571: folds 
sanpidk: folds 
matiko09: folds 
omorfadramou: folds 
vrnMike: folds 
Uncalled bet ($2) returned to maxxmeister
maxxmeister collected $2.50 from pot
maxxmeister: doesn't show hand 
*** SUMMARY ***
Total pot $2.50 | Rake $0 
Seat 1: greyman571 folded before Flop (didn't bet)
Seat 2: sanpidk folded before Flop (didn't bet)
Seat 3: matiko09 (button) folded before Flop (didn't bet)
Seat 4: omorfadramou (small blind) folded before Flop
Seat 5: vrnMike (big blind) folded before Flop
Seat 6: maxxmeister collected ($2.50)
Seat 7: ozone2003 folded before Flop (didn't bet)
Seat 9: I The King I folded before Flop (didn't bet)





PokerStars Hand #152558955926:  Hold'em No Limit ($1/$2 USD) - 2016/04/28 14:54:47 CET [2016/04/28 8:54:47 ET]
Table 'Mireille' 9-max Seat #4 is the button
Seat 2: matiko09 ($200 in chips) 
Seat 3: MZ2502 ($437.09 in chips) 
Seat 4: Fish4trips ($222.23 in chips) 
Seat 5: SoNe1988 ($112.42 in chips) 
Seat 6: Yaaaazz ($218.45 in chips) 
Seat 8: KDJAll3 ($927.14 in chips) 
Seat 9: a-talash ($152.30 in chips) 
SoNe1988: posts small blind $1
Yaaaazz: posts big blind $2
aseban11: sits out 
I The King I: sits out 
*** HOLE CARDS ***
Dealt to matiko09 [4c Kd]
KDJAll3: folds 
a-talash: folds 
matiko09: folds 
MZ2502: raises $10 to $12
Fish4trips: folds 
SoNe1988: folds 
Yaaaazz: folds 
Uncalled bet ($10) returned to MZ2502
MZ2502 collected $5 from pot
MZ2502: doesn't show hand 
*** SUMMARY ***
Total pot $5 | Rake $0 
Seat 2: matiko09 folded before Flop (didn't bet)
Seat 3: MZ2502 collected ($5)
Seat 4: Fish4trips (button) folded before Flop (didn't bet)
Seat 5: SoNe1988 (small blind) folded before Flop
Seat 6: Yaaaazz (big blind) folded before Flop
Seat 8: KDJAll3 folded before Flop (didn't bet)
Seat 9: a-talash folded before Flop (didn't bet)





PokerStars Hand #152558956832:  Hold'em No Limit ($0.50/$1.00 USD) - 2016/04/28 14:54:48 CET [2016/04/28 8:54:48 ET]
Table 'Lyot' 9-max Seat #8 is the button
Seat 1: matiko09 ($108.01 in chips) 
Seat 2: vrnMike ($136.75 in chips) 
Seat 6: Monglaer ($123.47 in chips) 
Seat 7: PreMoze ($75.71 in chips) 
Seat 8: Patz B ($14.38 in chips) 
Seat 9: koksskrt ($103.16 in chips) 
koksskrt: posts small blind $0.50
matiko09: posts big blind $1
aseban11: sits out 
Yaaaazz: sits out 
di0d80: sits out 
matiko09: posts the ante $0.20
vrnMike: posts the ante $0.20
Monglaer: posts the ante $0.20
PreMoze: posts the ante $0.20
Patz B: posts the ante $0.20
koksskrt: posts the ante $0.20
*** HOLE CARDS ***
Dealt to matiko09 [3d 4c]
vrnMike: raises $1 to $2
Monglaer: folds 
PreMoze: folds 
Patz B: folds 
koksskrt: folds 
matiko09: folds 
Uncalled bet ($1) returned to vrnMike
vrnMike collected $3.70 from pot
*** SUMMARY ***
Total pot $3.70 | Rake $0 
Seat 1: matiko09 (big blind) folded before Flop
Seat 2: vrnMike collected ($3.70)
Seat 6: Monglaer folded before Flop (didn't bet)
Seat 7: PreMoze folded before Flop (didn't bet)
Seat 8: Patz B (button) folded before Flop (didn't bet)
Seat 9: koksskrt (small blind) folded before Flop





PokerStars Hand #152558956728:  Hold'em No Limit (€0.50/€1.00 EUR) - 2016/04/28 14:54:48 CET [2016/04/28 8:54:48 ET]
Table 'Clivia II' 9-max Seat #6 is the button
Seat 1: piperkova (€48.59 in chips) 
Seat 2: HasBigBiceps (€100 in chips) 
Seat 3: R1aki (€100 in chips) 
Seat 4: matiko09 (€100 in chips) 
Seat 6: ruslik_by (€67.05 in chips) 
Seat 7: St.LaCoste (€100 in chips) 
Seat 9: ozone2003 (€101.50 in chips) 
St.LaCoste: posts small blind €0.50
ozone2003: posts big blind €1
sanpidk: sits out 
*** HOLE CARDS ***
Dealt to matiko09 [8h 7c]
piperkova: folds 
HasBigBiceps: folds 
R1aki: folds 
matiko09: folds 
ruslik_by: raises €1 to €2
St.LaCoste: folds 
ozone2003: folds 
Uncalled bet (€1) returned to ruslik_by
ruslik_by collected €2.50 from pot
ruslik_by: doesn't show hand 
*** SUMMARY ***
Total pot €2.50 | Rake €0 
Seat 1: piperkova folded before Flop (didn't bet)
Seat 2: HasBigBiceps folded before Flop (didn't bet)
Seat 3: R1aki folded before Flop (didn't bet)
Seat 4: matiko09 folded before Flop (didn't bet)
Seat 6: ruslik_by (button) collected (€2.50)
Seat 7: St.LaCoste (small blind) folded before Flop
Seat 9: ozone2003 (big blind) folded before Flop





PokerStars Hand #152558962362:  Hold'em No Limit (€0.50/€1.00 EUR) - 2016/04/28 14:54:58 CET [2016/04/28 8:54:58 ET]
Table 'Lumiere II' 9-max Seat #7 is the button
Seat 1: vrnMike (€108.32 in chips) 
Seat 2: Racushniak (€100 in chips) 
Seat 3: ozone2003 (€103.23 in chips) 
Seat 4: ruslik_by (€63.20 in chips) 
Seat 5: Schmidy7 (€47.05 in chips) 
Seat 6: HasBigBiceps (€103 in chips) 
Seat 7: hammerwife (€114.68 in chips) 
Seat 9: matiko09 (€100 in chips) 
sanpidk will be allowed to play after the button
matiko09: posts small blind €0.50
vrnMike: posts big blind €1
*** HOLE CARDS ***
Dealt to matiko09 [4h Ah]
Racushniak: raises €2 to €3
ozone2003: folds 
ruslik_by: folds 
Schmidy7: folds 
HasBigBiceps: folds 
hammerwife: folds 
matiko09: folds 
vrnMike: folds 
Uncalled bet (€2) returned to Racushniak
Racushniak collected €2.50 from pot
Racushniak: doesn't show hand 
*** SUMMARY ***
Total pot €2.50 | Rake €0 
Seat 1: vrnMike (big blind) folded before Flop
Seat 2: Racushniak collected (€2.50)
Seat 3: ozone2003 folded before Flop (didn't bet)
Seat 4: ruslik_by folded before Flop (didn't bet)
Seat 5: Schmidy7 folded before Flop (didn't bet)
Seat 6: HasBigBiceps folded before Flop (didn't bet)
Seat 7: hammerwife (button) folded before Flop (didn't bet)
Seat 9: matiko09 (small blind) folded before Flop





PokerStars Hand #152558969883:  Hold'em No Limit ($1/$2 USD) - 2016/04/28 14:55:11 CET [2016/04/28 8:55:11 ET]
Table 'Libera II' 9-max Seat #6 is the button
Seat 1: libbyyww ($200 in chips) 
Seat 2: peevoajax ($200 in chips) 
Seat 3: maverick7614 ($200 in chips) 
Seat 4: Sly-Hustler ($87.80 in chips) 
Seat 5: ersevi6 ($138.30 in chips) 
Seat 6: matiko09 ($200 in chips) 
Seat 7: Fish4trips ($393.25 in chips) 
Seat 9: InsomniaRU ($200 in chips) 
Fish4trips: posts small blind $1
WDW3: is sitting out 
WDW3 leaves the table
InsomniaRU: posts big blind $2
*** HOLE CARDS ***
Dealt to matiko09 [5c 4h]
T0ny Adams joins the table at seat #8 
libbyyww: folds 
peevoajax: folds 
maverick7614: calls $2
Sly-Hustler: calls $2
ersevi6: raises $6 to $8
matiko09: folds 
Fish4trips: folds 
InsomniaRU: folds 
maverick7614: calls $6
Sly-Hustler: calls $6
*** FLOP *** [6d 2h 8s]
maverick7614: checks 
Sly-Hustler: bets $18
ersevi6: folds 
maverick7614: folds 
Uncalled bet ($18) returned to Sly-Hustler
Sly-Hustler collected $25.65 from pot
Sly-Hustler: doesn't show hand 
*** SUMMARY ***
Total pot $27 | Rake $1.35 
Board [6d 2h 8s]
Seat 1: libbyyww folded before Flop (didn't bet)
Seat 2: peevoajax folded before Flop (didn't bet)
Seat 3: maverick7614 folded on the Flop
Seat 4: Sly-Hustler collected ($25.65)
Seat 5: ersevi6 folded on the Flop
Seat 6: matiko09 (button) folded before Flop (didn't bet)
Seat 7: Fish4trips (small blind) folded before Flop
Seat 9: InsomniaRU (big blind) folded before Flop





PokerStars Hand #152558971092:  Hold'em No Limit ($0.50/$1.00 USD) - 2016/04/28 14:55:13 CET [2016/04/28 8:55:13 ET]
Table 'Paris' 9-max Seat #1 is the button
Seat 1: matiko09 ($153.47 in chips) 
Seat 2: birdie1970 ($216.94 in chips) 
Seat 3: vrnMike ($160.21 in chips) 
Seat 4: koksskrt ($101.50 in chips) 
Seat 7: Westpants ($134.60 in chips) 
Seat 8: Muric05 ($40.55 in chips) 
Seat 9: ruslik_by ($40 in chips) 
birdie1970: posts small blind $0.50
vrnMike: posts big blind $1
I The King I: sits out 
*** HOLE CARDS ***
Dealt to matiko09 [2h Qs]
koksskrt: folds 
Westpants: folds 
Muric05: folds 
ruslik_by: folds 
matiko09: folds 
birdie1970: calls $0.50
vrnMike: checks 
*** FLOP *** [Ah 9h 2s]
birdie1970: checks 
vrnMike: checks 
*** TURN *** [Ah 9h 2s] [9s]
birdie1970: checks 
vrnMike: checks 
*** RIVER *** [Ah 9h 2s 9s] [8c]
birdie1970: checks 
vrnMike: checks 
*** SHOW DOWN ***
birdie1970: shows [Ts Kd] (a pair of Nines)
vrnMike: mucks hand 
birdie1970 collected $1.90 from pot
*** SUMMARY ***
Total pot $2 | Rake $0.10 
Board [Ah 9h 2s 9s 8c]
Seat 1: matiko09 (button) folded before Flop (didn't bet)
Seat 2: birdie1970 (small blind) showed [Ts Kd] and won ($1.90) with a pair of Nines
Seat 3: vrnMike (big blind) mucked [4h Kc]
Seat 4: koksskrt folded before Flop (didn't bet)
Seat 7: Westpants folded before Flop (didn't bet)
Seat 8: Muric05 folded before Flop (didn't bet)
Seat 9: ruslik_by folded before Flop (didn't bet)





PokerStars Hand #152558971418:  Hold'em No Limit ($0.50/$1.00 USD) - 2016/04/28 14:55:14 CET [2016/04/28 8:55:14 ET]
Table 'Lyot' 9-max Seat #9 is the button
Seat 1: matiko09 ($106.81 in chips) 
Seat 2: vrnMike ($139.25 in chips) 
Seat 6: Monglaer ($123.27 in chips) 
Seat 7: PreMoze ($75.51 in chips) 
Seat 8: Patz B ($14.18 in chips) 
Seat 9: koksskrt ($102.46 in chips) 
matiko09: posts small blind $0.50
vrnMike: posts big blind $1
aseban11: sits out 
Yaaaazz: sits out 
di0d80: sits out 
matiko09: posts the ante $0.20
vrnMike: posts the ante $0.20
Monglaer: posts the ante $0.20
PreMoze: posts the ante $0.20
Patz B: posts the ante $0.20
koksskrt: posts the ante $0.20
*** HOLE CARDS ***
Dealt to matiko09 [5s 8c]
Monglaer: folds 
PreMoze: raises $1 to $2
Patz B: folds 
koksskrt: folds 
matiko09: folds 
vrnMike: calls $1
*** FLOP *** [Td 3d As]
vrnMike: checks 
PreMoze: checks 
*** TURN *** [Td 3d As] [3c]
vrnMike: bets $5
PreMoze: calls $5
*** RIVER *** [Td 3d As 3c] [4h]
vrnMike: bets $10
PreMoze: folds 
Uncalled bet ($10) returned to vrnMike
vrnMike collected $14.92 from pot
*** SUMMARY ***
Total pot $15.70 | Rake $0.78 
Board [Td 3d As 3c 4h]
Seat 1: matiko09 (small blind) folded before Flop
Seat 2: vrnMike (big blind) collected ($14.92)
Seat 6: Monglaer folded before Flop (didn't bet)
Seat 7: PreMoze folded on the River
Seat 8: Patz B folded before Flop (didn't bet)
Seat 9: koksskrt (button) folded before Flop (didn't bet)





PokerStars Hand #152558971369:  Hold'em No Limit ($0.50/$1.00 USD) - 2016/04/28 14:55:14 CET [2016/04/28 8:55:14 ET]
Table 'Zachia II' 9-max Seat #4 is the button
Seat 1: greyman571 ($154.84 in chips) 
Seat 2: sanpidk ($151.13 in chips) 
Seat 3: matiko09 ($101.50 in chips) 
Seat 4: omorfadramou ($102.97 in chips) 
Seat 5: vrnMike ($111.50 in chips) 
Seat 7: ozone2003 ($100 in chips) 
Seat 9: I The King I ($100 in chips) 
vrnMike: posts small blind $0.50
maxxmeister: is sitting out 
ozone2003: posts big blind $1
aseban11: sits out 
*** HOLE CARDS ***
Dealt to matiko09 [Ac 9h]
I The King I: folds 
greyman571: folds 
sanpidk: folds 
matiko09: raises $1.50 to $2.50
omorfadramou: folds 
vrnMike: folds 
ozone2003: calls $1.50
*** FLOP *** [8d 4s 7h]
ozone2003: checks 
matiko09: bets $3.39
ozone2003: raises $11.80 to $15.19
matiko09: folds 
Uncalled bet ($11.80) returned to ozone2003
ozone2003 collected $11.67 from pot
ozone2003: doesn't show hand 
*** SUMMARY ***
Total pot $12.28 | Rake $0.61 
Board [8d 4s 7h]
Seat 1: greyman571 folded before Flop (didn't bet)
Seat 2: sanpidk folded before Flop (didn't bet)
Seat 3: matiko09 folded on the Flop
Seat 4: omorfadramou (button) folded before Flop (didn't bet)
Seat 5: vrnMike (small blind) folded before Flop
Seat 7: ozone2003 (big blind) collected ($11.67)
Seat 9: I The King I folded before Flop (didn't bet)





PokerStars Hand #152558972012:  Hold'em No Limit ($0.50/$1.00 USD) - 2016/04/28 14:55:15 CET [2016/04/28 8:55:15 ET]
Table 'Bruwer' 9-max Seat #3 is the button
Seat 2: ruslik_by ($42.50 in chips) 
Seat 3: koksskrt ($107.61 in chips) 
Seat 4: matiko09 ($140.04 in chips) 
Seat 5: Carloszhang ($118.35 in chips) 
Seat 6: I The King I ($111.02 in chips) 
Seat 7: R1aki ($247.08 in chips) 
matiko09: posts small blind $0.50
Carloszhang: posts big blind $1
lumen21: sits out 
aseban11: sits out 
*** HOLE CARDS ***
Dealt to matiko09 [Kd 4d]
I The King I: folds 
R1aki: folds 
ruslik_by: raises $1.50 to $2.50
koksskrt: folds 
matiko09: folds 
Carloszhang: calls $1.50
*** FLOP *** [Ts As 9s]
Carloszhang: bets $3
ruslik_by: calls $3
*** TURN *** [Ts As 9s] [6s]
Carloszhang: bets $4
ruslik_by: folds 
Uncalled bet ($4) returned to Carloszhang
Carloszhang collected $10.92 from pot
*** SUMMARY ***
Total pot $11.50 | Rake $0.58 
Board [Ts As 9s 6s]
Seat 2: ruslik_by folded on the Turn
Seat 3: koksskrt (button) folded before Flop (didn't bet)
Seat 4: matiko09 (small blind) folded before Flop
Seat 5: Carloszhang (big blind) collected ($10.92)
Seat 6: I The King I folded before Flop (didn't bet)
Seat 7: R1aki folded before Flop (didn't bet)





PokerStars Hand #152559268064:  Hold'em No Limit ($0.50/$1.00 USD) - 2016/04/28 15:04:40 CET [2016/04/28 9:04:40 ET]
Table 'Zachia II' 9-max Seat #1 is the button
Seat 1: greyman571 ($152.12 in chips) 
Seat 2: sanpidk ($155.75 in chips) 
Seat 3: matiko09 ($100 in chips) 
Seat 4: omorfadramou ($101.47 in chips) 
Seat 5: vrnMike ($100 in chips) 
Seat 7: ozone2003 ($100 in chips) 
Seat 8: aseban11 ($138 in chips) 
Seat 9: Painkiller72 ($106.39 in chips) 
sanpidk: posts small blind $0.50
matiko09: posts big blind $1
koksskrt: sits out 
*** HOLE CARDS ***
Dealt to matiko09 [2c Td]
omorfadramou: folds 
vrnMike: folds 
ozone2003: folds 
aseban11: folds 
Painkiller72: folds 
greyman571: raises $2 to $3
sanpidk: calls $2.50
matiko09: folds 
*** FLOP *** [4d Jh Jc]
sanpidk: checks 
greyman571: bets $3
sanpidk: folds 
Uncalled bet ($3) returned to greyman571
greyman571 collected $6.65 from pot
greyman571: doesn't show hand 
*** SUMMARY ***
Total pot $7 | Rake $0.35 
Board [4d Jh Jc]
Seat 1: greyman571 (button) collected ($6.65)
Seat 2: sanpidk (small blind) folded on the Flop
Seat 3: matiko09 (big blind) folded before Flop
Seat 4: omorfadramou folded before Flop (didn't bet)
Seat 5: vrnMike folded before Flop (didn't bet)
Seat 7: ozone2003 folded before Flop (didn't bet)
Seat 8: aseban11 folded before Flop (didn't bet)
Seat 9: Painkiller72 folded before Flop (didn't bet)





PokerStars Hand #152559282939:  Hold'em No Limit (€0.50/€1.00 EUR) - 2016/04/28 15:05:05 CET [2016/04/28 9:05:05 ET]
Table 'Lumiere II' 9-max Seat #7 is the button
Seat 1: vrnMike (€131.22 in chips) 
Seat 4: ruslik_by (€67.20 in chips) 
Seat 5: Schmidy7 (€51.35 in chips) 
Seat 7: hammerwife (€115.68 in chips) 
Seat 8: sanpidk (€100 in chips) 
Seat 9: matiko09 (€100 in chips) 
sanpidk: posts small blind €0.50
matiko09: posts big blind €1
maxxmeister: sits out 
*** HOLE CARDS ***
Dealt to matiko09 [Kc 9d]
vrnMike: folds 
ruslik_by: raises €2 to €3
Schmidy7: folds 
hammerwife: raises €6 to €9
sanpidk: folds 
matiko09: folds 
ruslik_by: folds 
Uncalled bet (€6) returned to hammerwife
hammerwife collected €7.50 from pot
hammerwife: doesn't show hand 
*** SUMMARY ***
Total pot €7.50 | Rake €0 
Seat 1: vrnMike folded before Flop (didn't bet)
Seat 4: ruslik_by folded before Flop
Seat 5: Schmidy7 folded before Flop (didn't bet)
Seat 7: hammerwife (button) collected (€7.50)
Seat 8: sanpidk (small blind) folded before Flop
Seat 9: matiko09 (big blind) folded before Flop





PokerStars Hand #152559296803:  Hold'em No Limit ($0.50/$1.00 USD) - 2016/04/28 15:05:29 CET [2016/04/28 9:05:29 ET]
Table 'Zachia II' 9-max Seat #2 is the button
Seat 1: greyman571 ($155.77 in chips) 
Seat 2: sanpidk ($152.75 in chips) 
Seat 3: matiko09 ($100 in chips) 
Seat 4: omorfadramou ($101.47 in chips) 
Seat 5: vrnMike ($100 in chips) 
Seat 7: ozone2003 ($100 in chips) 
Seat 8: aseban11 ($138 in chips) 
Seat 9: Painkiller72 ($106.39 in chips) 
matiko09: posts small blind $0.50
omorfadramou: posts big blind $1
koksskrt: sits out 
*** HOLE CARDS ***
Dealt to matiko09 [Ts 9c]
vrnMike: folds 
ozone2003: folds 
aseban11: folds 
Painkiller72: folds 
greyman571: folds 
sanpidk: raises $1.24 to $2.24
matiko09: folds 
omorfadramou: raises $5.76 to $8
sanpidk: folds 
Uncalled bet ($5.76) returned to omorfadramou
omorfadramou collected $4.98 from pot
omorfadramou: doesn't show hand 
*** SUMMARY ***
Total pot $4.98 | Rake $0 
Seat 1: greyman571 folded before Flop (didn't bet)
Seat 2: sanpidk (button) folded before Flop
Seat 3: matiko09 (small blind) folded before Flop
Seat 4: omorfadramou (big blind) collected ($4.98)
Seat 5: vrnMike folded before Flop (didn't bet)
Seat 7: ozone2003 folded before Flop (didn't bet)
Seat 8: aseban11 folded before Flop (didn't bet)
Seat 9: Painkiller72 folded before Flop (didn't bet)





PokerStars Hand #152559314807:  Hold'em No Limit (€0.50/€1.00 EUR) - 2016/04/28 15:05:59 CET [2016/04/28 9:05:59 ET]
Table 'Lumiere II' 9-max Seat #8 is the button
Seat 1: vrnMike (€131.22 in chips) 
Seat 4: ruslik_by (€64.20 in chips) 
Seat 5: Schmidy7 (€51.35 in chips) 
Seat 7: hammerwife (€120.18 in chips) 
Seat 8: sanpidk (€100 in chips) 
Seat 9: matiko09 (€100 in chips) 
matiko09: posts small blind €0.50
vrnMike: posts big blind €1
maxxmeister: sits out 
*** HOLE CARDS ***
Dealt to matiko09 [6s 3c]
ruslik_by: folds 
Schmidy7: folds 
hammerwife: folds 
sanpidk: raises €1.24 to €2.24
matiko09: folds 
vrnMike: calls €1.24
*** FLOP *** [9s As Tc]
vrnMike: checks 
sanpidk: checks 
*** TURN *** [9s As Tc] [8c]
vrnMike: checks 
sanpidk: checks 
*** RIVER *** [9s As Tc 8c] [Qh]
vrnMike: bets €8
sanpidk: folds 
Uncalled bet (€8) returned to vrnMike
vrnMike collected €4.73 from pot
*** SUMMARY ***
Total pot €4.98 | Rake €0.25 
Board [9s As Tc 8c Qh]
Seat 1: vrnMike (big blind) collected (€4.73)
Seat 4: ruslik_by folded before Flop (didn't bet)
Seat 5: Schmidy7 folded before Flop (didn't bet)
Seat 7: hammerwife folded before Flop (didn't bet)
Seat 8: sanpidk (button) folded on the River
Seat 9: matiko09 (small blind) folded before Flop





PokerStars Hand #152559331417:  Hold'em No Limit ($0.50/$1.00 USD) - 2016/04/28 15:06:27 CET [2016/04/28 9:06:27 ET]
Table 'Zachia II' 9-max Seat #3 is the button
Seat 1: greyman571 ($155.77 in chips) 
Seat 2: sanpidk ($150.51 in chips) 
Seat 3: matiko09 ($100 in chips) 
Seat 4: omorfadramou ($104.21 in chips) 
Seat 5: vrnMike ($100 in chips) 
Seat 7: ozone2003 ($100 in chips) 
Seat 8: aseban11 ($138 in chips) 
Seat 9: Painkiller72 ($106.39 in chips) 
omorfadramou: posts small blind $0.50
vrnMike: posts big blind $1
koksskrt: sits out 
*** HOLE CARDS ***
Dealt to matiko09 [9c 3d]
ozone2003: folds 
aseban11: raises $2 to $3
Painkiller72: folds 
greyman571: calls $3
sanpidk: calls $3
matiko09: folds 
omorfadramou: folds 
vrnMike: calls $2
*** FLOP *** [9h 6d 5c]
vrnMike: checks 
aseban11: bets $8.91
greyman571: folds 
sanpidk: folds 
vrnMike: folds 
Uncalled bet ($8.91) returned to aseban11
aseban11 collected $11.88 from pot
aseban11: doesn't show hand 
*** SUMMARY ***
Total pot $12.50 | Rake $0.62 
Board [9h 6d 5c]
Seat 1: greyman571 folded on the Flop
Seat 2: sanpidk folded on the Flop
Seat 3: matiko09 (button) folded before Flop (didn't bet)
Seat 4: omorfadramou (small blind) folded before Flop
Seat 5: vrnMike (big blind) folded on the Flop
Seat 7: ozone2003 folded before Flop (didn't bet)
Seat 8: aseban11 collected ($11.88)
Seat 9: Painkiller72 folded before Flop (didn't bet)





PokerStars Hand #152559340388:  Hold'em No Limit ($0.50/$1.00 USD) - 2016/04/28 15:06:42 CET [2016/04/28 9:06:42 ET]
Table 'Lyot' 9-max Seat #8 is the button
Seat 1: matiko09 ($106.11 in chips) 
Seat 2: vrnMike ($152.91 in chips) 
Seat 3: aseban11 ($100 in chips) 
Seat 4: Yaaaazz ($100 in chips) 
Seat 5: di0d80 ($142.40 in chips) 
Seat 7: PreMoze ($26.97 in chips) 
Seat 8: Patz B ($39.32 in chips) 
Seat 9: koksskrt ($123.77 in chips) 
koksskrt: posts small blind $0.50
matiko09: posts big blind $1
guoweiAA: sits out 
matiko09: posts the ante $0.20
vrnMike: posts the ante $0.20
aseban11: posts the ante $0.20
Yaaaazz: posts the ante $0.20
di0d80: posts the ante $0.20
PreMoze: posts the ante $0.20
Patz B: posts the ante $0.20
koksskrt: posts the ante $0.20
*** HOLE CARDS ***
Dealt to matiko09 [5s 6h]
vrnMike: folds 
aseban11: raises $2 to $3
Yaaaazz: folds 
di0d80: folds 
PreMoze: calls $3
Patz B: folds 
koksskrt: folds 
matiko09: folds 
*** FLOP *** [Qd 4h Th]
aseban11: checks 
PreMoze: checks 
*** TURN *** [Qd 4h Th] [Js]
aseban11: checks 
PreMoze: bets $3
aseban11: folds 
Uncalled bet ($3) returned to PreMoze
PreMoze collected $8.64 from pot
*** SUMMARY ***
Total pot $9.10 | Rake $0.46 
Board [Qd 4h Th Js]
Seat 1: matiko09 (big blind) folded before Flop
Seat 2: vrnMike folded before Flop (didn't bet)
Seat 3: aseban11 folded on the Turn
Seat 4: Yaaaazz folded before Flop (didn't bet)
Seat 5: di0d80 folded before Flop (didn't bet)
Seat 7: PreMoze collected ($8.64)
Seat 8: Patz B (button) folded before Flop (didn't bet)
Seat 9: koksskrt (small blind) folded before Flop





PokerStars Hand #152559352240:  Hold'em No Limit (€0.50/€1.00 EUR) - 2016/04/28 15:07:02 CET [2016/04/28 9:07:02 ET]
Table 'Lumiere II' 9-max Seat #9 is the button
Seat 1: vrnMike (€133.71 in chips) 
Seat 3: maxxmeister (€100 in chips) 
Seat 4: ruslik_by (€64.20 in chips) 
Seat 5: Schmidy7 (€51.35 in chips) 
Seat 7: hammerwife (€120.18 in chips) 
Seat 8: sanpidk (€100 in chips) 
Seat 9: matiko09 (€100 in chips) 
vrnMike: posts small blind €0.50
maxxmeister: posts big blind €1
*** HOLE CARDS ***
Dealt to matiko09 [2h 5h]
ruslik_by: folds 
Schmidy7: folds 
hammerwife: folds 
sanpidk: folds 
matiko09: folds 
vrnMike: folds 
Uncalled bet (€0.50) returned to maxxmeister
maxxmeister collected €1 from pot
maxxmeister: doesn't show hand 
*** SUMMARY ***
Total pot €1 | Rake €0 
Seat 1: vrnMike (small blind) folded before Flop
Seat 3: maxxmeister (big blind) collected (€1)
Seat 4: ruslik_by folded before Flop (didn't bet)
Seat 5: Schmidy7 folded before Flop (didn't bet)
Seat 7: hammerwife folded before Flop (didn't bet)
Seat 8: sanpidk folded before Flop (didn't bet)
Seat 9: matiko09 (button) folded before Flop (didn't bet)





PokerStars Hand #152559360379:  Hold'em No Limit ($0.50/$1.00 USD) - 2016/04/28 15:07:16 CET [2016/04/28 9:07:16 ET]
Table 'Agapenor III' 9-max Seat #1 is the button
Seat 1: I The King I ($100 in chips) 
Seat 3: sanpidk ($139.28 in chips) 
Seat 4: matiko09 ($100 in chips) 
Seat 5: Painkiller72 ($113.67 in chips) 
Seat 6: azzad2007 ($104.10 in chips) 
Seat 7: tylerz71 ($124.48 in chips) 
Seat 8: Ceanucs ($55.50 in chips) 
Seat 9: DYO1000 ($35.48 in chips) 
sanpidk: posts small blind $0.50
matiko09: posts big blind $1
*** HOLE CARDS ***
Dealt to matiko09 [Qs Qc]
Painkiller72: folds 
azzad2007: folds 
tylerz71: raises $1 to $2
Ceanucs: folds 
DYO1000: folds 
I The King I: folds 
sanpidk: folds 
matiko09: raises $6 to $8
tylerz71: folds 
Uncalled bet ($6) returned to matiko09
matiko09 collected $4.50 from pot
matiko09: doesn't show hand 
*** SUMMARY ***
Total pot $4.50 | Rake $0 
Seat 1: I The King I (button) folded before Flop (didn't bet)
Seat 3: sanpidk (small blind) folded before Flop
Seat 4: matiko09 (big blind) collected ($4.50)
Seat 5: Painkiller72 folded before Flop (didn't bet)
Seat 6: azzad2007 folded before Flop (didn't bet)
Seat 7: tylerz71 folded before Flop
Seat 8: Ceanucs folded before Flop (didn't bet)
Seat 9: DYO1000 folded before Flop (didn't bet)





PokerStars Hand #152559366185:  Hold'em No Limit ($0.50/$1.00 USD) - 2016/04/28 15:07:26 CET [2016/04/28 9:07:26 ET]
Table 'Zachia II' 9-max Seat #4 is the button
Seat 1: greyman571 ($152.77 in chips) 
Seat 2: sanpidk ($147.51 in chips) 
Seat 3: matiko09 ($100 in chips) 
Seat 4: omorfadramou ($103.71 in chips) 
Seat 5: vrnMike ($100 in chips) 
Seat 6: koksskrt ($100 in chips) 
Seat 7: ozone2003 ($100 in chips) 
Seat 8: aseban11 ($146.88 in chips) 
Seat 9: Painkiller72 ($106.39 in chips) 
vrnMike: posts small blind $0.50
koksskrt: posts big blind $1
*** HOLE CARDS ***
Dealt to matiko09 [2c Ks]
ozone2003: folds 
aseban11: folds 
Painkiller72: folds 
greyman571: folds 
sanpidk: folds 
matiko09: folds 
omorfadramou: raises $1.16 to $2.16
vrnMike: folds 
koksskrt: folds 
Uncalled bet ($1.16) returned to omorfadramou
omorfadramou collected $2.50 from pot
omorfadramou: doesn't show hand 
*** SUMMARY ***
Total pot $2.50 | Rake $0 
Seat 1: greyman571 folded before Flop (didn't bet)
Seat 2: sanpidk folded before Flop (didn't bet)
Seat 3: matiko09 folded before Flop (didn't bet)
Seat 4: omorfadramou (button) collected ($2.50)
Seat 5: vrnMike (small blind) folded before Flop
Seat 6: koksskrt (big blind) folded before Flop
Seat 7: ozone2003 folded before Flop (didn't bet)
Seat 8: aseban11 folded before Flop (didn't bet)
Seat 9: Painkiller72 folded before Flop (didn't bet)





PokerStars Hand #152559367301:  Hold'em No Limit ($0.50/$1.00 USD) - 2016/04/28 15:07:27 CET [2016/04/28 9:07:27 ET]
Table 'Lyot' 9-max Seat #9 is the button
Seat 1: matiko09 ($104.91 in chips) 
Seat 2: vrnMike ($152.71 in chips) 
Seat 3: aseban11 ($100 in chips) 
Seat 4: Yaaaazz ($100 in chips) 
Seat 5: di0d80 ($142.20 in chips) 
Seat 7: PreMoze ($32.41 in chips) 
Seat 8: Patz B ($39.12 in chips) 
Seat 9: koksskrt ($123.07 in chips) 
matiko09: posts small blind $0.50
vrnMike: posts big blind $1
guoweiAA: sits out 
matiko09: posts the ante $0.20
vrnMike: posts the ante $0.20
aseban11: posts the ante $0.20
Yaaaazz: posts the ante $0.20
di0d80: posts the ante $0.20
PreMoze: posts the ante $0.20
Patz B: posts the ante $0.20
koksskrt: posts the ante $0.20
*** HOLE CARDS ***
Dealt to matiko09 [4h 3s]
aseban11: folds 
Yaaaazz: folds 
di0d80: folds 
PreMoze: calls $1
Patz B: folds 
koksskrt: raises $2.50 to $3.50
matiko09: folds 
vrnMike: folds 
PreMoze: calls $2.50
*** FLOP *** [9c 4d 4c]
PreMoze: checks 
koksskrt: checks 
*** TURN *** [9c 4d 4c] [6d]
PreMoze: checks 
koksskrt: bets $4.99
PreMoze: folds 
Uncalled bet ($4.99) returned to koksskrt
koksskrt collected $9.60 from pot
koksskrt: doesn't show hand 
*** SUMMARY ***
Total pot $10.10 | Rake $0.50 
Board [9c 4d 4c 6d]
Seat 1: matiko09 (small blind) folded before Flop
Seat 2: vrnMike (big blind) folded before Flop
Seat 3: aseban11 folded before Flop (didn't bet)
Seat 4: Yaaaazz folded before Flop (didn't bet)
Seat 5: di0d80 folded before Flop (didn't bet)
Seat 7: PreMoze folded on the Turn
Seat 8: Patz B folded before Flop (didn't bet)
Seat 9: koksskrt (button) collected ($9.60)





PokerStars Hand #152559374377:  Hold'em No Limit (€0.50/€1.00 EUR) - 2016/04/28 15:07:39 CET [2016/04/28 9:07:39 ET]
Table 'Lumiere II' 9-max Seat #1 is the button
Seat 1: vrnMike (€133.21 in chips) 
Seat 3: maxxmeister (€100.50 in chips) 
Seat 4: ruslik_by (€64.20 in chips) 
Seat 5: Schmidy7 (€51.35 in chips) 
Seat 7: hammerwife (€120.18 in chips) 
Seat 8: sanpidk (€100 in chips) 
Seat 9: matiko09 (€100 in chips) 
maxxmeister: posts small blind €0.50
ruslik_by: posts big blind €1
HasBigBiceps: sits out 
*** HOLE CARDS ***
Dealt to matiko09 [2s Qs]
Schmidy7: folds 
hammerwife: folds 
sanpidk: folds 
matiko09: folds 
vrnMike: folds 
maxxmeister: folds 
Uncalled bet (€0.50) returned to ruslik_by
ruslik_by collected €1 from pot
ruslik_by: doesn't show hand 
*** SUMMARY ***
Total pot €1 | Rake €0 
Seat 1: vrnMike (button) folded before Flop (didn't bet)
Seat 3: maxxmeister (small blind) folded before Flop
Seat 4: ruslik_by (big blind) collected (€1)
Seat 5: Schmidy7 folded before Flop (didn't bet)
Seat 7: hammerwife folded before Flop (didn't bet)
Seat 8: sanpidk folded before Flop (didn't bet)
Seat 9: matiko09 folded before Flop (didn't bet)





PokerStars Hand #152559379667:  Hold'em No Limit ($0.50/$1.00 USD) - 2016/04/28 15:07:48 CET [2016/04/28 9:07:48 ET]
Table 'Agapenor III' 9-max Seat #3 is the button
Seat 1: I The King I ($100 in chips) 
Seat 3: sanpidk ($138.78 in chips) 
Seat 4: matiko09 ($102.50 in chips) 
Seat 5: Painkiller72 ($113.67 in chips) 
Seat 6: azzad2007 ($104.10 in chips) 
Seat 7: tylerz71 ($122.48 in chips) 
Seat 8: Ceanucs ($55.50 in chips) 
Seat 9: DYO1000 ($35.48 in chips) 
matiko09: posts small blind $0.50
Painkiller72: posts big blind $1
*** HOLE CARDS ***
Dealt to matiko09 [8s Td]
azzad2007: folds 
tylerz71: folds 
Ceanucs: calls $1
DYO1000: folds 
I The King I: folds 
sanpidk: folds 
matiko09: folds 
Painkiller72: checks 
*** FLOP *** [Th 3s As]
Painkiller72: checks 
Ceanucs: checks 
*** TURN *** [Th 3s As] [Ks]
Painkiller72: checks 
Ceanucs: bets $1
Painkiller72: folds 
Uncalled bet ($1) returned to Ceanucs
Ceanucs collected $2.38 from pot
*** SUMMARY ***
Total pot $2.50 | Rake $0.12 
Board [Th 3s As Ks]
Seat 1: I The King I folded before Flop (didn't bet)
Seat 3: sanpidk (button) folded before Flop (didn't bet)
Seat 4: matiko09 (small blind) folded before Flop
Seat 5: Painkiller72 (big blind) folded on the Turn
Seat 6: azzad2007 folded before Flop (didn't bet)
Seat 7: tylerz71 folded before Flop (didn't bet)
Seat 8: Ceanucs collected ($2.38)
Seat 9: DYO1000 folded before Flop (didn't bet)





PokerStars Hand #152559382685:  Hold'em No Limit (€0.50/€1.00 EUR) - 2016/04/28 15:07:53 CET [2016/04/28 9:07:53 ET]
Table 'Lumiere II' 9-max Seat #3 is the button
Seat 1: vrnMike (€133.21 in chips) 
Seat 3: maxxmeister (€100 in chips) 
Seat 4: ruslik_by (€64.70 in chips) 
Seat 5: Schmidy7 (€51.35 in chips) 
Seat 7: hammerwife (€120.18 in chips) 
Seat 8: sanpidk (€100 in chips) 
Seat 9: matiko09 (€100 in chips) 
ruslik_by: posts small blind €0.50
Schmidy7: posts big blind €1
HasBigBiceps: sits out 
*** HOLE CARDS ***
Dealt to matiko09 [3d Qd]
HasBigBiceps leaves the table
hammerwife: folds 
sanpidk: folds 
matiko09: folds 
vrnMike: folds 
maxxmeister: folds 
ruslik_by: folds 
Uncalled bet (€0.50) returned to Schmidy7
Schmidy7 collected €1 from pot
azzad2007 joins the table at seat #6 
*** SUMMARY ***
Total pot €1 | Rake €0 
Seat 1: vrnMike folded before Flop (didn't bet)
Seat 3: maxxmeister (button) folded before Flop (didn't bet)
Seat 4: ruslik_by (small blind) folded before Flop
Seat 5: Schmidy7 (big blind) collected (€1)
Seat 7: hammerwife folded before Flop (didn't bet)
Seat 8: sanpidk folded before Flop (didn't bet)
Seat 9: matiko09 folded before Flop (didn't bet)





PokerStars Hand #152559390032:  Hold'em No Limit ($1/$2 USD) - 2016/04/28 15:08:05 CET [2016/04/28 9:08:05 ET]
Table 'Hakone II' 9-max Seat #9 is the button
Seat 1: Iggso ($200 in chips) 
Seat 2: matiko09 ($200 in chips) 
Seat 9: sofiya4 ($83.80 in chips) 
Iggso: posts small blind $1
matiko09: posts big blind $2
T0ny Adams: sits out 
aseban11: sits out 
ersevi6: sits out 
*** HOLE CARDS ***
Dealt to matiko09 [8c 7d]
wiseyoyo joins the table at seat #7 
sofiya4: calls $2
Iggso: folds 
matiko09: checks 
*** FLOP *** [Kh 7h 7c]
matiko09: checks 
sofiya4: bets $4.75
matiko09: raises $9.25 to $14
sofiya4: calls $9.25
*** TURN *** [Kh 7h 7c] [8h]
Todox2pesos joins the table at seat #8 
matiko09: bets $18
sofiya4: calls $18
*** RIVER *** [Kh 7h 7c 8h] [Ks]
matiko09: checks 
sofiya4: bets $33.87
matiko09: folds 
Uncalled bet ($33.87) returned to sofiya4
sofiya4 collected $67.75 from pot
sofiya4: doesn't show hand 
*** SUMMARY ***
Total pot $69 | Rake $1.25 
Board [Kh 7h 7c 8h Ks]
Seat 1: Iggso (small blind) folded before Flop
Seat 2: matiko09 (big blind) folded on the River
Seat 9: sofiya4 (button) collected ($67.75)





PokerStars Hand #152559397903:  Hold'em No Limit ($0.50/$1.00 USD) - 2016/04/28 15:08:19 CET [2016/04/28 9:08:19 ET]
Table 'Zachia II' 9-max Seat #5 is the button
Seat 1: greyman571 ($152.77 in chips) 
Seat 2: sanpidk ($147.51 in chips) 
Seat 3: matiko09 ($100 in chips) 
Seat 4: omorfadramou ($105.21 in chips) 
Seat 5: vrnMike ($100 in chips) 
Seat 6: koksskrt ($100 in chips) 
Seat 7: ozone2003 ($100 in chips) 
Seat 8: aseban11 ($146.88 in chips) 
Seat 9: Painkiller72 ($106.39 in chips) 
koksskrt: posts small blind $0.50
ozone2003: posts big blind $1
*** HOLE CARDS ***
Dealt to matiko09 [Qs 3s]
aseban11: folds 
Painkiller72: folds 
greyman571: folds 
sanpidk: folds 
matiko09: folds 
omorfadramou: folds 
vrnMike: raises $1 to $2
koksskrt: folds 
ozone2003: folds 
Uncalled bet ($1) returned to vrnMike
vrnMike collected $2.50 from pot
*** SUMMARY ***
Total pot $2.50 | Rake $0 
Seat 1: greyman571 folded before Flop (didn't bet)
Seat 2: sanpidk folded before Flop (didn't bet)
Seat 3: matiko09 folded before Flop (didn't bet)
Seat 4: omorfadramou folded before Flop (didn't bet)
Seat 5: vrnMike (button) collected ($2.50)
Seat 6: koksskrt (small blind) folded before Flop
Seat 7: ozone2003 (big blind) folded before Flop
Seat 8: aseban11 folded before Flop (didn't bet)
Seat 9: Painkiller72 folded before Flop (didn't bet)





PokerStars Hand #152559405736:  Hold'em No Limit (€0.50/€1.00 EUR) - 2016/04/28 15:08:32 CET [2016/04/28 9:08:32 ET]
Table 'Lumiere II' 9-max Seat #4 is the button
Seat 1: vrnMike (€133.21 in chips) 
Seat 3: maxxmeister (€100 in chips) 
Seat 4: ruslik_by (€64.20 in chips) 
Seat 5: Schmidy7 (€51.85 in chips) 
Seat 6: azzad2007 (€80.09 in chips) 
Seat 7: hammerwife (€120.18 in chips) 
Seat 8: sanpidk (€100 in chips) 
Seat 9: matiko09 (€100 in chips) 
Schmidy7: posts small blind €0.50
azzad2007: posts big blind €1
Racushniak: sits out 
*** HOLE CARDS ***
Dealt to matiko09 [Qd 5h]
hammerwife: folds 
sanpidk: folds 
matiko09: folds 
vrnMike: folds 
maxxmeister: raises €2.50 to €3.50
ruslik_by: folds 
Schmidy7: raises €3.50 to €7
azzad2007: folds 
maxxmeister: calls €3.50
*** FLOP *** [3h 7d 8d]
Schmidy7: bets €14.25
maxxmeister: folds 
Uncalled bet (€14.25) returned to Schmidy7
Schmidy7 collected €14.25 from pot
*** SUMMARY ***
Total pot €15 | Rake €0.75 
Board [3h 7d 8d]
Seat 1: vrnMike folded before Flop (didn't bet)
Seat 3: maxxmeister folded on the Flop
Seat 4: ruslik_by (button) folded before Flop (didn't bet)
Seat 5: Schmidy7 (small blind) collected (€14.25)
Seat 6: azzad2007 (big blind) folded before Flop
Seat 7: hammerwife folded before Flop (didn't bet)
Seat 8: sanpidk folded before Flop (didn't bet)
Seat 9: matiko09 folded before Flop (didn't bet)





PokerStars Hand #152559413522:  Hold'em No Limit ($0.50/$1.00 USD) - 2016/04/28 15:08:45 CET [2016/04/28 9:08:45 ET]
Table 'Agapenor III' 9-max Seat #4 is the button
Seat 1: I The King I ($100 in chips) 
Seat 3: sanpidk ($138.78 in chips) 
Seat 4: matiko09 ($102 in chips) 
Seat 5: Painkiller72 ($112.67 in chips) 
Seat 6: azzad2007 ($104.10 in chips) 
Seat 7: tylerz71 ($122.48 in chips) 
Seat 8: Ceanucs ($56.88 in chips) 
Seat 9: DYO1000 ($35.48 in chips) 
Painkiller72: posts small blind $0.50
azzad2007: posts big blind $1
*** HOLE CARDS ***
Dealt to matiko09 [4c 5s]
tylerz71: folds 
Ceanucs: calls $1
DYO1000: folds 
I The King I: folds 
sanpidk: folds 
matiko09: folds 
Painkiller72: folds 
azzad2007: checks 
*** FLOP *** [4s 9h 2c]
azzad2007: checks 
Ceanucs: checks 
*** TURN *** [4s 9h 2c] [9d]
azzad2007: bets $1
Ceanucs: calls $1
*** RIVER *** [4s 9h 2c 9d] [Js]
azzad2007: checks 
Ceanucs: bets $1
azzad2007: folds 
Uncalled bet ($1) returned to Ceanucs
Ceanucs collected $4.28 from pot
*** SUMMARY ***
Total pot $4.50 | Rake $0.22 
Board [4s 9h 2c 9d Js]
Seat 1: I The King I folded before Flop (didn't bet)
Seat 3: sanpidk folded before Flop (didn't bet)
Seat 4: matiko09 (button) folded before Flop (didn't bet)
Seat 5: Painkiller72 (small blind) folded before Flop
Seat 6: azzad2007 (big blind) folded on the River
Seat 7: tylerz71 folded before Flop (didn't bet)
Seat 8: Ceanucs collected ($4.28)
Seat 9: DYO1000 folded before Flop (didn't bet)





PokerStars Hand #152559427036:  Hold'em No Limit ($0.50/$1.00 USD) - 2016/04/28 15:09:08 CET [2016/04/28 9:09:08 ET]
Table 'Zachia II' 9-max Seat #6 is the button
Seat 1: greyman571 ($152.77 in chips) 
Seat 2: sanpidk ($147.51 in chips) 
Seat 3: matiko09 ($100 in chips) 
Seat 4: omorfadramou ($105.21 in chips) 
Seat 5: vrnMike ($101.50 in chips) 
Seat 6: koksskrt ($100 in chips) 
Seat 7: ozone2003 ($100 in chips) 
Seat 8: aseban11 ($146.88 in chips) 
Seat 9: Painkiller72 ($106.39 in chips) 
ozone2003: posts small blind $0.50
aseban11: posts big blind $1
*** HOLE CARDS ***
Dealt to matiko09 [Jd Ac]
Painkiller72: folds 
greyman571: raises $2 to $3
sanpidk: folds 
matiko09: raises $6 to $9
omorfadramou: folds 
vrnMike: folds 
koksskrt: folds 
ozone2003: folds 
aseban11: folds 
greyman571: calls $6
*** FLOP *** [Js 9d 5h]
greyman571: checks 
matiko09: bets $12
greyman571: calls $12
*** TURN *** [Js 9d 5h] [4s]
greyman571: checks 
matiko09: bets $25
greyman571: folds 
Uncalled bet ($25) returned to matiko09
matiko09 collected $41.32 from pot
matiko09: doesn't show hand 
*** SUMMARY ***
Total pot $43.50 | Rake $2.18 
Board [Js 9d 5h 4s]
Seat 1: greyman571 folded on the Turn
Seat 2: sanpidk folded before Flop (didn't bet)
Seat 3: matiko09 collected ($41.32)
Seat 4: omorfadramou folded before Flop (didn't bet)
Seat 5: vrnMike folded before Flop (didn't bet)
Seat 6: koksskrt (button) folded before Flop (didn't bet)
Seat 7: ozone2003 (small blind) folded before Flop
Seat 8: aseban11 (big blind) folded before Flop
Seat 9: Painkiller72 folded before Flop (didn't bet)





PokerStars Hand #152559432718:  Hold'em No Limit ($0.50/$1.00 USD) - 2016/04/28 15:09:15 CET [2016/04/28 9:09:15 ET]
Table 'Lyot' 9-max Seat #1 is the button
Seat 1: matiko09 ($104.21 in chips) 
Seat 2: vrnMike ($151.51 in chips) 
Seat 3: aseban11 ($100 in chips) 
Seat 4: Yaaaazz ($100 in chips) 
Seat 5: di0d80 ($142 in chips) 
Seat 7: PreMoze ($28.71 in chips) 
Seat 8: Patz B ($38.92 in chips) 
Seat 9: koksskrt ($128.97 in chips) 
vrnMike: posts small blind $0.50
aseban11: posts big blind $1
guoweiAA: sits out 
matiko09: posts the ante $0.20
vrnMike: posts the ante $0.20
aseban11: posts the ante $0.20
Yaaaazz: posts the ante $0.20
di0d80: posts the ante $0.20
PreMoze: posts the ante $0.20
Patz B: posts the ante $0.20
koksskrt: posts the ante $0.20
*** HOLE CARDS ***
Dealt to matiko09 [Ts 2h]
Yaaaazz: folds 
di0d80: folds 
PreMoze: raises $1 to $2
Patz B: folds 
koksskrt: folds 
matiko09: folds 
vrnMike: folds 
aseban11: folds 
Uncalled bet ($1) returned to PreMoze
PreMoze collected $4.10 from pot
*** SUMMARY ***
Total pot $4.10 | Rake $0 
Seat 1: matiko09 (button) folded before Flop (didn't bet)
Seat 2: vrnMike (small blind) folded before Flop
Seat 3: aseban11 (big blind) folded before Flop
Seat 4: Yaaaazz folded before Flop (didn't bet)
Seat 5: di0d80 folded before Flop (didn't bet)
Seat 7: PreMoze collected ($4.10)
Seat 8: Patz B folded before Flop (didn't bet)
Seat 9: koksskrt folded before Flop (didn't bet)





PokerStars Hand #152559436366:  Hold'em No Limit ($0.50/$1.00 USD) - 2016/04/28 15:09:21 CET [2016/04/28 9:09:21 ET]
Table 'Agapenor III' 9-max Seat #5 is the button
Seat 1: I The King I ($100 in chips) 
Seat 3: sanpidk ($138.78 in chips) 
Seat 4: matiko09 ($102 in chips) 
Seat 5: Painkiller72 ($112.17 in chips) 
Seat 6: azzad2007 ($102.10 in chips) 
Seat 7: tylerz71 ($122.48 in chips) 
Seat 8: Ceanucs ($59.16 in chips) 
Seat 9: DYO1000 ($35.48 in chips) 
azzad2007: posts small blind $0.50
tylerz71: posts big blind $1
*** HOLE CARDS ***
Dealt to matiko09 [8c 8d]
Ceanucs: calls $1
DYO1000: folds 
I The King I: raises $3 to $4
sanpidk: folds 
matiko09: calls $4
Painkiller72: folds 
azzad2007: folds 
tylerz71: folds 
Ceanucs: calls $3
*** FLOP *** [Js Qd Ks]
Ceanucs: checks 
I The King I: bets $9
matiko09: folds 
Ceanucs: folds 
Uncalled bet ($9) returned to I The King I
I The King I collected $12.82 from pot
I The King I: doesn't show hand 
*** SUMMARY ***
Total pot $13.50 | Rake $0.68 
Board [Js Qd Ks]
Seat 1: I The King I collected ($12.82)
Seat 3: sanpidk folded before Flop (didn't bet)
Seat 4: matiko09 folded on the Flop
Seat 5: Painkiller72 (button) folded before Flop (didn't bet)
Seat 6: azzad2007 (small blind) folded before Flop
Seat 7: tylerz71 (big blind) folded before Flop
Seat 8: Ceanucs folded on the Flop
Seat 9: DYO1000 folded before Flop (didn't bet)





PokerStars Hand #152559440677:  Hold'em No Limit ($1/$2 USD) - 2016/04/28 15:09:28 CET [2016/04/28 9:09:28 ET]
Table 'Hakone II' 9-max Seat #1 is the button
Seat 1: Iggso ($200 in chips) 
Seat 2: matiko09 ($200 in chips) 
Seat 3: T0ny Adams ($80 in chips) 
Seat 9: sofiya4 ($117.55 in chips) 
matiko09: posts small blind $1
T0ny Adams: posts big blind $2
aseban11: sits out 
ersevi6: sits out 
wiseyoyo: sits out 
Todox2pesos: sits out 
*** HOLE CARDS ***
Dealt to matiko09 [5h 9c]
sofiya4: folds 
Iggso: folds 
matiko09: folds 
Uncalled bet ($1) returned to T0ny Adams
T0ny Adams collected $2 from pot
T0ny Adams: doesn't show hand 
*** SUMMARY ***
Total pot $2 | Rake $0 
Seat 1: Iggso (button) folded before Flop (didn't bet)
Seat 2: matiko09 (small blind) folded before Flop
Seat 3: T0ny Adams (big blind) collected ($2)
Seat 9: sofiya4 folded before Flop (didn't bet)





PokerStars Hand #152559443047:  Hold'em No Limit (€0.50/€1.00 EUR) - 2016/04/28 15:09:32 CET [2016/04/28 9:09:32 ET]
Table 'Lumiere II' 9-max Seat #5 is the button
Seat 1: vrnMike (€133.21 in chips) 
Seat 3: maxxmeister (€100 in chips) 
Seat 4: ruslik_by (€64.20 in chips) 
Seat 5: Schmidy7 (€59.10 in chips) 
Seat 6: azzad2007 (€79.09 in chips) 
Seat 7: hammerwife (€120.18 in chips) 
Seat 8: sanpidk (€100 in chips) 
Seat 9: matiko09 (€100 in chips) 
azzad2007: posts small blind €0.50
hammerwife: posts big blind €1
Racushniak: sits out 
*** HOLE CARDS ***
Dealt to matiko09 [3h 4d]
sanpidk: folds 
matiko09: folds 
vrnMike: folds 
maxxmeister: folds 
ruslik_by: raises €1.50 to €2.50
Schmidy7: calls €2.50
azzad2007: folds 
hammerwife: calls €1.50
*** FLOP *** [3c 7c 7d]
hammerwife: checks 
ruslik_by: checks 
Schmidy7: checks 
*** TURN *** [3c 7c 7d] [Kd]
hammerwife: checks 
ruslik_by: checks 
Schmidy7: bets €3.80
hammerwife: folds 
ruslik_by: folds 
Uncalled bet (€3.80) returned to Schmidy7
Schmidy7 collected €7.60 from pot
*** SUMMARY ***
Total pot €8 | Rake €0.40 
Board [3c 7c 7d Kd]
Seat 1: vrnMike folded before Flop (didn't bet)
Seat 3: maxxmeister folded before Flop (didn't bet)
Seat 4: ruslik_by folded on the Turn
Seat 5: Schmidy7 (button) collected (€7.60)
Seat 6: azzad2007 (small blind) folded before Flop
Seat 7: hammerwife (big blind) folded on the Turn
Seat 8: sanpidk folded before Flop (didn't bet)
Seat 9: matiko09 folded before Flop (didn't bet)





PokerStars Hand #152559447091:  Hold'em No Limit ($1/$2 USD) - 2016/04/28 15:09:39 CET [2016/04/28 9:09:39 ET]
Table 'Hakone II' 9-max Seat #2 is the button
Seat 1: Iggso ($200 in chips) 
Seat 2: matiko09 ($200 in chips) 
Seat 3: T0ny Adams ($81 in chips) 
Seat 4: aseban11 ($200 in chips) 
Seat 9: sofiya4 ($117.55 in chips) 
T0ny Adams: posts small blind $1
aseban11: posts big blind $2
ersevi6: sits out 
wiseyoyo: sits out 
Todox2pesos: sits out 
*** HOLE CARDS ***
Dealt to matiko09 [6c 3c]
sofiya4: folds 
Iggso: folds 
matiko09: folds 
T0ny Adams: raises $2.64 to $4.64
aseban11: folds 
Uncalled bet ($2.64) returned to T0ny Adams
T0ny Adams collected $4 from pot
T0ny Adams: doesn't show hand 
*** SUMMARY ***
Total pot $4 | Rake $0 
Seat 1: Iggso folded before Flop (didn't bet)
Seat 2: matiko09 (button) folded before Flop (didn't bet)
Seat 3: T0ny Adams (small blind) collected ($4)
Seat 4: aseban11 (big blind) folded before Flop
Seat 9: sofiya4 folded before Flop (didn't bet)





PokerStars Hand #152559450153:  Hold'em No Limit ($0.50/$1.00 USD) - 2016/04/28 15:09:44 CET [2016/04/28 9:09:44 ET]
Table 'Lyot' 9-max Seat #2 is the button
Seat 1: matiko09 ($104.01 in chips) 
Seat 2: vrnMike ($150.81 in chips) 
Seat 3: aseban11 ($100 in chips) 
Seat 4: Yaaaazz ($100 in chips) 
Seat 5: di0d80 ($141.80 in chips) 
Seat 7: PreMoze ($31.61 in chips) 
Seat 8: Patz B ($38.72 in chips) 
Seat 9: koksskrt ($128.77 in chips) 
aseban11: posts small blind $0.50
Yaaaazz: posts big blind $1
guoweiAA: sits out 
matiko09: posts the ante $0.20
vrnMike: posts the ante $0.20
aseban11: posts the ante $0.20
Yaaaazz: posts the ante $0.20
di0d80: posts the ante $0.20
PreMoze: posts the ante $0.20
Patz B: posts the ante $0.20
koksskrt: posts the ante $0.20
*** HOLE CARDS ***
Dealt to matiko09 [2d Kc]
di0d80: folds 
PreMoze: folds 
PreMoze leaves the table
Patz B: folds 
koksskrt: folds 
matiko09: folds 
vrnMike: folds 
aseban11: raises $2.50 to $3.50
Yaaaazz: folds 
Uncalled bet ($2.50) returned to aseban11
aseban11 collected $3.60 from pot
aseban11: doesn't show hand 
*** SUMMARY ***
Total pot $3.60 | Rake $0 
Seat 1: matiko09 folded before Flop (didn't bet)
Seat 2: vrnMike (button) folded before Flop (didn't bet)
Seat 3: aseban11 (small blind) collected ($3.60)
Seat 4: Yaaaazz (big blind) folded before Flop
Seat 5: di0d80 folded before Flop (didn't bet)
Seat 7: PreMoze folded before Flop (didn't bet)
Seat 8: Patz B folded before Flop (didn't bet)
Seat 9: koksskrt folded before Flop (didn't bet)





PokerStars Hand #152559464269:  Hold'em No Limit ($0.50/$1.00 USD) - 2016/04/28 15:10:08 CET [2016/04/28 9:10:08 ET]
Table 'Agapenor III' 9-max Seat #6 is the button
Seat 1: I The King I ($108.82 in chips) 
Seat 3: sanpidk ($138.78 in chips) 
Seat 4: matiko09 ($100 in chips) 
Seat 5: Painkiller72 ($112.17 in chips) 
Seat 6: azzad2007 ($101.60 in chips) 
Seat 7: tylerz71 ($121.48 in chips) 
Seat 8: Ceanucs ($55.16 in chips) 
Seat 9: DYO1000 ($35.48 in chips) 
tylerz71: posts small blind $0.50
Ceanucs: posts big blind $1
cerbisor1: sits out 
*** HOLE CARDS ***
Dealt to matiko09 [7d Jd]
DYO1000: folds 
I The King I: folds 
sanpidk: folds 
matiko09: folds 
Painkiller72: folds 
azzad2007: folds 
tylerz71: raises $1 to $2
Ceanucs: calls $1
*** FLOP *** [Kc 2c 3h]
tylerz71: bets $1
Ceanucs: calls $1
*** TURN *** [Kc 2c 3h] [5d]
tylerz71: bets $1
Ceanucs: calls $1
*** RIVER *** [Kc 2c 3h 5d] [Ah]
tylerz71: checks 
Ceanucs: bets $3
tylerz71: folds 
Uncalled bet ($3) returned to Ceanucs
Ceanucs collected $7.60 from pot
*** SUMMARY ***
Total pot $8 | Rake $0.40 
Board [Kc 2c 3h 5d Ah]
Seat 1: I The King I folded before Flop (didn't bet)
Seat 3: sanpidk folded before Flop (didn't bet)
Seat 4: matiko09 folded before Flop (didn't bet)
Seat 5: Painkiller72 folded before Flop (didn't bet)
Seat 6: azzad2007 (button) folded before Flop (didn't bet)
Seat 7: tylerz71 (small blind) folded on the River
Seat 8: Ceanucs (big blind) collected ($7.60)
Seat 9: DYO1000 folded before Flop (didn't bet)





PokerStars Hand #152559464658:  Hold'em No Limit ($1/$2 USD) - 2016/04/28 15:10:09 CET [2016/04/28 9:10:09 ET]
Table 'Hakone II' 9-max Seat #3 is the button
Seat 1: Iggso ($200 in chips) 
Seat 2: matiko09 ($200 in chips) 
Seat 3: T0ny Adams ($83 in chips) 
Seat 4: aseban11 ($200 in chips) 
Seat 6: ersevi6 ($80 in chips) 
Seat 9: sofiya4 ($117.55 in chips) 
aseban11: posts small blind $1
ersevi6: posts big blind $2
wiseyoyo: sits out 
Todox2pesos: sits out 
*** HOLE CARDS ***
Dealt to matiko09 [Ad Ah]
sofiya4: calls $2
Iggso: folds 
matiko09: raises $6 to $8
T0ny Adams: folds 
aseban11: folds 
ersevi6: folds 
sofiya4: calls $6
*** FLOP *** [3h 4d 7d]
sofiya4: checks 
matiko09: bets $12
sofiya4: folds 
Uncalled bet ($12) returned to matiko09
matiko09 collected $18.05 from pot
matiko09: doesn't show hand 
*** SUMMARY ***
Total pot $19 | Rake $0.95 
Board [3h 4d 7d]
Seat 1: Iggso folded before Flop (didn't bet)
Seat 2: matiko09 collected ($18.05)
Seat 3: T0ny Adams (button) folded before Flop (didn't bet)
Seat 4: aseban11 (small blind) folded before Flop
Seat 6: ersevi6 (big blind) folded before Flop
Seat 9: sofiya4 folded on the Flop





PokerStars Hand #152559471432:  Hold'em No Limit ($0.50/$1.00 USD) - 2016/04/28 15:10:20 CET [2016/04/28 9:10:20 ET]
Table 'Lyot' 9-max Seat #3 is the button
Seat 1: matiko09 ($103.81 in chips) 
Seat 2: vrnMike ($150.61 in chips) 
Seat 3: aseban11 ($102.40 in chips) 
Seat 4: Yaaaazz ($100 in chips) 
Seat 5: di0d80 ($141.60 in chips) 
Seat 8: Patz B ($38.52 in chips) 
Seat 9: koksskrt ($128.57 in chips) 
Yaaaazz: posts small blind $0.50
di0d80: posts big blind $1
guoweiAA: sits out 
matiko09: posts the ante $0.20
vrnMike: posts the ante $0.20
aseban11: posts the ante $0.20
Yaaaazz: posts the ante $0.20
di0d80: posts the ante $0.20
Patz B: posts the ante $0.20
koksskrt: posts the ante $0.20
*** HOLE CARDS ***
Dealt to matiko09 [Jd 4s]
Patz B: raises $2 to $3
koksskrt: folds 
matiko09: folds 
Painkiller72 joins the table at seat #7 
vrnMike: folds 
aseban11: folds 
Yaaaazz: folds 
di0d80: folds 
Uncalled bet ($2) returned to Patz B
Patz B collected $3.90 from pot
*** SUMMARY ***
Total pot $3.90 | Rake $0 
Seat 1: matiko09 folded before Flop (didn't bet)
Seat 2: vrnMike folded before Flop (didn't bet)
Seat 3: aseban11 (button) folded before Flop (didn't bet)
Seat 4: Yaaaazz (small blind) folded before Flop
Seat 5: di0d80 (big blind) folded before Flop
Seat 8: Patz B collected ($3.90)
Seat 9: koksskrt folded before Flop (didn't bet)





PokerStars Hand #152559480442:  Hold'em No Limit (€0.50/€1.00 EUR) - 2016/04/28 15:10:36 CET [2016/04/28 9:10:36 ET]
Table 'Clivia II' 9-max Seat #2 is the button
Seat 1: piperkova (€41.76 in chips) 
Seat 2: HasBigBiceps (€100 in chips) 
Seat 3: Racushniak (€100 in chips) 
Seat 4: matiko09 (€100 in chips) 
Seat 5: sanpidk (€118.84 in chips) 
Seat 6: ruslik_by (€74.41 in chips) 
Seat 7: St.LaCoste (€107.15 in chips) 
Seat 8: Dantist1122 (€100 in chips) 
Seat 9: ozone2003 (€112.62 in chips) 
Racushniak: posts small blind €0.50
matiko09: posts big blind €1
*** HOLE CARDS ***
Dealt to matiko09 [Qd 9s]
sanpidk: folds 
ruslik_by: folds 
St.LaCoste: folds 
Dantist1122: folds 
ozone2003: folds 
piperkova: folds 
HasBigBiceps: raises €1.06 to €2.06
Racushniak: folds 
matiko09: calls €1.06
*** FLOP *** [6d Qh 9c]
matiko09: checks 
HasBigBiceps: bets €3.46
matiko09: calls €3.46
*** TURN *** [6d Qh 9c] [4c]
matiko09: checks 
HasBigBiceps: bets €8.65
piperkova leaves the table
matiko09: raises €15.35 to €24
HasBigBiceps: folds 
Uncalled bet (€15.35) returned to matiko09
matiko09 collected €27.40 from pot
matiko09: doesn't show hand 
*** SUMMARY ***
Total pot €28.84 | Rake €1.44 
Board [6d Qh 9c 4c]
Seat 1: piperkova folded before Flop (didn't bet)
Seat 2: HasBigBiceps (button) folded on the Turn
Seat 3: Racushniak (small blind) folded before Flop
Seat 4: matiko09 (big blind) collected (€27.40)
Seat 5: sanpidk folded before Flop (didn't bet)
Seat 6: ruslik_by folded before Flop (didn't bet)
Seat 7: St.LaCoste folded before Flop (didn't bet)
Seat 8: Dantist1122 folded before Flop (didn't bet)
Seat 9: ozone2003 folded before Flop (didn't bet)





PokerStars Hand #152559482772:  Hold'em No Limit ($0.50/$1.00 USD) - 2016/04/28 15:10:39 CET [2016/04/28 9:10:39 ET]
Table 'Zachia II' 9-max Seat #7 is the button
Seat 1: greyman571 ($131.77 in chips) 
Seat 2: sanpidk ($147.51 in chips) 
Seat 3: matiko09 ($120.32 in chips) 
Seat 4: omorfadramou ($105.21 in chips) 
Seat 5: vrnMike ($101.50 in chips) 
Seat 6: koksskrt ($100 in chips) 
Seat 7: ozone2003 ($100 in chips) 
Seat 8: aseban11 ($145.88 in chips) 
Seat 9: Painkiller72 ($106.39 in chips) 
aseban11: posts small blind $0.50
Painkiller72: posts big blind $1
*** HOLE CARDS ***
Dealt to matiko09 [6s Jc]
greyman571: folds 
sanpidk: folds 
matiko09: folds 
omorfadramou: folds 
vrnMike: raises $1 to $2
koksskrt: folds 
ozone2003: folds 
aseban11: folds 
Painkiller72: folds 
Uncalled bet ($1) returned to vrnMike
vrnMike collected $2.50 from pot
*** SUMMARY ***
Total pot $2.50 | Rake $0 
Seat 1: greyman571 folded before Flop (didn't bet)
Seat 2: sanpidk folded before Flop (didn't bet)
Seat 3: matiko09 folded before Flop (didn't bet)
Seat 4: omorfadramou folded before Flop (didn't bet)
Seat 5: vrnMike collected ($2.50)
Seat 6: koksskrt folded before Flop (didn't bet)
Seat 7: ozone2003 (button) folded before Flop (didn't bet)
Seat 8: aseban11 (small blind) folded before Flop
Seat 9: Painkiller72 (big blind) folded before Flop





PokerStars Hand #152559484086:  Hold'em No Limit ($0.50/$1.00 USD) - 2016/04/28 15:10:42 CET [2016/04/28 9:10:42 ET]
Table 'Lyot' 9-max Seat #4 is the button
Seat 1: matiko09 ($103.61 in chips) 
Seat 2: vrnMike ($150.41 in chips) 
Seat 3: aseban11 ($102.20 in chips) 
Seat 4: Yaaaazz ($100 in chips) 
Seat 5: di0d80 ($140.40 in chips) 
Seat 6: guoweiAA ($100 in chips) 
Seat 8: Patz B ($41.22 in chips) 
Seat 9: koksskrt ($128.37 in chips) 
di0d80: posts small blind $0.50
guoweiAA: posts big blind $1
Painkiller72: sits out 
matiko09: posts the ante $0.20
vrnMike: posts the ante $0.20
aseban11: posts the ante $0.20
Yaaaazz: posts the ante $0.20
di0d80: posts the ante $0.20
guoweiAA: posts the ante $0.20
Patz B: posts the ante $0.20
koksskrt: posts the ante $0.20
*** HOLE CARDS ***
Dealt to matiko09 [7s Jd]
Patz B: folds 
koksskrt: folds 
matiko09: folds 
vrnMike: raises $1 to $2
aseban11: raises $7.10 to $9.10
Yaaaazz: folds 
di0d80: folds 
guoweiAA: folds 
vrnMike: folds 
Uncalled bet ($7.10) returned to aseban11
aseban11 collected $7.10 from pot
aseban11: doesn't show hand 
*** SUMMARY ***
Total pot $7.10 | Rake $0 
Seat 1: matiko09 folded before Flop (didn't bet)
Seat 2: vrnMike folded before Flop
Seat 3: aseban11 collected ($7.10)
Seat 4: Yaaaazz (button) folded before Flop (didn't bet)
Seat 5: di0d80 (small blind) folded before Flop
Seat 6: guoweiAA (big blind) folded before Flop
Seat 8: Patz B folded before Flop (didn't bet)
Seat 9: koksskrt folded before Flop (didn't bet)





PokerStars Hand #152559486172:  Hold'em No Limit ($1/$2 USD) - 2016/04/28 15:10:45 CET [2016/04/28 9:10:45 ET]
Table 'Idomeneus II' 9-max Seat #3 is the button
Seat 1: 13Ghosts ($257.11 in chips) 
Seat 2: libbyyww ($343.95 in chips) 
Seat 3: adrenalin333 ($197.26 in chips) 
Seat 4: SoNe1988 ($80 in chips) 
Seat 5: matiko09 ($208.36 in chips) 
Seat 6: aseban11 ($200 in chips) 
Seat 7: ersevi6 ($262.03 in chips) 
Seat 8: di0d80 ($203 in chips) 
Seat 9: Fish4trips ($204 in chips) 
SoNe1988: posts small blind $1
matiko09: posts big blind $2
*** HOLE CARDS ***
Dealt to matiko09 [8h 3h]
aseban11: folds 
ersevi6: raises $3 to $5
di0d80: folds 
Fish4trips: folds 
13Ghosts: folds 
libbyyww: folds 
adrenalin333: calls $5
SoNe1988: folds 
matiko09: folds 
*** FLOP *** [Kd Ah Td]
ersevi6: checks 
adrenalin333: checks 
*** TURN *** [Kd Ah Td] [Qh]
ersevi6: checks 
adrenalin333: bets $6
ersevi6: folds 
Uncalled bet ($6) returned to adrenalin333
adrenalin333 collected $12.35 from pot
adrenalin333: doesn't show hand 
*** SUMMARY ***
Total pot $13 | Rake $0.65 
Board [Kd Ah Td Qh]
Seat 1: 13Ghosts folded before Flop (didn't bet)
Seat 2: libbyyww folded before Flop (didn't bet)
Seat 3: adrenalin333 (button) collected ($12.35)
Seat 4: SoNe1988 (small blind) folded before Flop
Seat 5: matiko09 (big blind) folded before Flop
Seat 6: aseban11 folded before Flop (didn't bet)
Seat 7: ersevi6 folded on the Turn
Seat 8: di0d80 folded before Flop (didn't bet)
Seat 9: Fish4trips folded before Flop (didn't bet)





PokerStars Hand #152559491737:  Hold'em No Limit ($1/$2 USD) - 2016/04/28 15:10:55 CET [2016/04/28 9:10:55 ET]
Table 'Hakone II' 9-max Seat #4 is the button
Seat 1: Iggso ($200 in chips) 
Seat 2: matiko09 ($210.05 in chips) 
Seat 3: T0ny Adams ($83 in chips) 
Seat 4: aseban11 ($200 in chips) 
Seat 6: ersevi6 ($78 in chips) 
Seat 7: wiseyoyo ($200 in chips) 
Seat 9: sofiya4 ($109.55 in chips) 
ersevi6: posts small blind $1
wiseyoyo: posts big blind $2
Todox2pesos: sits out 
*** HOLE CARDS ***
Dealt to matiko09 [As 5s]
sofiya4: calls $2
Iggso: folds 
matiko09: raises $6 to $8
T0ny Adams: folds 
aseban11: folds 
ersevi6: folds 
wiseyoyo: folds 
sofiya4: calls $6
*** FLOP *** [7h 7s 6h]
sofiya4: checks 
matiko09: checks 
*** TURN *** [7h 7s 6h] [Td]
sofiya4: bets $9.02
matiko09: folds 
Uncalled bet ($9.02) returned to sofiya4
sofiya4 collected $18.05 from pot
sofiya4: doesn't show hand 
*** SUMMARY ***
Total pot $19 | Rake $0.95 
Board [7h 7s 6h Td]
Seat 1: Iggso folded before Flop (didn't bet)
Seat 2: matiko09 folded on the Turn
Seat 3: T0ny Adams folded before Flop (didn't bet)
Seat 4: aseban11 (button) folded before Flop (didn't bet)
Seat 6: ersevi6 (small blind) folded before Flop
Seat 7: wiseyoyo (big blind) folded before Flop
Seat 9: sofiya4 collected ($18.05)





PokerStars Hand #152559497508:  Hold'em No Limit ($0.50/$1.00 USD) - 2016/04/28 15:11:05 CET [2016/04/28 9:11:05 ET]
Table 'Agapenor III' 9-max Seat #7 is the button
Seat 1: I The King I ($108.82 in chips) 
Seat 3: sanpidk ($138.78 in chips) 
Seat 4: matiko09 ($100 in chips) 
Seat 5: Painkiller72 ($112.17 in chips) 
Seat 6: azzad2007 ($101.60 in chips) 
Seat 7: tylerz71 ($117.48 in chips) 
Seat 8: Ceanucs ($58.76 in chips) 
Seat 9: DYO1000 ($35.48 in chips) 
Ceanucs: posts small blind $0.50
DYO1000: posts big blind $1
cerbisor1: sits out 
*** HOLE CARDS ***
Dealt to matiko09 [Js 9c]
I The King I: folds 
sanpidk: folds 
matiko09: folds 
Painkiller72: raises $1.50 to $2.50
azzad2007: folds 
tylerz71: raises $6.50 to $9
Ceanucs: folds 
DYO1000: folds 
Painkiller72: folds 
Uncalled bet ($6.50) returned to tylerz71
tylerz71 collected $6.50 from pot
tylerz71: doesn't show hand 
*** SUMMARY ***
Total pot $6.50 | Rake $0 
Seat 1: I The King I folded before Flop (didn't bet)
Seat 3: sanpidk folded before Flop (didn't bet)
Seat 4: matiko09 folded before Flop (didn't bet)
Seat 5: Painkiller72 folded before Flop
Seat 6: azzad2007 folded before Flop (didn't bet)
Seat 7: tylerz71 (button) collected ($6.50)
Seat 8: Ceanucs (small blind) folded before Flop
Seat 9: DYO1000 (big blind) folded before Flop





PokerStars Hand #152559498814:  Hold'em No Limit ($0.50/$1.00 USD) - 2016/04/28 15:11:07 CET [2016/04/28 9:11:07 ET]
Table 'Lyot' 9-max Seat #5 is the button
Seat 1: matiko09 ($103.41 in chips) 
Seat 2: vrnMike ($148.21 in chips) 
Seat 3: aseban11 ($107.10 in chips) 
Seat 4: Yaaaazz ($100 in chips) 
Seat 5: di0d80 ($139.70 in chips) 
Seat 6: guoweiAA ($98.80 in chips) 
Seat 7: Painkiller72 ($100 in chips) 
Seat 8: Patz B ($41.02 in chips) 
Seat 9: koksskrt ($128.17 in chips) 
guoweiAA: posts small blind $0.50
Painkiller72: posts big blind $1
matiko09: posts the ante $0.20
vrnMike: posts the ante $0.20
aseban11: posts the ante $0.20
Yaaaazz: posts the ante $0.20
di0d80: posts the ante $0.20
guoweiAA: posts the ante $0.20
Painkiller72: posts the ante $0.20
Patz B: posts the ante $0.20
koksskrt: posts the ante $0.20
*** HOLE CARDS ***
Dealt to matiko09 [2c 7d]
Patz B: folds 
koksskrt: folds 
matiko09: folds 
vrnMike: folds 
aseban11: folds 
Yaaaazz: folds 
di0d80: folds 
guoweiAA: folds 
Uncalled bet ($0.50) returned to Painkiller72
Painkiller72 collected $2.80 from pot
Painkiller72: doesn't show hand 
*** SUMMARY ***
Total pot $2.80 | Rake $0 
Seat 1: matiko09 folded before Flop (didn't bet)
Seat 2: vrnMike folded before Flop (didn't bet)
Seat 3: aseban11 folded before Flop (didn't bet)
Seat 4: Yaaaazz folded before Flop (didn't bet)
Seat 5: di0d80 (button) folded before Flop (didn't bet)
Seat 6: guoweiAA (small blind) folded before Flop
Seat 7: Painkiller72 (big blind) collected ($2.80)
Seat 8: Patz B folded before Flop (didn't bet)
Seat 9: koksskrt folded before Flop (didn't bet)





PokerStars Hand #152559499347:  Hold'em No Limit (€0.50/€1.00 EUR) - 2016/04/28 15:11:08 CET [2016/04/28 9:11:08 ET]
Table 'Lumiere II' 9-max Seat #6 is the button
Seat 1: vrnMike (€133.21 in chips) 
Seat 3: maxxmeister (€100 in chips) 
Seat 4: ruslik_by (€61.70 in chips) 
Seat 5: Schmidy7 (€64.20 in chips) 
Seat 6: azzad2007 (€78.59 in chips) 
Seat 7: hammerwife (€117.68 in chips) 
Seat 8: sanpidk (€100 in chips) 
Seat 9: matiko09 (€100 in chips) 
hammerwife: posts small blind €0.50
sanpidk: posts big blind €1
Racushniak: sits out 
*** HOLE CARDS ***
Dealt to matiko09 [Tc Kc]
matiko09: raises €2 to €3
vrnMike: calls €3
maxxmeister: folds 
ruslik_by: folds 
Schmidy7: folds 
azzad2007: folds 
hammerwife: folds 
sanpidk: folds 
*** FLOP *** [Js Qs Qd]
matiko09: checks 
vrnMike: checks 
*** TURN *** [Js Qs Qd] [7d]
matiko09: bets €4.15
vrnMike: raises €8.35 to €12.50
matiko09: folds 
Uncalled bet (€8.35) returned to vrnMike
vrnMike collected €15.01 from pot
*** SUMMARY ***
Total pot €15.80 | Rake €0.79 
Board [Js Qs Qd 7d]
Seat 1: vrnMike collected (€15.01)
Seat 3: maxxmeister folded before Flop (didn't bet)
Seat 4: ruslik_by folded before Flop (didn't bet)
Seat 5: Schmidy7 folded before Flop (didn't bet)
Seat 6: azzad2007 (button) folded before Flop (didn't bet)
Seat 7: hammerwife (small blind) folded before Flop
Seat 8: sanpidk (big blind) folded before Flop
Seat 9: matiko09 folded on the Turn





PokerStars Hand #152559507661:  Hold'em No Limit ($0.50/$1.00 USD) - 2016/04/28 15:11:22 CET [2016/04/28 9:11:22 ET]
Table 'Zachia II' 9-max Seat #8 is the button
Seat 1: greyman571 ($131.77 in chips) 
Seat 2: sanpidk ($147.51 in chips) 
Seat 3: matiko09 ($120.32 in chips) 
Seat 4: omorfadramou ($105.21 in chips) 
Seat 5: vrnMike ($103 in chips) 
Seat 6: koksskrt ($100 in chips) 
Seat 7: ozone2003 ($100 in chips) 
Seat 8: aseban11 ($145.38 in chips) 
Seat 9: Painkiller72 ($105.39 in chips) 
Painkiller72: posts small blind $0.50
greyman571: posts big blind $1
*** HOLE CARDS ***
Dealt to matiko09 [9c Kd]
sanpidk: folds 
matiko09: folds 
omorfadramou: folds 
vrnMike: folds 
koksskrt: folds 
ozone2003: raises $1.50 to $2.50
aseban11: folds 
Painkiller72: folds 
greyman571: calls $1.50
*** FLOP *** [9s 5d Ad]
greyman571: checks 
ozone2003: bets $3.39
greyman571: calls $3.39
*** TURN *** [9s 5d Ad] [5s]
greyman571: checks 
ozone2003: checks 
*** RIVER *** [9s 5d Ad 5s] [Ac]
greyman571: bets $6
ozone2003: folds 
Uncalled bet ($6) returned to greyman571
greyman571 collected $11.67 from pot
greyman571: doesn't show hand 
*** SUMMARY ***
Total pot $12.28 | Rake $0.61 
Board [9s 5d Ad 5s Ac]
Seat 1: greyman571 (big blind) collected ($11.67)
Seat 2: sanpidk folded before Flop (didn't bet)
Seat 3: matiko09 folded before Flop (didn't bet)
Seat 4: omorfadramou folded before Flop (didn't bet)
Seat 5: vrnMike folded before Flop (didn't bet)
Seat 6: koksskrt folded before Flop (didn't bet)
Seat 7: ozone2003 folded on the River
Seat 8: aseban11 (button) folded before Flop (didn't bet)
Seat 9: Painkiller72 (small blind) folded before Flop





PokerStars Hand #152559516822:  Hold'em No Limit ($0.50/$1.00 USD) - 2016/04/28 15:11:38 CET [2016/04/28 9:11:38 ET]
Table 'Lyot' 9-max Seat #6 is the button
Seat 1: matiko09 ($103.21 in chips) 
Seat 2: vrnMike ($148.01 in chips) 
Seat 3: aseban11 ($106.90 in chips) 
Seat 4: Yaaaazz ($100 in chips) 
Seat 5: di0d80 ($139.50 in chips) 
Seat 6: guoweiAA ($98.10 in chips) 
Seat 7: Painkiller72 ($102.10 in chips) 
Seat 8: Patz B ($40.82 in chips) 
Seat 9: koksskrt ($127.97 in chips) 
Painkiller72: posts small blind $0.50
Patz B: posts big blind $1
matiko09: posts the ante $0.20
vrnMike: posts the ante $0.20
aseban11: posts the ante $0.20
Yaaaazz: posts the ante $0.20
di0d80: posts the ante $0.20
guoweiAA: posts the ante $0.20
Painkiller72: posts the ante $0.20
Patz B: posts the ante $0.20
koksskrt: posts the ante $0.20
*** HOLE CARDS ***
Dealt to matiko09 [2h Qs]
koksskrt: folds 
matiko09: folds 
vrnMike: folds 
aseban11: folds 
Yaaaazz: folds 
di0d80: folds 
guoweiAA: folds 
Painkiller72: folds 
Uncalled bet ($0.50) returned to Patz B
Patz B collected $2.80 from pot
Patz B: shows [5d 7s] (high card Seven)
*** SUMMARY ***
Total pot $2.80 | Rake $0 
Seat 1: matiko09 folded before Flop (didn't bet)
Seat 2: vrnMike folded before Flop (didn't bet)
Seat 3: aseban11 folded before Flop (didn't bet)
Seat 4: Yaaaazz folded before Flop (didn't bet)
Seat 5: di0d80 folded before Flop (didn't bet)
Seat 6: guoweiAA (button) folded before Flop (didn't bet)
Seat 7: Painkiller72 (small blind) folded before Flop
Seat 8: Patz B (big blind) collected ($2.80)
Seat 9: koksskrt folded before Flop (didn't bet)





PokerStars Hand #152559524154:  Hold'em No Limit ($0.50/$1.00 USD) - 2016/04/28 15:11:50 CET [2016/04/28 9:11:50 ET]
Table 'Ciurlionis' 9-max Seat #3 is the button
Seat 1: sanpidk ($112.32 in chips) 
Seat 2: liuzhi14 ($119.05 in chips) 
Seat 3: I The King I ($100 in chips) 
Seat 4: ruslik_by ($209.50 in chips) 
Seat 5: matiko09 ($102.78 in chips) 
Seat 6: vrnMike ($100 in chips) 
Seat 7: Stopton ($92.50 in chips) 
Seat 8: omorfadramou ($100 in chips) 
Seat 9: Painkiller72 ($101.50 in chips) 
ruslik_by: posts small blind $0.50
matiko09: posts big blind $1
*** HOLE CARDS ***
Dealt to matiko09 [Jd Jh]
vrnMike: folds 
Stopton: folds 
omorfadramou: folds 
Painkiller72: raises $1.50 to $2.50
sanpidk: folds 
liuzhi14: calls $2.50
I The King I: folds 
ruslik_by: calls $2
matiko09: raises $10.50 to $13
Painkiller72: calls $10.50
liuzhi14: calls $10.50
ruslik_by: folds 
*** FLOP *** [Jc 3h 4d]
matiko09: checks 
Painkiller72: bets $14
liuzhi14: calls $14
matiko09: calls $14
*** TURN *** [Jc 3h 4d] [Ks]
matiko09: checks 
Painkiller72: checks 
liuzhi14: checks 
*** RIVER *** [Jc 3h 4d Ks] [7d]
matiko09: bets $27
Painkiller72: folds 
liuzhi14: calls $27
*** SHOW DOWN ***
matiko09: shows [Jd Jh] (three of a kind, Jacks)
liuzhi14: mucks hand 
matiko09 collected $135 from pot
*** SUMMARY ***
Total pot $137.50 | Rake $2.50 
Board [Jc 3h 4d Ks 7d]
Seat 1: sanpidk folded before Flop (didn't bet)
Seat 2: liuzhi14 mucked [6s Js]
Seat 3: I The King I (button) folded before Flop (didn't bet)
Seat 4: ruslik_by (small blind) folded before Flop
Seat 5: matiko09 (big blind) showed [Jd Jh] and won ($135) with three of a kind, Jacks
Seat 6: vrnMike folded before Flop (didn't bet)
Seat 7: Stopton folded before Flop (didn't bet)
Seat 8: omorfadramou folded before Flop (didn't bet)
Seat 9: Painkiller72 folded on the River





PokerStars Hand #152559525588:  Hold'em No Limit ($1/$2 USD) - 2016/04/28 15:11:53 CET [2016/04/28 9:11:53 ET]
Table 'Idomeneus II' 9-max Seat #4 is the button
Seat 1: 13Ghosts ($257.11 in chips) 
Seat 2: libbyyww ($343.95 in chips) 
Seat 3: adrenalin333 ($204.61 in chips) 
Seat 4: SoNe1988 ($80 in chips) 
Seat 5: matiko09 ($206.36 in chips) 
Seat 7: ersevi6 ($257.03 in chips) 
Seat 8: di0d80 ($203 in chips) 
Seat 9: Fish4trips ($204 in chips) 
matiko09: posts small blind $1
aseban11: is sitting out 
ersevi6: posts big blind $2
*** HOLE CARDS ***
Dealt to matiko09 [Js Jh]
aseban11 leaves the table
di0d80: folds 
Fish4trips: folds 
13Ghosts: folds 
libbyyww: folds 
adrenalin333: folds 
SoNe1988: raises $2.40 to $4.40
rmanjkeee joins the table at seat #6 
matiko09: raises $9.60 to $14
ersevi6: folds 
SoNe1988: folds 
Uncalled bet ($9.60) returned to matiko09
matiko09 collected $10.80 from pot
matiko09: doesn't show hand 
*** SUMMARY ***
Total pot $10.80 | Rake $0 
Seat 1: 13Ghosts folded before Flop (didn't bet)
Seat 2: libbyyww folded before Flop (didn't bet)
Seat 3: adrenalin333 folded before Flop (didn't bet)
Seat 4: SoNe1988 (button) folded before Flop
Seat 5: matiko09 (small blind) collected ($10.80)
Seat 7: ersevi6 (big blind) folded before Flop
Seat 8: di0d80 folded before Flop (didn't bet)
Seat 9: Fish4trips folded before Flop (didn't bet)





PokerStars Hand #152559526184:  Hold'em No Limit ($1/$2 USD) - 2016/04/28 15:11:54 CET [2016/04/28 9:11:54 ET]
Table 'Hakone II' 9-max Seat #6 is the button
Seat 1: Iggso ($200 in chips) 
Seat 2: matiko09 ($202.05 in chips) 
Seat 3: T0ny Adams ($83 in chips) 
Seat 4: aseban11 ($200 in chips) 
Seat 6: ersevi6 ($77 in chips) 
Seat 7: wiseyoyo ($200 in chips) 
Seat 8: Todox2pesos ($200 in chips) 
Seat 9: sofiya4 ($119.60 in chips) 
wiseyoyo: posts small blind $1
Todox2pesos: posts big blind $2
*** HOLE CARDS ***
Dealt to matiko09 [5s 6d]
sofiya4: calls $2
Iggso: folds 
matiko09: folds 
T0ny Adams: folds 
aseban11: raises $4 to $6
ersevi6: folds 
wiseyoyo: folds 
Todox2pesos: folds 
sofiya4: calls $4
*** FLOP *** [6h 8d Kh]
sofiya4: checks 
aseban11: checks 
*** TURN *** [6h 8d Kh] [Th]
sofiya4: checks 
aseban11: checks 
*** RIVER *** [6h 8d Kh Th] [As]
sofiya4: bets $7.12
aseban11: folds 
Uncalled bet ($7.12) returned to sofiya4
sofiya4 collected $14.25 from pot
sofiya4: doesn't show hand 
*** SUMMARY ***
Total pot $15 | Rake $0.75 
Board [6h 8d Kh Th As]
Seat 1: Iggso folded before Flop (didn't bet)
Seat 2: matiko09 folded before Flop (didn't bet)
Seat 3: T0ny Adams folded before Flop (didn't bet)
Seat 4: aseban11 folded on the River
Seat 6: ersevi6 (button) folded before Flop (didn't bet)
Seat 7: wiseyoyo (small blind) folded before Flop
Seat 8: Todox2pesos (big blind) folded before Flop
Seat 9: sofiya4 collected ($14.25)





PokerStars Hand #152559531735:  Hold'em No Limit ($0.50/$1.00 USD) - 2016/04/28 15:12:03 CET [2016/04/28 9:12:03 ET]
Table 'Agapenor III' 9-max Seat #8 is the button
Seat 1: I The King I ($108.82 in chips) 
Seat 3: sanpidk ($138.78 in chips) 
Seat 4: matiko09 ($100 in chips) 
Seat 5: Painkiller72 ($109.67 in chips) 
Seat 6: azzad2007 ($101.60 in chips) 
Seat 7: tylerz71 ($121.48 in chips) 
Seat 8: Ceanucs ($58.26 in chips) 
Seat 9: DYO1000 ($34.48 in chips) 
DYO1000: posts small blind $0.50
I The King I: posts big blind $1
cerbisor1: sits out 
*** HOLE CARDS ***
Dealt to matiko09 [9h 8h]
sanpidk: folds 
matiko09: raises $2 to $3
Painkiller72: folds 
azzad2007: calls $3
tylerz71: folds 
Ceanucs: calls $3
DYO1000: folds 
I The King I: folds 
*** FLOP *** [Qc 7d 9c]
matiko09: checks 
azzad2007: bets $3.60
Ceanucs: folds 
matiko09: folds 
Uncalled bet ($3.60) returned to azzad2007
azzad2007 collected $9.98 from pot
azzad2007: doesn't show hand 
*** SUMMARY ***
Total pot $10.50 | Rake $0.52 
Board [Qc 7d 9c]
Seat 1: I The King I (big blind) folded before Flop
Seat 3: sanpidk folded before Flop (didn't bet)
Seat 4: matiko09 folded on the Flop
Seat 5: Painkiller72 folded before Flop (didn't bet)
Seat 6: azzad2007 collected ($9.98)
Seat 7: tylerz71 folded before Flop (didn't bet)
Seat 8: Ceanucs (button) folded on the Flop
Seat 9: DYO1000 (small blind) folded before Flop





PokerStars Hand #152559535480:  Hold'em No Limit ($0.50/$1.00 USD) - 2016/04/28 15:12:09 CET [2016/04/28 9:12:09 ET]
Table 'Bruwer' 9-max Seat #2 is the button
Seat 1: aseban11 ($103.68 in chips) 
Seat 2: ruslik_by ($40 in chips) 
Seat 3: koksskrt ($134.01 in chips) 
Seat 4: matiko09 ($139.54 in chips) 
Seat 5: Carloszhang ($116.37 in chips) 
Seat 6: I The King I ($109.02 in chips) 
Seat 7: R1aki ($231.16 in chips) 
Seat 8: lumen21 ($103.50 in chips) 
Seat 9: Dantist1122 ($129.55 in chips) 
koksskrt: posts small blind $0.50
matiko09: posts big blind $1
*** HOLE CARDS ***
Dealt to matiko09 [3c As]
Carloszhang: raises $1 to $2
I The King I: folds 
R1aki: folds 
lumen21: folds 
Dantist1122: folds 
aseban11: folds 
ruslik_by: folds 
koksskrt: folds 
matiko09: folds 
Uncalled bet ($1) returned to Carloszhang
Carloszhang collected $2.50 from pot
*** SUMMARY ***
Total pot $2.50 | Rake $0 
Seat 1: aseban11 folded before Flop (didn't bet)
Seat 2: ruslik_by (button) folded before Flop (didn't bet)
Seat 3: koksskrt (small blind) folded before Flop
Seat 4: matiko09 (big blind) folded before Flop
Seat 5: Carloszhang collected ($2.50)
Seat 6: I The King I folded before Flop (didn't bet)
Seat 7: R1aki folded before Flop (didn't bet)
Seat 8: lumen21 folded before Flop (didn't bet)
Seat 9: Dantist1122 folded before Flop (didn't bet)





PokerStars Hand #152559539348:  Hold'em No Limit ($0.50/$1.00 USD) - 2016/04/28 15:12:16 CET [2016/04/28 9:12:16 ET]
Table 'Lyot' 9-max Seat #7 is the button
Seat 1: matiko09 ($103.01 in chips) 
Seat 2: vrnMike ($147.81 in chips) 
Seat 3: aseban11 ($106.70 in chips) 
Seat 4: Yaaaazz ($100 in chips) 
Seat 5: di0d80 ($139.30 in chips) 
Seat 6: guoweiAA ($97.90 in chips) 
Seat 7: Painkiller72 ($101.40 in chips) 
Seat 8: Patz B ($42.92 in chips) 
Seat 9: koksskrt ($127.77 in chips) 
Patz B: posts small blind $0.50
koksskrt: posts big blind $1
matiko09: posts the ante $0.20
vrnMike: posts the ante $0.20
aseban11: posts the ante $0.20
Yaaaazz: posts the ante $0.20
di0d80: posts the ante $0.20
guoweiAA: posts the ante $0.20
Painkiller72: posts the ante $0.20
Patz B: posts the ante $0.20
koksskrt: posts the ante $0.20
*** HOLE CARDS ***
Dealt to matiko09 [8s Td]
matiko09: folds 
vrnMike: folds 
aseban11: folds 
Yaaaazz: raises $2 to $3
di0d80: folds 
guoweiAA: calls $3
Painkiller72: folds 
Patz B: folds 
koksskrt: folds 
*** FLOP *** [7h 4s 3c]
Yaaaazz: bets $4
guoweiAA: folds 
Uncalled bet ($4) returned to Yaaaazz
Yaaaazz collected $8.84 from pot
*** SUMMARY ***
Total pot $9.30 | Rake $0.46 
Board [7h 4s 3c]
Seat 1: matiko09 folded before Flop (didn't bet)
Seat 2: vrnMike folded before Flop (didn't bet)
Seat 3: aseban11 folded before Flop (didn't bet)
Seat 4: Yaaaazz collected ($8.84)
Seat 5: di0d80 folded before Flop (didn't bet)
Seat 6: guoweiAA folded on the Flop
Seat 7: Painkiller72 (button) folded before Flop (didn't bet)
Seat 8: Patz B (small blind) folded before Flop
Seat 9: koksskrt (big blind) folded before Flop





PokerStars Hand #152559539558:  Hold'em No Limit ($0.50/$1.00 USD) - 2016/04/28 15:12:16 CET [2016/04/28 9:12:16 ET]
Table 'Erynia' 9-max Seat #9 is the button
Seat 1: I The King I ($100 in chips) 
Seat 2: matiko09 ($142.82 in chips) 
Seat 3: aseban11 ($126.97 in chips) 
Seat 4: omorfadramou ($110.68 in chips) 
Seat 5: RMilPoker ($100 in chips) 
Seat 6: peevoajax ($100 in chips) 
Seat 7: vrnMike ($111.82 in chips) 
Seat 8: YourKicker78 ($60.09 in chips) 
Seat 9: ruslik_by ($54.61 in chips) 
I The King I: posts small blind $0.50
matiko09: posts big blind $1
*** HOLE CARDS ***
Dealt to matiko09 [Js 3h]
aseban11: folds 
omorfadramou: folds 
RMilPoker: folds 
peevoajax: folds 
vrnMike: folds 
YourKicker78: folds 
ruslik_by: raises $1 to $2
I The King I: folds 
matiko09: folds 
Uncalled bet ($1) returned to ruslik_by
ruslik_by collected $2.50 from pot
ruslik_by: doesn't show hand 
*** SUMMARY ***
Total pot $2.50 | Rake $0 
Seat 1: I The King I (small blind) folded before Flop
Seat 2: matiko09 (big blind) folded before Flop
Seat 3: aseban11 folded before Flop (didn't bet)
Seat 4: omorfadramou folded before Flop (didn't bet)
Seat 5: RMilPoker folded before Flop (didn't bet)
Seat 6: peevoajax folded before Flop (didn't bet)
Seat 7: vrnMike folded before Flop (didn't bet)
Seat 8: YourKicker78 folded before Flop (didn't bet)
Seat 9: ruslik_by (button) collected ($2.50)





PokerStars Hand #152559549307:  Hold'em No Limit (€0.50/€1.00 EUR) - 2016/04/28 15:12:33 CET [2016/04/28 9:12:33 ET]
Table 'Lumiere II' 9-max Seat #7 is the button
Seat 1: vrnMike (€141.07 in chips) 
Seat 3: maxxmeister (€100 in chips) 
Seat 4: ruslik_by (€61.70 in chips) 
Seat 5: Schmidy7 (€64.20 in chips) 
Seat 6: azzad2007 (€78.59 in chips) 
Seat 7: hammerwife (€117.18 in chips) 
Seat 8: sanpidk (€100 in chips) 
Seat 9: matiko09 (€100 in chips) 
sanpidk: posts small blind €0.50
matiko09: posts big blind €1
Racushniak: sits out 
*** HOLE CARDS ***
Dealt to matiko09 [7s 5h]
vrnMike: folds 
maxxmeister: folds 
ruslik_by: folds 
Schmidy7: raises €2 to €3
azzad2007: folds 
hammerwife: folds 
sanpidk: folds 
matiko09: folds 
Uncalled bet (€2) returned to Schmidy7
Schmidy7 collected €2.50 from pot
*** SUMMARY ***
Total pot €2.50 | Rake €0 
Seat 1: vrnMike folded before Flop (didn't bet)
Seat 3: maxxmeister folded before Flop (didn't bet)
Seat 4: ruslik_by folded before Flop (didn't bet)
Seat 5: Schmidy7 collected (€2.50)
Seat 6: azzad2007 folded before Flop (didn't bet)
Seat 7: hammerwife (button) folded before Flop (didn't bet)
Seat 8: sanpidk (small blind) folded before Flop
Seat 9: matiko09 (big blind) folded before Flop





PokerStars Hand #152559550349:  Hold'em No Limit (€0.50/€1.00 EUR) - 2016/04/28 15:12:34 CET [2016/04/28 9:12:34 ET]
Table 'Clivia II' 9-max Seat #3 is the button
Seat 2: HasBigBiceps (€100 in chips) 
Seat 3: Racushniak (€100 in chips) 
Seat 4: matiko09 (€113.23 in chips) 
Seat 5: sanpidk (€118.84 in chips) 
Seat 6: ruslik_by (€74.41 in chips) 
Seat 7: St.LaCoste (€107.15 in chips) 
Seat 8: Dantist1122 (€100 in chips) 
Seat 9: ozone2003 (€112.62 in chips) 
matiko09: posts small blind €0.50
sanpidk: posts big blind €1
*** HOLE CARDS ***
Dealt to matiko09 [9s 8d]
temujin011 joins the table at seat #1 
ruslik_by: folds 
St.LaCoste: folds 
Dantist1122: folds 
ozone2003: raises €2 to €3
HasBigBiceps: folds 
Racushniak: raises €6 to €9
matiko09: folds 
sanpidk: folds 
ozone2003: calls €6
*** FLOP *** [As 6s Ks]
ozone2003: checks 
Racushniak: checks 
*** TURN *** [As 6s Ks] [7h]
ozone2003: bets €12
Racushniak: folds 
Uncalled bet (€12) returned to ozone2003
ozone2003 collected €18.52 from pot
ozone2003: doesn't show hand 
*** SUMMARY ***
Total pot €19.50 | Rake €0.98 
Board [As 6s Ks 7h]
Seat 2: HasBigBiceps folded before Flop (didn't bet)
Seat 3: Racushniak (button) folded on the Turn
Seat 4: matiko09 (small blind) folded before Flop
Seat 5: sanpidk (big blind) folded before Flop
Seat 6: ruslik_by folded before Flop (didn't bet)
Seat 7: St.LaCoste folded before Flop (didn't bet)
Seat 8: Dantist1122 folded before Flop (didn't bet)
Seat 9: ozone2003 collected (€18.52)





PokerStars Hand #152559552807:  Hold'em No Limit ($0.50/$1.00 USD) - 2016/04/28 15:12:38 CET [2016/04/28 9:12:38 ET]
Table 'Zachia II' 9-max Seat #9 is the button
Seat 1: greyman571 ($137.55 in chips) 
Seat 2: sanpidk ($147.51 in chips) 
Seat 3: matiko09 ($120.32 in chips) 
Seat 4: omorfadramou ($105.21 in chips) 
Seat 5: vrnMike ($103 in chips) 
Seat 6: koksskrt ($100 in chips) 
Seat 7: ozone2003 ($100 in chips) 
Seat 8: aseban11 ($145.38 in chips) 
Seat 9: Painkiller72 ($104.89 in chips) 
greyman571: posts small blind $0.50
sanpidk: posts big blind $1
*** HOLE CARDS ***
Dealt to matiko09 [3c Th]
matiko09: folds 
omorfadramou: folds 
vrnMike: folds 
koksskrt: folds 
ozone2003: folds 
aseban11: folds 
Painkiller72: raises $1 to $2
greyman571: folds 
sanpidk: calls $1
*** FLOP *** [Jd As 3d]
sanpidk: checks 
Painkiller72: bets $2.99
sanpidk: raises $7.51 to $10.50
Painkiller72: folds 
Uncalled bet ($7.51) returned to sanpidk
sanpidk collected $9.96 from pot
sanpidk: doesn't show hand 
*** SUMMARY ***
Total pot $10.48 | Rake $0.52 
Board [Jd As 3d]
Seat 1: greyman571 (small blind) folded before Flop
Seat 2: sanpidk (big blind) collected ($9.96)
Seat 3: matiko09 folded before Flop (didn't bet)
Seat 4: omorfadramou folded before Flop (didn't bet)
Seat 5: vrnMike folded before Flop (didn't bet)
Seat 6: koksskrt folded before Flop (didn't bet)
Seat 7: ozone2003 folded before Flop (didn't bet)
Seat 8: aseban11 folded before Flop (didn't bet)
Seat 9: Painkiller72 (button) folded on the Flop





PokerStars Hand #152559553245:  Hold'em No Limit ($1/$2 USD) - 2016/04/28 15:12:39 CET [2016/04/28 9:12:39 ET]
Table 'Idomeneus II' 9-max Seat #5 is the button
Seat 1: 13Ghosts ($257.11 in chips) 
Seat 2: libbyyww ($343.95 in chips) 
Seat 3: adrenalin333 ($204.61 in chips) 
Seat 4: SoNe1988 ($80 in chips) 
Seat 5: matiko09 ($212.76 in chips) 
Seat 7: ersevi6 ($255.03 in chips) 
Seat 8: di0d80 ($203 in chips) 
Seat 9: Fish4trips ($204 in chips) 
rmanjkeee will be allowed to play after the button
ersevi6: posts small blind $1
di0d80: posts big blind $2
*** HOLE CARDS ***
Dealt to matiko09 [4h 4c]
Fish4trips: raises $3 to $5
13Ghosts: folds 
libbyyww: folds 
adrenalin333: folds 
SoNe1988: folds 
matiko09: calls $5
ersevi6: folds 
di0d80: folds 
*** FLOP *** [8h 3d Jh]
Fish4trips: checks 
matiko09: checks 
*** TURN *** [8h 3d Jh] [8d]
Fish4trips: checks 
matiko09: checks 
*** RIVER *** [8h 3d Jh 8d] [2s]
Fish4trips: checks 
matiko09: checks 
*** SHOW DOWN ***
Fish4trips: shows [Qh Kd] (a pair of Eights)
matiko09: shows [4h 4c] (two pair, Eights and Fours)
matiko09 collected $12.35 from pot
*** SUMMARY ***
Total pot $13 | Rake $0.65 
Board [8h 3d Jh 8d 2s]
Seat 1: 13Ghosts folded before Flop (didn't bet)
Seat 2: libbyyww folded before Flop (didn't bet)
Seat 3: adrenalin333 folded before Flop (didn't bet)
Seat 4: SoNe1988 folded before Flop (didn't bet)
Seat 5: matiko09 (button) showed [4h 4c] and won ($12.35) with two pair, Eights and Fours
Seat 7: ersevi6 (small blind) folded before Flop
Seat 8: di0d80 (big blind) folded before Flop
Seat 9: Fish4trips showed [Qh Kd] and lost with a pair of Eights





PokerStars Hand #152559570092:  Hold'em No Limit ($0.50/$1.00 USD) - 2016/04/28 15:13:07 CET [2016/04/28 9:13:07 ET]
Table 'Lyot' 9-max Seat #8 is the button
Seat 1: matiko09 ($102.81 in chips) 
Seat 2: vrnMike ($147.61 in chips) 
Seat 3: aseban11 ($106.50 in chips) 
Seat 4: Yaaaazz ($105.64 in chips) 
Seat 5: di0d80 ($139.10 in chips) 
Seat 6: guoweiAA ($94.70 in chips) 
Seat 7: Painkiller72 ($101.20 in chips) 
Seat 8: Patz B ($42.22 in chips) 
Seat 9: koksskrt ($126.57 in chips) 
koksskrt: posts small blind $0.50
matiko09: posts big blind $1
matiko09: posts the ante $0.20
vrnMike: posts the ante $0.20
aseban11: posts the ante $0.20
Yaaaazz: posts the ante $0.20
di0d80: posts the ante $0.20
guoweiAA: posts the ante $0.20
Painkiller72: posts the ante $0.20
Patz B: posts the ante $0.20
koksskrt: posts the ante $0.20
*** HOLE CARDS ***
Dealt to matiko09 [Qc 7c]
vrnMike: folds 
aseban11: folds 
Yaaaazz: folds 
di0d80: folds 
guoweiAA: folds 
Painkiller72: folds 
Patz B: raises $2 to $3
koksskrt: folds 
matiko09: folds 
Uncalled bet ($2) returned to Patz B
Patz B collected $4.30 from pot
*** SUMMARY ***
Total pot $4.30 | Rake $0 
Seat 1: matiko09 (big blind) folded before Flop
Seat 2: vrnMike folded before Flop (didn't bet)
Seat 3: aseban11 folded before Flop (didn't bet)
Seat 4: Yaaaazz folded before Flop (didn't bet)
Seat 5: di0d80 folded before Flop (didn't bet)
Seat 6: guoweiAA folded before Flop (didn't bet)
Seat 7: Painkiller72 folded before Flop (didn't bet)
Seat 8: Patz B (button) collected ($4.30)
Seat 9: koksskrt (small blind) folded before Flop





PokerStars Hand #152559570869:  Hold'em No Limit ($0.50/$1.00 USD) - 2016/04/28 15:13:09 CET [2016/04/28 9:13:09 ET]
Table 'Bruwer' 9-max Seat #3 is the button
Seat 1: aseban11 ($103.68 in chips) 
Seat 2: ruslik_by ($40 in chips) 
Seat 3: koksskrt ($133.51 in chips) 
Seat 4: matiko09 ($138.54 in chips) 
Seat 5: Carloszhang ($117.87 in chips) 
Seat 6: I The King I ($109.02 in chips) 
Seat 7: R1aki ($231.16 in chips) 
Seat 8: lumen21 ($103.50 in chips) 
Seat 9: Dantist1122 ($129.55 in chips) 
matiko09: posts small blind $0.50
Carloszhang: posts big blind $1
*** HOLE CARDS ***
Dealt to matiko09 [7c 3h]
I The King I: folds 
R1aki: folds 
lumen21: folds 
Dantist1122: raises $2 to $3
aseban11: folds 
ruslik_by: folds 
koksskrt: folds 
matiko09: folds 
Carloszhang: raises $5 to $8
Dantist1122: folds 
Uncalled bet ($5) returned to Carloszhang
Carloszhang collected $6.50 from pot
*** SUMMARY ***
Total pot $6.50 | Rake $0 
Seat 1: aseban11 folded before Flop (didn't bet)
Seat 2: ruslik_by folded before Flop (didn't bet)
Seat 3: koksskrt (button) folded before Flop (didn't bet)
Seat 4: matiko09 (small blind) folded before Flop
Seat 5: Carloszhang (big blind) collected ($6.50)
Seat 6: I The King I folded before Flop (didn't bet)
Seat 7: R1aki folded before Flop (didn't bet)
Seat 8: lumen21 folded before Flop (didn't bet)
Seat 9: Dantist1122 folded before Flop





PokerStars Hand #152559571863:  Hold'em No Limit ($0.50/$1.00 USD) - 2016/04/28 15:13:10 CET [2016/04/28 9:13:10 ET]
Table 'Erynia' 9-max Seat #1 is the button
Seat 1: I The King I ($100 in chips) 
Seat 2: matiko09 ($141.82 in chips) 
Seat 4: omorfadramou ($110.68 in chips) 
Seat 5: RMilPoker ($100 in chips) 
Seat 6: peevoajax ($100 in chips) 
Seat 7: vrnMike ($111.82 in chips) 
Seat 8: YourKicker78 ($60.09 in chips) 
Seat 9: ruslik_by ($56.11 in chips) 
matiko09: posts small blind $0.50
aseban11: is sitting out 
omorfadramou: posts big blind $1
*** HOLE CARDS ***
Dealt to matiko09 [2d 9c]
aseban11 leaves the table
RMilPoker: folds 
peevoajax: folds 
vrnMike: folds 
YourKicker78: folds 
vilo1070 joins the table at seat #3 
ruslik_by: folds 
I The King I: folds 
matiko09: folds 
Uncalled bet ($0.50) returned to omorfadramou
omorfadramou collected $1 from pot
omorfadramou: doesn't show hand 
*** SUMMARY ***
Total pot $1 | Rake $0 
Seat 1: I The King I (button) folded before Flop (didn't bet)
Seat 2: matiko09 (small blind) folded before Flop
Seat 4: omorfadramou (big blind) collected ($1)
Seat 5: RMilPoker folded before Flop (didn't bet)
Seat 6: peevoajax folded before Flop (didn't bet)
Seat 7: vrnMike folded before Flop (didn't bet)
Seat 8: YourKicker78 folded before Flop (didn't bet)
Seat 9: ruslik_by folded before Flop (didn't bet)





PokerStars Hand #152559572199:  Hold'em No Limit ($1/$2 USD) - 2016/04/28 15:13:11 CET [2016/04/28 9:13:11 ET]
Table 'Hakone II' 9-max Seat #7 is the button
Seat 1: Iggso ($200 in chips) 
Seat 2: matiko09 ($202.05 in chips) 
Seat 3: T0ny Adams ($83 in chips) 
Seat 4: aseban11 ($200 in chips) 
Seat 6: ersevi6 ($77 in chips) 
Seat 7: wiseyoyo ($200 in chips) 
Seat 8: Todox2pesos ($198 in chips) 
Seat 9: sofiya4 ($127.85 in chips) 
Todox2pesos: posts small blind $1
sofiya4: posts big blind $2
*** HOLE CARDS ***
Dealt to matiko09 [7d As]
Iggso: folds 
matiko09: folds 
T0ny Adams: folds 
aseban11: raises $4 to $6
ersevi6: folds 
wiseyoyo: folds 
Todox2pesos: folds 
sofiya4 is connected 
sofiya4: folds 
Uncalled bet ($4) returned to aseban11
aseban11 collected $5 from pot
aseban11: doesn't show hand 
*** SUMMARY ***
Total pot $5 | Rake $0 
Seat 1: Iggso folded before Flop (didn't bet)
Seat 2: matiko09 folded before Flop (didn't bet)
Seat 3: T0ny Adams folded before Flop (didn't bet)
Seat 4: aseban11 collected ($5)
Seat 6: ersevi6 folded before Flop (didn't bet)
Seat 7: wiseyoyo (button) folded before Flop (didn't bet)
Seat 8: Todox2pesos (small blind) folded before Flop
Seat 9: sofiya4 (big blind) folded before Flop





PokerStars Hand #152559574926:  Hold'em No Limit ($0.50/$1.00 USD) - 2016/04/28 15:13:15 CET [2016/04/28 9:13:15 ET]
Table 'Agapenor III' 9-max Seat #9 is the button
Seat 1: I The King I ($107.82 in chips) 
Seat 2: cerbisor1 ($40 in chips) 
Seat 3: sanpidk ($138.78 in chips) 
Seat 4: matiko09 ($100 in chips) 
Seat 5: Painkiller72 ($109.67 in chips) 
Seat 6: azzad2007 ($108.58 in chips) 
Seat 7: tylerz71 ($121.48 in chips) 
Seat 8: Ceanucs ($55.26 in chips) 
Seat 9: DYO1000 ($33.98 in chips) 
I The King I: posts small blind $0.50
cerbisor1: posts big blind $1
*** HOLE CARDS ***
Dealt to matiko09 [7d 7h]
sanpidk: folds 
matiko09: raises $2 to $3
Painkiller72: folds 
azzad2007: calls $3
tylerz71: folds 
Ceanucs: calls $3
DYO1000: folds 
I The King I: calls $2.50
cerbisor1: folds 
*** FLOP *** [Qh 2d 9h]
I The King I: checks 
matiko09: checks 
azzad2007: checks 
Ceanucs: checks 
*** TURN *** [Qh 2d 9h] [Ad]
I The King I: checks 
matiko09: checks 
azzad2007: bets $8
Ceanucs: folds 
I The King I: folds 
matiko09: folds 
Uncalled bet ($8) returned to azzad2007
azzad2007 collected $12.35 from pot
azzad2007: doesn't show hand 
*** SUMMARY ***
Total pot $13 | Rake $0.65 
Board [Qh 2d 9h Ad]
Seat 1: I The King I (small blind) folded on the Turn
Seat 2: cerbisor1 (big blind) folded before Flop
Seat 3: sanpidk folded before Flop (didn't bet)
Seat 4: matiko09 folded on the Turn
Seat 5: Painkiller72 folded before Flop (didn't bet)
Seat 6: azzad2007 collected ($12.35)
Seat 7: tylerz71 folded before Flop (didn't bet)
Seat 8: Ceanucs folded on the Turn
Seat 9: DYO1000 (button) folded before Flop (didn't bet)





PokerStars Hand #152559577354:  Hold'em No Limit ($0.50/$1.00 USD) - 2016/04/28 15:13:19 CET [2016/04/28 9:13:19 ET]
Table 'Musa II' 9-max Seat #5 is the button
Seat 5: Painkiller72 ($112.69 in chips) 
Seat 6: skolombi77 ($67.12 in chips) 
Seat 8: matiko09 ($100 in chips) 
Seat 9: Moszes360 ($145.65 in chips) 
skolombi77: posts small blind $0.50
matiko09: posts big blind $1
ozone2003: sits out 
Dany660810: sits out 
*** HOLE CARDS ***
Dealt to matiko09 [Ad 6h]
Moszes360: folds 
ozone2003 leaves the table
Painkiller72: raises $1 to $2
skolombi77: folds 
Dany660810 leaves the table
St.LaCoste joins the table at seat #4 
matiko09: folds 
Uncalled bet ($1) returned to Painkiller72
St.LaCoste leaves the table
Painkiller72 collected $2.50 from pot
Painkiller72: doesn't show hand 
*** SUMMARY ***
Total pot $2.50 | Rake $0 
Seat 5: Painkiller72 (button) collected ($2.50)
Seat 6: skolombi77 (small blind) folded before Flop
Seat 8: matiko09 (big blind) folded before Flop
Seat 9: Moszes360 folded before Flop (didn't bet)





PokerStars Hand #152559582305:  Hold'em No Limit ($0.50/$1.00 USD) - 2016/04/28 15:13:27 CET [2016/04/28 9:13:27 ET]
Table 'Erynia' 9-max Seat #2 is the button
Seat 1: I The King I ($100 in chips) 
Seat 2: matiko09 ($141.32 in chips) 
Seat 4: omorfadramou ($111.18 in chips) 
Seat 5: RMilPoker ($100 in chips) 
Seat 6: peevoajax ($100 in chips) 
Seat 7: vrnMike ($111.82 in chips) 
Seat 8: YourKicker78 ($60.09 in chips) 
Seat 9: ruslik_by ($56.11 in chips) 
vilo1070 will be allowed to play after the button
omorfadramou: posts small blind $0.50
RMilPoker: posts big blind $1
*** HOLE CARDS ***
Dealt to matiko09 [2c Js]
peevoajax: folds 
vrnMike: folds 
YourKicker78: folds 
ruslik_by: folds 
I The King I: raises $1.50 to $2.50
matiko09: folds 
omorfadramou: folds 
RMilPoker: raises $5.50 to $8
I The King I: calls $5.50
*** FLOP *** [8c 7d Jc]
RMilPoker: bets $12
I The King I: folds 
Uncalled bet ($12) returned to RMilPoker
RMilPoker collected $15.68 from pot
RMilPoker: doesn't show hand 
*** SUMMARY ***
Total pot $16.50 | Rake $0.82 
Board [8c 7d Jc]
Seat 1: I The King I folded on the Flop
Seat 2: matiko09 (button) folded before Flop (didn't bet)
Seat 4: omorfadramou (small blind) folded before Flop
Seat 5: RMilPoker (big blind) collected ($15.68)
Seat 6: peevoajax folded before Flop (didn't bet)
Seat 7: vrnMike folded before Flop (didn't bet)
Seat 8: YourKicker78 folded before Flop (didn't bet)
Seat 9: ruslik_by folded before Flop (didn't bet)





PokerStars Hand #152559583951:  Hold'em No Limit (€0.50/€1.00 EUR) - 2016/04/28 15:13:30 CET [2016/04/28 9:13:30 ET]
Table 'Lumiere II' 9-max Seat #8 is the button
Seat 1: vrnMike (€141.07 in chips) 
Seat 3: maxxmeister (€100 in chips) 
Seat 4: ruslik_by (€61.70 in chips) 
Seat 5: Schmidy7 (€65.70 in chips) 
Seat 6: azzad2007 (€78.59 in chips) 
Seat 7: hammerwife (€117.18 in chips) 
Seat 8: sanpidk (€100 in chips) 
Seat 9: matiko09 (€100 in chips) 
matiko09: posts small blind €0.50
vrnMike: posts big blind €1
Racushniak: sits out 
*** HOLE CARDS ***
Dealt to matiko09 [8c 3h]
maxxmeister: raises €2 to €3
ruslik_by: folds 
Schmidy7: folds 
azzad2007: folds 
hammerwife: folds 
sanpidk: calls €3
matiko09: folds 
vrnMike: folds 
*** FLOP *** [6c 5c Ad]
maxxmeister: checks 
sanpidk: bets €5
maxxmeister: folds 
Uncalled bet (€5) returned to sanpidk
sanpidk collected €7.12 from pot
sanpidk: doesn't show hand 
*** SUMMARY ***
Total pot €7.50 | Rake €0.38 
Board [6c 5c Ad]
Seat 1: vrnMike (big blind) folded before Flop
Seat 3: maxxmeister folded on the Flop
Seat 4: ruslik_by folded before Flop (didn't bet)
Seat 5: Schmidy7 folded before Flop (didn't bet)
Seat 6: azzad2007 folded before Flop (didn't bet)
Seat 7: hammerwife folded before Flop (didn't bet)
Seat 8: sanpidk (button) collected (€7.12)
Seat 9: matiko09 (small blind) folded before Flop





PokerStars Hand #152559586970:  Hold'em No Limit ($0.50/$1.00 USD) - 2016/04/28 15:13:35 CET [2016/04/28 9:13:35 ET]
Table 'Musa II' 9-max Seat #6 is the button
Seat 5: Painkiller72 ($114.19 in chips) 
Seat 6: skolombi77 ($66.62 in chips) 
Seat 8: matiko09 ($100 in chips) 
Seat 9: Moszes360 ($145.65 in chips) 
matiko09: posts small blind $0.50
Moszes360: posts big blind $1
*** HOLE CARDS ***
Dealt to matiko09 [Ah Ks]
Painkiller72: folds 
skolombi77: folds 
matiko09: raises $1.50 to $2.50
Moszes360: folds 
Uncalled bet ($1.50) returned to matiko09
CARLOSXV15 joins the table at seat #4 
matiko09 collected $2 from pot
matiko09: doesn't show hand 
*** SUMMARY ***
Total pot $2 | Rake $0 
Seat 5: Painkiller72 folded before Flop (didn't bet)
Seat 6: skolombi77 (button) folded before Flop (didn't bet)
Seat 8: matiko09 (small blind) collected ($2)
Seat 9: Moszes360 (big blind) folded before Flop





PokerStars Hand #152559593789:  Hold'em No Limit ($0.50/$1.00 USD) - 2016/04/28 15:13:46 CET [2016/04/28 9:13:46 ET]
Table 'Zachia II' 9-max Seat #1 is the button
Seat 1: greyman571 ($137.05 in chips) 
Seat 2: sanpidk ($152.48 in chips) 
Seat 3: matiko09 ($120.32 in chips) 
Seat 4: omorfadramou ($105.21 in chips) 
Seat 5: vrnMike ($103 in chips) 
Seat 6: koksskrt ($100 in chips) 
Seat 7: ozone2003 ($100 in chips) 
Seat 8: aseban11 ($145.38 in chips) 
Seat 9: Painkiller72 ($100 in chips) 
sanpidk: posts small blind $0.50
matiko09: posts big blind $1
*** HOLE CARDS ***
Dealt to matiko09 [Kd 5d]
omorfadramou: folds 
vrnMike: folds 
koksskrt: raises $2 to $3
ozone2003: folds 
aseban11: calls $3
Painkiller72: folds 
greyman571: folds 
sanpidk: folds 
matiko09: folds 
*** FLOP *** [Qc 2c 8d]
koksskrt: checks 
aseban11: checks 
*** TURN *** [Qc 2c 8d] [4h]
koksskrt: bets $4.48
aseban11: folds 
Uncalled bet ($4.48) returned to koksskrt
koksskrt collected $7.12 from pot
koksskrt: doesn't show hand 
*** SUMMARY ***
Total pot $7.50 | Rake $0.38 
Board [Qc 2c 8d 4h]
Seat 1: greyman571 (button) folded before Flop (didn't bet)
Seat 2: sanpidk (small blind) folded before Flop
Seat 3: matiko09 (big blind) folded before Flop
Seat 4: omorfadramou folded before Flop (didn't bet)
Seat 5: vrnMike folded before Flop (didn't bet)
Seat 6: koksskrt collected ($7.12)
Seat 7: ozone2003 folded before Flop (didn't bet)
Seat 8: aseban11 folded on the Turn
Seat 9: Painkiller72 folded before Flop (didn't bet)





PokerStars Hand #152559596448:  Hold'em No Limit ($0.50/$1.00 USD) - 2016/04/28 15:13:51 CET [2016/04/28 9:13:51 ET]
Table 'Bruwer' 9-max Seat #4 is the button
Seat 1: aseban11 ($103.68 in chips) 
Seat 2: ruslik_by ($40 in chips) 
Seat 3: koksskrt ($133.51 in chips) 
Seat 4: matiko09 ($138.04 in chips) 
Seat 5: Carloszhang ($121.37 in chips) 
Seat 6: I The King I ($109.02 in chips) 
Seat 7: R1aki ($231.16 in chips) 
Seat 8: lumen21 ($103.50 in chips) 
Seat 9: Dantist1122 ($126.55 in chips) 
Carloszhang: posts small blind $0.50
I The King I: posts big blind $1
*** HOLE CARDS ***
Dealt to matiko09 [2d 5d]
R1aki: folds 
lumen21: folds 
Dantist1122: raises $2 to $3
aseban11: folds 
ruslik_by: folds 
koksskrt: folds 
matiko09: folds 
Carloszhang: calls $2.50
I The King I: folds 
*** FLOP *** [Ac 5c 6h]
Carloszhang: checks 
Dantist1122: bets $5
Carloszhang: folds 
Uncalled bet ($5) returned to Dantist1122
Dantist1122 collected $6.65 from pot
Dantist1122: doesn't show hand 
*** SUMMARY ***
Total pot $7 | Rake $0.35 
Board [Ac 5c 6h]
Seat 1: aseban11 folded before Flop (didn't bet)
Seat 2: ruslik_by folded before Flop (didn't bet)
Seat 3: koksskrt folded before Flop (didn't bet)
Seat 4: matiko09 (button) folded before Flop (didn't bet)
Seat 5: Carloszhang (small blind) folded on the Flop
Seat 6: I The King I (big blind) folded before Flop
Seat 7: R1aki folded before Flop (didn't bet)
Seat 8: lumen21 folded before Flop (didn't bet)
Seat 9: Dantist1122 collected ($6.65)





PokerStars Hand #152559600866:  Hold'em No Limit ($0.50/$1.00 USD) - 2016/04/28 15:13:58 CET [2016/04/28 9:13:58 ET]
Table 'Musa II' 9-max Seat #8 is the button
Seat 4: CARLOSXV15 ($80 in chips) 
Seat 5: Painkiller72 ($114.19 in chips) 
Seat 6: skolombi77 ($66.62 in chips) 
Seat 8: matiko09 ($101 in chips) 
Seat 9: Moszes360 ($144.65 in chips) 
Moszes360: posts small blind $0.50
CARLOSXV15: posts big blind $1
*** HOLE CARDS ***
Dealt to matiko09 [3h Qc]
Painkiller72: folds 
skolombi77: raises $1 to $2
matiko09: folds 
Moszes360: calls $1.50
CARLOSXV15: calls $1
*** FLOP *** [5d 9s Js]
HomerrrJay joins the table at seat #1 
Moszes360: checks 
CARLOSXV15: checks 
skolombi77: bets $3
Moszes360: calls $3
CARLOSXV15: calls $3
*** TURN *** [5d 9s Js] [8h]
Moszes360: checks 
CARLOSXV15: checks 
skolombi77: checks 
*** RIVER *** [5d 9s Js 8h] [Ad]
Moszes360: checks 
CARLOSXV15: checks 
skolombi77: bets $9
Moszes360: folds 
CARLOSXV15: calls $9
*** SHOW DOWN ***
skolombi77: shows [As 8s] (two pair, Aces and Eights)
CARLOSXV15: mucks hand 
skolombi77 collected $31.35 from pot
*** SUMMARY ***
Total pot $33 | Rake $1.65 
Board [5d 9s Js 8h Ad]
Seat 4: CARLOSXV15 (big blind) mucked [Ks 8c]
Seat 5: Painkiller72 folded before Flop (didn't bet)
Seat 6: skolombi77 showed [As 8s] and won ($31.35) with two pair, Aces and Eights
Seat 8: matiko09 (button) folded before Flop (didn't bet)
Seat 9: Moszes360 (small blind) folded on the River





PokerStars Hand #152559605038:  Hold'em No Limit ($0.50/$1.00 USD) - 2016/04/28 15:14:05 CET [2016/04/28 9:14:05 ET]
Table 'Lyot' 9-max Seat #9 is the button
Seat 1: matiko09 ($101.61 in chips) 
Seat 6: guoweiAA ($94.50 in chips) 
Seat 7: Painkiller72 ($101 in chips) 
Seat 8: Patz B ($45.32 in chips) 
Seat 9: koksskrt ($125.87 in chips) 
matiko09: posts small blind $0.50
vrnMike: is sitting out 
aseban11: is sitting out 
Yaaaazz: is sitting out 
aseban11 leaves the table
di0d80: is sitting out 
guoweiAA: posts big blind $1
matiko09: posts the ante $0.20
guoweiAA: posts the ante $0.20
Painkiller72: posts the ante $0.20
Patz B: posts the ante $0.20
koksskrt: posts the ante $0.20
*** HOLE CARDS ***
Dealt to matiko09 [5h 9d]
di0d80 leaves the table
Painkiller72: folds 
Yaaaazz leaves the table
vrnMike leaves the table
Patz B: calls $1
koksskrt: folds 
matiko09: folds 
guoweiAA: checks 
*** FLOP *** [Jd 6s 7c]
guoweiAA: checks 
Patz B: checks 
*** TURN *** [Jd 6s 7c] [Kc]
guoweiAA: checks 
Patz B: bets $1
guoweiAA: calls $1
*** RIVER *** [Jd 6s 7c Kc] [6d]
guoweiAA: checks 
Patz B: bets $3
guoweiAA: folds 
Uncalled bet ($3) returned to Patz B
Patz B collected $5.22 from pot
*** SUMMARY ***
Total pot $5.50 | Rake $0.28 
Board [Jd 6s 7c Kc 6d]
Seat 1: matiko09 (small blind) folded before Flop
Seat 6: guoweiAA (big blind) folded on the River
Seat 7: Painkiller72 folded before Flop (didn't bet)
Seat 8: Patz B collected ($5.22)
Seat 9: koksskrt (button) folded before Flop (didn't bet)





PokerStars Hand #152559607561:  Hold'em No Limit ($1/$2 USD) - 2016/04/28 15:14:09 CET [2016/04/28 9:14:09 ET]
Table 'Hakone II' 9-max Seat #8 is the button
Seat 1: Iggso ($200 in chips) 
Seat 2: matiko09 ($202.05 in chips) 
Seat 3: T0ny Adams ($83 in chips) 
Seat 4: aseban11 ($203 in chips) 
Seat 6: ersevi6 ($77 in chips) 
Seat 7: wiseyoyo ($200 in chips) 
Seat 8: Todox2pesos ($197 in chips) 
Seat 9: sofiya4 ($125.85 in chips) 
sofiya4: posts small blind $1
Iggso: posts big blind $2
*** HOLE CARDS ***
Dealt to matiko09 [Ah Jh]
matiko09: raises $3 to $5
T0ny Adams: folds 
aseban11: calls $5
ersevi6: folds 
wiseyoyo: folds 
Todox2pesos: folds 
sofiya4: calls $4
Iggso: folds 
*** FLOP *** [3h As Ac]
sofiya4: checks 
matiko09: checks 
aseban11: checks 
*** TURN *** [3h As Ac] [8s]
sofiya4: bets $2
matiko09: raises $10 to $12
aseban11: folds 
sofiya4: folds 
Uncalled bet ($10) returned to matiko09
matiko09 collected $19.95 from pot
matiko09: doesn't show hand 
*** SUMMARY ***
Total pot $21 | Rake $1.05 
Board [3h As Ac 8s]
Seat 1: Iggso (big blind) folded before Flop
Seat 2: matiko09 collected ($19.95)
Seat 3: T0ny Adams folded before Flop (didn't bet)
Seat 4: aseban11 folded on the Turn
Seat 6: ersevi6 folded before Flop (didn't bet)
Seat 7: wiseyoyo folded before Flop (didn't bet)
Seat 8: Todox2pesos (button) folded before Flop (didn't bet)
Seat 9: sofiya4 (small blind) folded on the Turn





PokerStars Hand #152559607775:  Hold'em No Limit (€0.50/€1.00 EUR) - 2016/04/28 15:14:10 CET [2016/04/28 9:14:10 ET]
Table 'Clivia II' 9-max Seat #4 is the button
Seat 2: HasBigBiceps (€100 in chips) 
Seat 3: Racushniak (€100 in chips) 
Seat 4: matiko09 (€112.73 in chips) 
Seat 5: sanpidk (€117.84 in chips) 
Seat 6: ruslik_by (€74.41 in chips) 
Seat 7: St.LaCoste (€107.15 in chips) 
Seat 8: Dantist1122 (€100 in chips) 
Seat 9: ozone2003 (€122.14 in chips) 
sanpidk: posts small blind €0.50
ruslik_by: posts big blind €1
temujin011: sits out 
*** HOLE CARDS ***
Dealt to matiko09 [4d Jd]
St.LaCoste: folds 
St.LaCoste leaves the table
Dantist1122: raises €2 to €3
ozone2003: folds 
HasBigBiceps: folds 
Racushniak: folds 
Painkiller72 joins the table at seat #7 
matiko09: folds 
Painkiller72 leaves the table
sanpidk: folds 
ruslik_by: calls €2
*** FLOP *** [Td Qc 7s]
ruslik_by: checks 
Dantist1122: bets €4.76
ruslik_by: folds 
Uncalled bet (€4.76) returned to Dantist1122
Dantist1122 collected €6.18 from pot
Dantist1122: doesn't show hand 
*** SUMMARY ***
Total pot €6.50 | Rake €0.32 
Board [Td Qc 7s]
Seat 2: HasBigBiceps folded before Flop (didn't bet)
Seat 3: Racushniak folded before Flop (didn't bet)
Seat 4: matiko09 (button) folded before Flop (didn't bet)
Seat 5: sanpidk (small blind) folded before Flop
Seat 6: ruslik_by (big blind) folded on the Flop
Seat 7: St.LaCoste folded before Flop (didn't bet)
Seat 8: Dantist1122 collected (€6.18)
Seat 9: ozone2003 folded before Flop (didn't bet)





PokerStars Hand #152559614521:  Hold'em No Limit ($1/$2 USD) - 2016/04/28 15:14:21 CET [2016/04/28 9:14:21 ET]
Table 'Idomeneus II' 9-max Seat #7 is the button
Seat 1: 13Ghosts ($257.11 in chips) 
Seat 2: libbyyww ($343.95 in chips) 
Seat 3: adrenalin333 ($204.61 in chips) 
Seat 4: SoNe1988 ($80 in chips) 
Seat 5: matiko09 ($220.11 in chips) 
Seat 7: ersevi6 ($254.03 in chips) 
Seat 8: di0d80 ($201 in chips) 
di0d80: posts small blind $1
Fish4trips: is sitting out 
Fish4trips leaves the table
13Ghosts: posts big blind $2
rmanjkeee: sits out 
*** HOLE CARDS ***
Dealt to matiko09 [6h Kh]
libbyyww: folds 
adrenalin333: folds 
SoNe1988: folds 
matiko09: folds 
ersevi6: raises $2 to $4
di0d80: folds 
13Ghosts: folds 
Uncalled bet ($2) returned to ersevi6
ersevi6 collected $5 from pot
ersevi6: doesn't show hand 
*** SUMMARY ***
Total pot $5 | Rake $0 
Seat 1: 13Ghosts (big blind) folded before Flop
Seat 2: libbyyww folded before Flop (didn't bet)
Seat 3: adrenalin333 folded before Flop (didn't bet)
Seat 4: SoNe1988 folded before Flop (didn't bet)
Seat 5: matiko09 folded before Flop (didn't bet)
Seat 7: ersevi6 (button) collected ($5)
Seat 8: di0d80 (small blind) folded before Flop





PokerStars Hand #152559615000:  Hold'em No Limit (€0.50/€1.00 EUR) - 2016/04/28 15:14:22 CET [2016/04/28 9:14:22 ET]
Table 'Lumiere II' 9-max Seat #9 is the button
Seat 1: vrnMike (€140.07 in chips) 
Seat 2: Racushniak (€111.83 in chips) 
Seat 3: maxxmeister (€100 in chips) 
Seat 4: ruslik_by (€61.70 in chips) 
Seat 5: Schmidy7 (€65.70 in chips) 
Seat 6: azzad2007 (€78.59 in chips) 
Seat 7: hammerwife (€117.18 in chips) 
Seat 8: sanpidk (€104.12 in chips) 
Seat 9: matiko09 (€100 in chips) 
vrnMike: posts small blind €0.50
Racushniak: posts big blind €1
*** HOLE CARDS ***
Dealt to matiko09 [Ac 6s]
maxxmeister: folds 
ruslik_by: raises €2 to €3
Schmidy7: folds 
azzad2007: raises €6 to €9
hammerwife: folds 
sanpidk: folds 
matiko09: folds 
vrnMike: folds 
Racushniak: folds 
ruslik_by: folds 
Uncalled bet (€6) returned to azzad2007
azzad2007 collected €7.50 from pot
azzad2007: doesn't show hand 
*** SUMMARY ***
Total pot €7.50 | Rake €0 
Seat 1: vrnMike (small blind) folded before Flop
Seat 2: Racushniak (big blind) folded before Flop
Seat 3: maxxmeister folded before Flop (didn't bet)
Seat 4: ruslik_by folded before Flop
Seat 5: Schmidy7 folded before Flop (didn't bet)
Seat 6: azzad2007 collected (€7.50)
Seat 7: hammerwife folded before Flop (didn't bet)
Seat 8: sanpidk folded before Flop (didn't bet)
Seat 9: matiko09 (button) folded before Flop (didn't bet)





PokerStars Hand #152559615808:  Hold'em No Limit ($0.50/$1.00 USD) - 2016/04/28 15:14:23 CET [2016/04/28 9:14:23 ET]
Table 'Erynia' 9-max Seat #4 is the button
Seat 1: I The King I ($100 in chips) 
Seat 2: matiko09 ($141.32 in chips) 
Seat 4: omorfadramou ($110.68 in chips) 
Seat 5: RMilPoker ($107.68 in chips) 
Seat 6: peevoajax ($100 in chips) 
Seat 7: vrnMike ($111.82 in chips) 
Seat 8: YourKicker78 ($60.09 in chips) 
Seat 9: ruslik_by ($56.11 in chips) 
RMilPoker: posts small blind $0.50
peevoajax: posts big blind $1
vilo1070: sits out 
*** HOLE CARDS ***
Dealt to matiko09 [Kd 9s]
vrnMike: folds 
YourKicker78: folds 
ruslik_by: folds 
I The King I: raises $2 to $3
matiko09: folds 
omorfadramou: folds 
RMilPoker: folds 
peevoajax: folds 
Uncalled bet ($2) returned to I The King I
I The King I collected $2.50 from pot
I The King I: doesn't show hand 
*** SUMMARY ***
Total pot $2.50 | Rake $0 
Seat 1: I The King I collected ($2.50)
Seat 2: matiko09 folded before Flop (didn't bet)
Seat 4: omorfadramou (button) folded before Flop (didn't bet)
Seat 5: RMilPoker (small blind) folded before Flop
Seat 6: peevoajax (big blind) folded before Flop
Seat 7: vrnMike folded before Flop (didn't bet)
Seat 8: YourKicker78 folded before Flop (didn't bet)
Seat 9: ruslik_by folded before Flop (didn't bet)





PokerStars Hand #152559624092:  Hold'em No Limit ($0.50/$1.00 USD) - 2016/04/28 15:14:37 CET [2016/04/28 9:14:37 ET]
Table 'Zachia II' 9-max Seat #2 is the button
Seat 1: greyman571 ($137.05 in chips) 
Seat 2: sanpidk ($151.98 in chips) 
Seat 3: matiko09 ($119.32 in chips) 
Seat 4: omorfadramou ($105.21 in chips) 
Seat 5: vrnMike ($103 in chips) 
Seat 6: koksskrt ($104.12 in chips) 
Seat 7: ozone2003 ($100 in chips) 
Seat 8: aseban11 ($142.38 in chips) 
Seat 9: Painkiller72 ($100 in chips) 
matiko09: posts small blind $0.50
omorfadramou: posts big blind $1
*** HOLE CARDS ***
Dealt to matiko09 [Th Kh]
vrnMike: folds 
koksskrt: folds 
ozone2003: folds 
aseban11: folds 
Painkiller72: raises $1.50 to $2.50
greyman571: folds 
sanpidk: folds 
matiko09: folds 
omorfadramou: calls $1.50
*** FLOP *** [Ac Kc 2h]
omorfadramou: checks 
Painkiller72: checks 
*** TURN *** [Ac Kc 2h] [8h]
omorfadramou: checks 
Painkiller72: checks 
*** RIVER *** [Ac Kc 2h 8h] [6d]
omorfadramou: bets $3.28
Painkiller72: folds 
Uncalled bet ($3.28) returned to omorfadramou
omorfadramou collected $5.22 from pot
omorfadramou: doesn't show hand 
*** SUMMARY ***
Total pot $5.50 | Rake $0.28 
Board [Ac Kc 2h 8h 6d]
Seat 1: greyman571 folded before Flop (didn't bet)
Seat 2: sanpidk (button) folded before Flop (didn't bet)
Seat 3: matiko09 (small blind) folded before Flop
Seat 4: omorfadramou (big blind) collected ($5.22)
Seat 5: vrnMike folded before Flop (didn't bet)
Seat 6: koksskrt folded before Flop (didn't bet)
Seat 7: ozone2003 folded before Flop (didn't bet)
Seat 8: aseban11 folded before Flop (didn't bet)
Seat 9: Painkiller72 folded on the River





PokerStars Hand #152559626773:  Hold'em No Limit ($1/$2 USD) - 2016/04/28 15:14:41 CET [2016/04/28 9:14:41 ET]
Table 'Idomeneus II' 9-max Seat #8 is the button
Seat 1: 13Ghosts ($255.11 in chips) 
Seat 2: libbyyww ($343.95 in chips) 
Seat 3: adrenalin333 ($204.61 in chips) 
Seat 4: SoNe1988 ($80 in chips) 
Seat 5: matiko09 ($220.11 in chips) 
Seat 7: ersevi6 ($257.03 in chips) 
Seat 8: di0d80 ($200 in chips) 
13Ghosts: posts small blind $1
libbyyww: posts big blind $2
rmanjkeee: sits out 
*** HOLE CARDS ***
Dealt to matiko09 [Js 7d]
adrenalin333: calls $2
SoNe1988: folds 
matiko09: folds 
ersevi6: folds 
di0d80: folds 
prominente joins the table at seat #9 
13Ghosts: calls $1
libbyyww: raises $8 to $10
adrenalin333: calls $8
13Ghosts: folds 
*** FLOP *** [Kd 5d 3c]
libbyyww: bets $12
adrenalin333: folds 
Uncalled bet ($12) returned to libbyyww
libbyyww collected $20.90 from pot
libbyyww: doesn't show hand 
*** SUMMARY ***
Total pot $22 | Rake $1.10 
Board [Kd 5d 3c]
Seat 1: 13Ghosts (small blind) folded before Flop
Seat 2: libbyyww (big blind) collected ($20.90)
Seat 3: adrenalin333 folded on the Flop
Seat 4: SoNe1988 folded before Flop (didn't bet)
Seat 5: matiko09 folded before Flop (didn't bet)
Seat 7: ersevi6 folded before Flop (didn't bet)
Seat 8: di0d80 (button) folded before Flop (didn't bet)





PokerStars Hand #152559628538:  Hold'em No Limit ($0.50/$1.00 USD) - 2016/04/28 15:14:44 CET [2016/04/28 9:14:44 ET]
Table 'Musa II' 9-max Seat #9 is the button
Seat 4: CARLOSXV15 ($66 in chips) 
Seat 5: Painkiller72 ($114.19 in chips) 
Seat 6: skolombi77 ($83.97 in chips) 
Seat 8: matiko09 ($101 in chips) 
Seat 9: Moszes360 ($139.65 in chips) 
HomerrrJay will be allowed to play after the button
CARLOSXV15: posts small blind $0.50
Painkiller72: posts big blind $1
ka100pka527: sits out 
*** HOLE CARDS ***
Dealt to matiko09 [5h 7s]
skolombi77: folds 
matiko09: folds 
Moszes360: raises $1.10 to $2.10
CARLOSXV15: calls $1.60
Painkiller72: calls $1.10
*** FLOP *** [4s 2d As]
CARLOSXV15: checks 
Painkiller72: checks 
Moszes360: bets $3.94
CARLOSXV15: folds 
Painkiller72: calls $3.94
*** TURN *** [4s 2d As] [Ah]
Painkiller72: checks 
Moszes360: checks 
*** RIVER *** [4s 2d As Ah] [8h]
Painkiller72: checks 
Moszes360: checks 
ozone2003 joins the table at seat #2 
*** SHOW DOWN ***
Painkiller72: shows [5s 2s] (two pair, Aces and Deuces)
Moszes360: shows [8c Ks] (two pair, Aces and Eights)
Moszes360 collected $13.47 from pot
*** SUMMARY ***
Total pot $14.18 | Rake $0.71 
Board [4s 2d As Ah 8h]
Seat 4: CARLOSXV15 (small blind) folded on the Flop
Seat 5: Painkiller72 (big blind) showed [5s 2s] and lost with two pair, Aces and Deuces
Seat 6: skolombi77 folded before Flop (didn't bet)
Seat 8: matiko09 folded before Flop (didn't bet)
Seat 9: Moszes360 (button) showed [8c Ks] and won ($13.47) with two pair, Aces and Eights





PokerStars Hand #152559636255:  Hold'em No Limit ($0.50/$1.00 USD) - 2016/04/28 15:14:57 CET [2016/04/28 9:14:57 ET]
Table 'Ciurlionis' 9-max Seat #4 is the button
Seat 1: sanpidk ($112.32 in chips) 
Seat 2: liuzhi14 ($65.05 in chips) 
Seat 3: I The King I ($100 in chips) 
Seat 4: ruslik_by ($207 in chips) 
Seat 5: matiko09 ($183.78 in chips) 
Seat 6: vrnMike ($100 in chips) 
Seat 7: Stopton ($92.50 in chips) 
Seat 8: omorfadramou ($100 in chips) 
Seat 9: Painkiller72 ($100 in chips) 
matiko09: posts small blind $0.50
vrnMike: posts big blind $1
*** HOLE CARDS ***
Dealt to matiko09 [Kc Qd]
Stopton: folds 
omorfadramou: folds 
Painkiller72: folds 
sanpidk: raises $2 to $3
liuzhi14: calls $3
I The King I: raises $10 to $13
ruslik_by: folds 
matiko09: folds 
vrnMike: folds 
sanpidk: calls $10
liuzhi14: folds 
*** FLOP *** [8d 6d 4s]
sanpidk: checks 
I The King I: bets $15
sanpidk: calls $15
*** TURN *** [8d 6d 4s] [4c]
sanpidk: checks 
I The King I: bets $23
sanpidk: folds 
Uncalled bet ($23) returned to I The King I
I The King I collected $58 from pot
I The King I: doesn't show hand 
*** SUMMARY ***
Total pot $60.50 | Rake $2.50 
Board [8d 6d 4s 4c]
Seat 1: sanpidk folded on the Turn
Seat 2: liuzhi14 folded before Flop
Seat 3: I The King I collected ($58)
Seat 4: ruslik_by (button) folded before Flop (didn't bet)
Seat 5: matiko09 (small blind) folded before Flop
Seat 6: vrnMike (big blind) folded before Flop
Seat 7: Stopton folded before Flop (didn't bet)
Seat 8: omorfadramou folded before Flop (didn't bet)
Seat 9: Painkiller72 folded before Flop (didn't bet)





PokerStars Hand #152559640303:  Hold'em No Limit ($0.50/$1.00 USD) - 2016/04/28 15:15:04 CET [2016/04/28 9:15:04 ET]
Table 'Erynia' 9-max Seat #5 is the button
Seat 1: I The King I ($101.50 in chips) 
Seat 2: matiko09 ($141.32 in chips) 
Seat 4: omorfadramou ($110.68 in chips) 
Seat 5: RMilPoker ($107.18 in chips) 
Seat 6: peevoajax ($100 in chips) 
Seat 7: vrnMike ($111.82 in chips) 
Seat 8: YourKicker78 ($60.09 in chips) 
Seat 9: ruslik_by ($56.11 in chips) 
peevoajax: posts small blind $0.50
vrnMike: posts big blind $1
vilo1070: sits out 
*** HOLE CARDS ***
Dealt to matiko09 [5h Kh]
YourKicker78: folds 
ruslik_by: raises $2 to $3
I The King I: folds 
matiko09: folds 
omorfadramou: folds 
RMilPoker: folds 
peevoajax: folds 
vrnMike: calls $2
*** FLOP *** [5s Ah Qs]
vrnMike: checks 
ruslik_by: bets $2.50
vrnMike: calls $2.50
*** TURN *** [5s Ah Qs] [8s]
vrnMike: checks 
ruslik_by: checks 
*** RIVER *** [5s Ah Qs 8s] [3c]
vrnMike: bets $15.50
ruslik_by: folds 
Uncalled bet ($15.50) returned to vrnMike
vrnMike collected $10.92 from pot
*** SUMMARY ***
Total pot $11.50 | Rake $0.58 
Board [5s Ah Qs 8s 3c]
Seat 1: I The King I folded before Flop (didn't bet)
Seat 2: matiko09 folded before Flop (didn't bet)
Seat 4: omorfadramou folded before Flop (didn't bet)
Seat 5: RMilPoker (button) folded before Flop (didn't bet)
Seat 6: peevoajax (small blind) folded before Flop
Seat 7: vrnMike (big blind) collected ($10.92)
Seat 8: YourKicker78 folded before Flop (didn't bet)
Seat 9: ruslik_by folded on the River





PokerStars Hand #152559645808:  Hold'em No Limit (€0.50/€1.00 EUR) - 2016/04/28 15:15:13 CET [2016/04/28 9:15:13 ET]
Table 'Lumiere II' 9-max Seat #1 is the button
Seat 1: vrnMike (€139.57 in chips) 
Seat 2: Racushniak (€110.83 in chips) 
Seat 3: maxxmeister (€100 in chips) 
Seat 4: ruslik_by (€58.70 in chips) 
Seat 5: Schmidy7 (€65.70 in chips) 
Seat 6: azzad2007 (€83.09 in chips) 
Seat 7: hammerwife (€117.18 in chips) 
Seat 8: sanpidk (€104.12 in chips) 
Seat 9: matiko09 (€100 in chips) 
Racushniak: posts small blind €0.50
maxxmeister: posts big blind €1
*** HOLE CARDS ***
Dealt to matiko09 [3c 5s]
ruslik_by: folds 
Schmidy7: calls €1
azzad2007: folds 
hammerwife: folds 
sanpidk: folds 
matiko09: folds 
vrnMike: folds 
Racushniak: raises €3 to €4
maxxmeister: folds 
Schmidy7: calls €3
*** FLOP *** [7s 9c 5c]
Racushniak: bets €4.70
Schmidy7: folds 
Uncalled bet (€4.70) returned to Racushniak
Racushniak collected €8.55 from pot
Racushniak: doesn't show hand 
*** SUMMARY ***
Total pot €9 | Rake €0.45 
Board [7s 9c 5c]
Seat 1: vrnMike (button) folded before Flop (didn't bet)
Seat 2: Racushniak (small blind) collected (€8.55)
Seat 3: maxxmeister (big blind) folded before Flop
Seat 4: ruslik_by folded before Flop (didn't bet)
Seat 5: Schmidy7 folded on the Flop
Seat 6: azzad2007 folded before Flop (didn't bet)
Seat 7: hammerwife folded before Flop (didn't bet)
Seat 8: sanpidk folded before Flop (didn't bet)
Seat 9: matiko09 folded before Flop (didn't bet)





PokerStars Hand #152559650900:  Hold'em No Limit ($0.50/$1.00 USD) - 2016/04/28 15:15:22 CET [2016/04/28 9:15:22 ET]
Table 'Lyot' 9-max Seat #1 is the button
Seat 1: matiko09 ($100.91 in chips) 
Seat 6: guoweiAA ($92.30 in chips) 
Seat 7: Painkiller72 ($100.80 in chips) 
Seat 8: Patz B ($48.34 in chips) 
Seat 9: koksskrt ($125.67 in chips) 
guoweiAA: posts small blind $0.50
Painkiller72: posts big blind $1
matiko09: posts the ante $0.20
guoweiAA: posts the ante $0.20
Painkiller72: posts the ante $0.20
Patz B: posts the ante $0.20
koksskrt: posts the ante $0.20
*** HOLE CARDS ***
Dealt to matiko09 [6h 3s]
Patz B: folds 
koksskrt: folds 
matiko09: folds 
guoweiAA: raises $2 to $3
Painkiller72: raises $6 to $9
guoweiAA: folds 
Uncalled bet ($6) returned to Painkiller72
Painkiller72 collected $7 from pot
Painkiller72: doesn't show hand 
*** SUMMARY ***
Total pot $7 | Rake $0 
Seat 1: matiko09 (button) folded before Flop (didn't bet)
Seat 6: guoweiAA (small blind) folded before Flop
Seat 7: Painkiller72 (big blind) collected ($7)
Seat 8: Patz B folded before Flop (didn't bet)
Seat 9: koksskrt folded before Flop (didn't bet)





PokerStars Hand #152559651299:  Hold'em No Limit ($0.50/$1.00 USD) - 2016/04/28 15:15:23 CET [2016/04/28 9:15:23 ET]
Table 'Agapenor III' 9-max Seat #1 is the button
Seat 1: I The King I ($104.82 in chips) 
Seat 2: cerbisor1 ($39 in chips) 
Seat 3: sanpidk ($138.78 in chips) 
Seat 4: matiko09 ($100 in chips) 
Seat 5: Painkiller72 ($109.67 in chips) 
Seat 6: azzad2007 ($117.93 in chips) 
Seat 7: tylerz71 ($121.48 in chips) 
Seat 8: Ceanucs ($52.26 in chips) 
Seat 9: DYO1000 ($33.98 in chips) 
cerbisor1: posts small blind $0.50
sanpidk: posts big blind $1
*** HOLE CARDS ***
Dealt to matiko09 [9h 5h]
matiko09: folds 
Painkiller72: folds 
azzad2007: folds 
tylerz71: folds 
Ceanucs: folds 
DYO1000: raises $1 to $2
I The King I: folds 
cerbisor1: folds 
sanpidk: folds 
Uncalled bet ($1) returned to DYO1000
DYO1000 collected $2.50 from pot
DYO1000: doesn't show hand 
*** SUMMARY ***
Total pot $2.50 | Rake $0 
Seat 1: I The King I (button) folded before Flop (didn't bet)
Seat 2: cerbisor1 (small blind) folded before Flop
Seat 3: sanpidk (big blind) folded before Flop
Seat 4: matiko09 folded before Flop (didn't bet)
Seat 5: Painkiller72 folded before Flop (didn't bet)
Seat 6: azzad2007 folded before Flop (didn't bet)
Seat 7: tylerz71 folded before Flop (didn't bet)
Seat 8: Ceanucs folded before Flop (didn't bet)
Seat 9: DYO1000 collected ($2.50)





PokerStars Hand #152559651496:  Hold'em No Limit ($1/$2 USD) - 2016/04/28 15:15:23 CET [2016/04/28 9:15:23 ET]
Table 'Hakone II' 9-max Seat #9 is the button
Seat 1: Iggso ($200 in chips) 
Seat 2: matiko09 ($215 in chips) 
Seat 3: T0ny Adams ($83 in chips) 
Seat 4: aseban11 ($200 in chips) 
Seat 6: ersevi6 ($77 in chips) 
Seat 7: wiseyoyo ($200 in chips) 
Seat 8: Todox2pesos ($197 in chips) 
Seat 9: sofiya4 ($118.85 in chips) 
Iggso: posts small blind $1
matiko09: posts big blind $2
*** HOLE CARDS ***
Dealt to matiko09 [Ts 7c]
T0ny Adams: folds 
aseban11: folds 
ersevi6: folds 
wiseyoyo: folds 
Todox2pesos: folds 
sofiya4: calls $2
Iggso: folds 
matiko09: checks 
*** FLOP *** [Jh 6d Jc]
matiko09: checks 
sofiya4: checks 
*** TURN *** [Jh 6d Jc] [6h]
matiko09: checks 
sofiya4: checks 
*** RIVER *** [Jh 6d Jc 6h] [Kc]
matiko09: checks 
sofiya4: bets $4.75
matiko09: folds 
Uncalled bet ($4.75) returned to sofiya4
sofiya4 collected $4.75 from pot
sofiya4: doesn't show hand 
*** SUMMARY ***
Total pot $5 | Rake $0.25 
Board [Jh 6d Jc 6h Kc]
Seat 1: Iggso (small blind) folded before Flop
Seat 2: matiko09 (big blind) folded on the River
Seat 3: T0ny Adams folded before Flop (didn't bet)
Seat 4: aseban11 folded before Flop (didn't bet)
Seat 6: ersevi6 folded before Flop (didn't bet)
Seat 7: wiseyoyo folded before Flop (didn't bet)
Seat 8: Todox2pesos folded before Flop (didn't bet)
Seat 9: sofiya4 (button) collected ($4.75)





PokerStars Hand #152559652803:  Hold'em No Limit (€0.50/€1.00 EUR) - 2016/04/28 15:15:25 CET [2016/04/28 9:15:25 ET]
Table 'Clivia II' 9-max Seat #5 is the button
Seat 2: HasBigBiceps (€100 in chips) 
Seat 3: Racushniak (€100 in chips) 
Seat 4: matiko09 (€112.73 in chips) 
Seat 5: sanpidk (€117.34 in chips) 
Seat 6: ruslik_by (€71.41 in chips) 
Seat 9: ozone2003 (€122.14 in chips) 
ruslik_by: posts small blind €0.50
Dantist1122: is sitting out 
Dantist1122 leaves the table
ozone2003: posts big blind €1
temujin011: sits out 
*** HOLE CARDS ***
Dealt to matiko09 [Qc Jd]
R1aki joins the table at seat #7 
HasBigBiceps: folds 
Racushniak: folds 
matiko09: raises €1.50 to €2.50
R1aki leaves the table
sanpidk: folds 
ruslik_by: folds 
ozone2003: folds 
Uncalled bet (€1.50) returned to matiko09
matiko09 collected €2.50 from pot
matiko09: doesn't show hand 
*** SUMMARY ***
Total pot €2.50 | Rake €0 
Seat 2: HasBigBiceps folded before Flop (didn't bet)
Seat 3: Racushniak folded before Flop (didn't bet)
Seat 4: matiko09 collected (€2.50)
Seat 5: sanpidk (button) folded before Flop (didn't bet)
Seat 6: ruslik_by (small blind) folded before Flop
Seat 9: ozone2003 (big blind) folded before Flop





PokerStars Hand #152559654686:  Hold'em No Limit ($0.50/$1.00 USD) - 2016/04/28 15:15:28 CET [2016/04/28 9:15:28 ET]
Table 'Bruwer' 9-max Seat #5 is the button
Seat 1: aseban11 ($103.68 in chips) 
Seat 2: ruslik_by ($40 in chips) 
Seat 3: koksskrt ($133.51 in chips) 
Seat 4: matiko09 ($138.04 in chips) 
Seat 5: Carloszhang ($118.37 in chips) 
Seat 6: I The King I ($108.02 in chips) 
Seat 7: R1aki ($231.16 in chips) 
Seat 8: lumen21 ($103.50 in chips) 
Seat 9: Dantist1122 ($130.20 in chips) 
I The King I: posts small blind $0.50
R1aki: posts big blind $1
*** HOLE CARDS ***
Dealt to matiko09 [4c 6c]
lumen21: folds 
Dantist1122: folds 
aseban11: raises $2 to $3
ruslik_by: folds 
koksskrt: folds 
matiko09: folds 
Carloszhang: calls $3
I The King I: folds 
R1aki: folds 
*** FLOP *** [7h 5h Js]
aseban11: bets $5.34
Carloszhang: calls $5.34
*** TURN *** [7h 5h Js] [Th]
aseban11: bets $12.95
Carloszhang: folds 
Uncalled bet ($12.95) returned to aseban11
aseban11 collected $17.27 from pot
aseban11: doesn't show hand 
*** SUMMARY ***
Total pot $18.18 | Rake $0.91 
Board [7h 5h Js Th]
Seat 1: aseban11 collected ($17.27)
Seat 2: ruslik_by folded before Flop (didn't bet)
Seat 3: koksskrt folded before Flop (didn't bet)
Seat 4: matiko09 folded before Flop (didn't bet)
Seat 5: Carloszhang (button) folded on the Turn
Seat 6: I The King I (small blind) folded before Flop
Seat 7: R1aki (big blind) folded before Flop
Seat 8: lumen21 folded before Flop (didn't bet)
Seat 9: Dantist1122 folded before Flop (didn't bet)





PokerStars Hand #152559663787:  Hold'em No Limit ($0.50/$1.00 USD) - 2016/04/28 15:15:44 CET [2016/04/28 9:15:44 ET]
Table 'Lyot' 9-max Seat #6 is the button
Seat 1: matiko09 ($100.71 in chips) 
Seat 6: guoweiAA ($89.10 in chips) 
Seat 7: Painkiller72 ($104.60 in chips) 
Seat 8: Patz B ($48.14 in chips) 
Seat 9: koksskrt ($125.47 in chips) 
Painkiller72: posts small blind $0.50
Patz B: posts big blind $1
matiko09: posts the ante $0.20
guoweiAA: posts the ante $0.20
Painkiller72: posts the ante $0.20
Patz B: posts the ante $0.20
koksskrt: posts the ante $0.20
*** HOLE CARDS ***
Dealt to matiko09 [Kc Tc]
koksskrt: folds 
matiko09: raises $2 to $3
guoweiAA: folds 
Painkiller72: folds 
Patz B: folds 
Uncalled bet ($2) returned to matiko09
matiko09 collected $3.50 from pot
matiko09: doesn't show hand 
*** SUMMARY ***
Total pot $3.50 | Rake $0 
Seat 1: matiko09 collected ($3.50)
Seat 6: guoweiAA (button) folded before Flop (didn't bet)
Seat 7: Painkiller72 (small blind) folded before Flop
Seat 8: Patz B (big blind) folded before Flop
Seat 9: koksskrt folded before Flop (didn't bet)





PokerStars Hand #152559670729:  Hold'em No Limit ($0.50/$1.00 USD) - 2016/04/28 15:15:56 CET [2016/04/28 9:15:56 ET]
Table 'Musa II' 9-max Seat #4 is the button
Seat 4: CARLOSXV15 ($98.40 in chips) 
Seat 5: Painkiller72 ($108.15 in chips) 
Seat 6: skolombi77 ($83.97 in chips) 
Seat 8: matiko09 ($101 in chips) 
Seat 9: Moszes360 ($147.08 in chips) 
Painkiller72: posts small blind $0.50
skolombi77: posts big blind $1
ka100pka527: sits out 
HomerrrJay: sits out 
ozone2003: sits out 
*** HOLE CARDS ***
Dealt to matiko09 [4d Ac]
matiko09: folds 
Moszes360: folds 
CARLOSXV15: folds 
King_ZéManel joins the table at seat #3 
Painkiller72: folds 
Uncalled bet ($0.50) returned to skolombi77
skolombi77 collected $1 from pot
skolombi77: doesn't show hand 
*** SUMMARY ***
Total pot $1 | Rake $0 
Seat 4: CARLOSXV15 (button) folded before Flop (didn't bet)
Seat 5: Painkiller72 (small blind) folded before Flop
Seat 6: skolombi77 (big blind) collected ($1)
Seat 8: matiko09 folded before Flop (didn't bet)
Seat 9: Moszes360 folded before Flop (didn't bet)





PokerStars Hand #152559672854:  Hold'em No Limit ($1/$2 USD) - 2016/04/28 15:15:59 CET [2016/04/28 9:15:59 ET]
Table 'Idomeneus II' 9-max Seat #1 is the button
Seat 1: 13Ghosts ($253.11 in chips) 
Seat 2: libbyyww ($354.85 in chips) 
Seat 3: adrenalin333 ($194.61 in chips) 
Seat 4: SoNe1988 ($80 in chips) 
Seat 5: matiko09 ($220.11 in chips) 
Seat 7: ersevi6 ($257.03 in chips) 
Seat 8: di0d80 ($200 in chips) 
libbyyww: posts small blind $1
adrenalin333: posts big blind $2
rmanjkeee: sits out 
*** HOLE CARDS ***
Dealt to matiko09 [As 8h]
SoNe1988: folds 
matiko09: folds 
ersevi6: folds 
di0d80: folds 
13Ghosts: folds 
libbyyww: folds 
Uncalled bet ($1) returned to adrenalin333
adrenalin333 collected $2 from pot
adrenalin333: doesn't show hand 
*** SUMMARY ***
Total pot $2 | Rake $0 
Seat 1: 13Ghosts (button) folded before Flop (didn't bet)
Seat 2: libbyyww (small blind) folded before Flop
Seat 3: adrenalin333 (big blind) collected ($2)
Seat 4: SoNe1988 folded before Flop (didn't bet)
Seat 5: matiko09 folded before Flop (didn't bet)
Seat 7: ersevi6 folded before Flop (didn't bet)
Seat 8: di0d80 folded before Flop (didn't bet)





PokerStars Hand #152559672556:  Hold'em No Limit (€0.50/€1.00 EUR) - 2016/04/28 15:15:59 CET [2016/04/28 9:15:59 ET]
Table 'Lumiere II' 9-max Seat #2 is the button
Seat 1: vrnMike (€139.57 in chips) 
Seat 2: Racushniak (€115.38 in chips) 
Seat 3: maxxmeister (€100 in chips) 
Seat 4: ruslik_by (€58.70 in chips) 
Seat 5: Schmidy7 (€61.70 in chips) 
Seat 6: azzad2007 (€83.09 in chips) 
Seat 7: hammerwife (€117.18 in chips) 
Seat 8: sanpidk (€104.12 in chips) 
Seat 9: matiko09 (€100 in chips) 
maxxmeister: posts small blind €0.50
ruslik_by: posts big blind €1
*** HOLE CARDS ***
Dealt to matiko09 [3d Qd]
Schmidy7: folds 
azzad2007: folds 
hammerwife: folds 
sanpidk: folds 
matiko09: folds 
vrnMike: raises €1 to €2
Racushniak: raises €6 to €8
maxxmeister: folds 
ruslik_by: folds 
vrnMike: raises €14 to €22
Racushniak: folds 
Uncalled bet (€14) returned to vrnMike
vrnMike collected €17.50 from pot
*** SUMMARY ***
Total pot €17.50 | Rake €0 
Seat 1: vrnMike collected (€17.50)
Seat 2: Racushniak (button) folded before Flop
Seat 3: maxxmeister (small blind) folded before Flop
Seat 4: ruslik_by (big blind) folded before Flop
Seat 5: Schmidy7 folded before Flop (didn't bet)
Seat 6: azzad2007 folded before Flop (didn't bet)
Seat 7: hammerwife folded before Flop (didn't bet)
Seat 8: sanpidk folded before Flop (didn't bet)
Seat 9: matiko09 folded before Flop (didn't bet)





PokerStars Hand #152559675245:  Hold'em No Limit ($0.50/$1.00 USD) - 2016/04/28 15:16:03 CET [2016/04/28 9:16:03 ET]
Table 'Agapenor III' 9-max Seat #2 is the button
Seat 1: I The King I ($104.82 in chips) 
Seat 2: cerbisor1 ($38.50 in chips) 
Seat 3: sanpidk ($137.78 in chips) 
Seat 4: matiko09 ($100 in chips) 
Seat 5: Painkiller72 ($109.67 in chips) 
Seat 6: azzad2007 ($117.93 in chips) 
Seat 7: tylerz71 ($121.48 in chips) 
Seat 8: Ceanucs ($52.26 in chips) 
Seat 9: DYO1000 ($35.48 in chips) 
sanpidk: posts small blind $0.50
matiko09: posts big blind $1
*** HOLE CARDS ***
Dealt to matiko09 [2s 7h]
Painkiller72: folds 
azzad2007: folds 
tylerz71: folds 
Ceanucs: folds 
DYO1000: folds 
I The King I: raises $1.50 to $2.50
cerbisor1: folds 
sanpidk: calls $2
matiko09: folds 
*** FLOP *** [2c 4d 5d]
sanpidk: checks 
I The King I: checks 
*** TURN *** [2c 4d 5d] [Ac]
sanpidk: checks 
I The King I: checks 
*** RIVER *** [2c 4d 5d Ac] [3s]
sanpidk: checks 
I The King I: checks 
*** SHOW DOWN ***
sanpidk: shows [Qh Tc] (a straight, Ace to Five)
I The King I: shows [Ts Qc] (a straight, Ace to Five)
sanpidk collected $2.85 from pot
I The King I collected $2.85 from pot
*** SUMMARY ***
Total pot $6 | Rake $0.30 
Board [2c 4d 5d Ac 3s]
Seat 1: I The King I showed [Ts Qc] and won ($2.85) with a straight, Ace to Five
Seat 2: cerbisor1 (button) folded before Flop (didn't bet)
Seat 3: sanpidk (small blind) showed [Qh Tc] and won ($2.85) with a straight, Ace to Five
Seat 4: matiko09 (big blind) folded before Flop
Seat 5: Painkiller72 folded before Flop (didn't bet)
Seat 6: azzad2007 folded before Flop (didn't bet)
Seat 7: tylerz71 folded before Flop (didn't bet)
Seat 8: Ceanucs folded before Flop (didn't bet)
Seat 9: DYO1000 folded before Flop (didn't bet)





PokerStars Hand #152559675874:  Hold'em No Limit ($1/$2 USD) - 2016/04/28 15:16:04 CET [2016/04/28 9:16:04 ET]
Table 'Hakone II' 9-max Seat #1 is the button
Seat 1: Iggso ($200 in chips) 
Seat 2: matiko09 ($213 in chips) 
Seat 3: T0ny Adams ($83 in chips) 
Seat 4: aseban11 ($200 in chips) 
Seat 6: ersevi6 ($77 in chips) 
Seat 7: wiseyoyo ($200 in chips) 
Seat 8: Todox2pesos ($197 in chips) 
Seat 9: sofiya4 ($121.60 in chips) 
matiko09: posts small blind $1
T0ny Adams: posts big blind $2
*** HOLE CARDS ***
Dealt to matiko09 [9s Ad]
aseban11: folds 
ersevi6: folds 
aseban11 leaves the table
wiseyoyo: raises $3 to $5
Todox2pesos: folds 
sofiya4: calls $5
Iggso: folds 
matiko09: folds 
T0ny Adams: folds 
*** FLOP *** [8c Js 3s]
SoNe1988 joins the table at seat #4 
wiseyoyo: bets $12
sofiya4: folds 
Uncalled bet ($12) returned to wiseyoyo
wiseyoyo collected $12.35 from pot
wiseyoyo: doesn't show hand 
*** SUMMARY ***
Total pot $13 | Rake $0.65 
Board [8c Js 3s]
Seat 1: Iggso (button) folded before Flop (didn't bet)
Seat 2: matiko09 (small blind) folded before Flop
Seat 3: T0ny Adams (big blind) folded before Flop
Seat 4: aseban11 folded before Flop (didn't bet)
Seat 6: ersevi6 folded before Flop (didn't bet)
Seat 7: wiseyoyo collected ($12.35)
Seat 8: Todox2pesos folded before Flop (didn't bet)
Seat 9: sofiya4 folded on the Flop





PokerStars Hand #152559677596:  Hold'em No Limit ($0.50/$1.00 USD) - 2016/04/28 15:16:07 CET [2016/04/28 9:16:07 ET]
Table 'Lyot' 9-max Seat #7 is the button
Seat 1: matiko09 ($103.01 in chips) 
Seat 6: guoweiAA ($88.90 in chips) 
Seat 7: Painkiller72 ($103.90 in chips) 
Seat 8: Patz B ($46.94 in chips) 
Seat 9: koksskrt ($125.27 in chips) 
Patz B: posts small blind $0.50
koksskrt: posts big blind $1
matiko09: posts the ante $0.20
guoweiAA: posts the ante $0.20
Painkiller72: posts the ante $0.20
Patz B: posts the ante $0.20
koksskrt: posts the ante $0.20
*** HOLE CARDS ***
Dealt to matiko09 [Ks Jd]
matiko09: raises $2 to $3
guoweiAA: folds 
Painkiller72: folds 
Patz B: folds 
koksskrt: folds 
Uncalled bet ($2) returned to matiko09
matiko09 collected $3.50 from pot
matiko09: doesn't show hand 
*** SUMMARY ***
Total pot $3.50 | Rake $0 
Seat 1: matiko09 collected ($3.50)
Seat 6: guoweiAA folded before Flop (didn't bet)
Seat 7: Painkiller72 (button) folded before Flop (didn't bet)
Seat 8: Patz B (small blind) folded before Flop
Seat 9: koksskrt (big blind) folded before Flop





PokerStars Hand #152559679167:  Hold'em No Limit ($0.50/$1.00 USD) - 2016/04/28 15:16:10 CET [2016/04/28 9:16:10 ET]
Table 'Zachia II' 9-max Seat #3 is the button
Seat 1: greyman571 ($137.05 in chips) 
Seat 2: sanpidk ($151.98 in chips) 
Seat 3: matiko09 ($118.82 in chips) 
Seat 4: omorfadramou ($107.93 in chips) 
Seat 5: vrnMike ($103 in chips) 
Seat 6: koksskrt ($104.12 in chips) 
Seat 7: ozone2003 ($100 in chips) 
Seat 8: aseban11 ($142.38 in chips) 
Seat 9: Painkiller72 ($100 in chips) 
omorfadramou: posts small blind $0.50
vrnMike: posts big blind $1
*** HOLE CARDS ***
Dealt to matiko09 [5h 3d]
koksskrt: folds 
ozone2003: folds 
aseban11: folds 
Painkiller72: folds 
greyman571: folds 
sanpidk: folds 
matiko09: folds 
omorfadramou: folds 
Uncalled bet ($0.50) returned to vrnMike
vrnMike collected $1 from pot
*** SUMMARY ***
Total pot $1 | Rake $0 
Seat 1: greyman571 folded before Flop (didn't bet)
Seat 2: sanpidk folded before Flop (didn't bet)
Seat 3: matiko09 (button) folded before Flop (didn't bet)
Seat 4: omorfadramou (small blind) folded before Flop
Seat 5: vrnMike (big blind) collected ($1)
Seat 6: koksskrt folded before Flop (didn't bet)
Seat 7: ozone2003 folded before Flop (didn't bet)
Seat 8: aseban11 folded before Flop (didn't bet)
Seat 9: Painkiller72 folded before Flop (didn't bet)





PokerStars Hand #152559679709:  Hold'em No Limit ($0.50/$1.00 USD) - 2016/04/28 15:16:11 CET [2016/04/28 9:16:11 ET]
Table 'Musa II' 9-max Seat #5 is the button
Seat 4: CARLOSXV15 ($98.40 in chips) 
Seat 5: Painkiller72 ($107.65 in chips) 
Seat 6: skolombi77 ($84.47 in chips) 
Seat 7: ka100pka527 ($40 in chips) 
Seat 8: matiko09 ($101 in chips) 
Seat 9: Moszes360 ($147.08 in chips) 
skolombi77: posts small blind $0.50
ka100pka527: posts big blind $1
HomerrrJay: sits out 
ozone2003: sits out 
King_ZéManel: sits out 
*** HOLE CARDS ***
Dealt to matiko09 [3d Tc]
King_ZéManel leaves the table
matiko09: folds 
Moszes360: folds 
sanpidk joins the table at seat #3 
CARLOSXV15: folds 
sanpidk leaves the table
vrnMike joins the table at seat #3 
Painkiller72: folds 
skolombi77: folds 
Uncalled bet ($0.50) returned to ka100pka527
ka100pka527 collected $1 from pot
ka100pka527: doesn't show hand 
*** SUMMARY ***
Total pot $1 | Rake $0 
Seat 4: CARLOSXV15 folded before Flop (didn't bet)
Seat 5: Painkiller72 (button) folded before Flop (didn't bet)
Seat 6: skolombi77 (small blind) folded before Flop
Seat 7: ka100pka527 (big blind) collected ($1)
Seat 8: matiko09 folded before Flop (didn't bet)
Seat 9: Moszes360 folded before Flop (didn't bet)





PokerStars Hand #152559680742:  Hold'em No Limit (€0.50/€1.00 EUR) - 2016/04/28 15:16:13 CET [2016/04/28 9:16:13 ET]
Table 'Clivia II' 9-max Seat #6 is the button
Seat 1: temujin011 (€100 in chips) 
Seat 2: HasBigBiceps (€100 in chips) 
Seat 3: Racushniak (€100 in chips) 
Seat 4: matiko09 (€114.23 in chips) 
Seat 5: sanpidk (€117.34 in chips) 
Seat 6: ruslik_by (€70.91 in chips) 
Seat 9: ozone2003 (€121.14 in chips) 
ozone2003: posts small blind €0.50
temujin011: posts big blind €1
*** HOLE CARDS ***
Dealt to matiko09 [7s 4s]
HasBigBiceps: folds 
Racushniak: folds 
matiko09: folds 
sanpidk: folds 
ruslik_by: raises €1 to €2
ozone2003: folds 
temujin011: calls €1
*** FLOP *** [2c 9d 9h]
temujin011: checks 
ruslik_by: bets €2
temujin011: folds 
Uncalled bet (€2) returned to ruslik_by
ruslik_by collected €4.28 from pot
ruslik_by: doesn't show hand 
*** SUMMARY ***
Total pot €4.50 | Rake €0.22 
Board [2c 9d 9h]
Seat 1: temujin011 (big blind) folded on the Flop
Seat 2: HasBigBiceps folded before Flop (didn't bet)
Seat 3: Racushniak folded before Flop (didn't bet)
Seat 4: matiko09 folded before Flop (didn't bet)
Seat 5: sanpidk folded before Flop (didn't bet)
Seat 6: ruslik_by (button) collected (€4.28)
Seat 9: ozone2003 (small blind) folded before Flop





PokerStars Hand #152559690372:  Hold'em No Limit ($1/$2 USD) - 2016/04/28 15:16:29 CET [2016/04/28 9:16:29 ET]
Table 'Idomeneus II' 9-max Seat #2 is the button
Seat 1: 13Ghosts ($253.11 in chips) 
Seat 2: libbyyww ($353.85 in chips) 
Seat 3: adrenalin333 ($195.61 in chips) 
Seat 4: SoNe1988 ($80 in chips) 
Seat 5: matiko09 ($220.11 in chips) 
Seat 7: ersevi6 ($257.03 in chips) 
Seat 8: di0d80 ($200 in chips) 
adrenalin333: posts small blind $1
SoNe1988: posts big blind $2
rmanjkeee: sits out 
*** HOLE CARDS ***
Dealt to matiko09 [2d Kh]
matiko09: folds 
ersevi6: raises $3 to $5
di0d80: folds 
13Ghosts: folds 
libbyyww: folds 
adrenalin333: folds 
SoNe1988: folds 
Uncalled bet ($3) returned to ersevi6
ersevi6 collected $5 from pot
ersevi6: doesn't show hand 
*** SUMMARY ***
Total pot $5 | Rake $0 
Seat 1: 13Ghosts folded before Flop (didn't bet)
Seat 2: libbyyww (button) folded before Flop (didn't bet)
Seat 3: adrenalin333 (small blind) folded before Flop
Seat 4: SoNe1988 (big blind) folded before Flop
Seat 5: matiko09 folded before Flop (didn't bet)
Seat 7: ersevi6 collected ($5)
Seat 8: di0d80 folded before Flop (didn't bet)





PokerStars Hand #152559692232:  Hold'em No Limit ($0.50/$1.00 USD) - 2016/04/28 15:16:32 CET [2016/04/28 9:16:32 ET]
Table 'Erynia' 9-max Seat #6 is the button
Seat 1: I The King I ($101.50 in chips) 
Seat 2: matiko09 ($141.32 in chips) 
Seat 4: omorfadramou ($110.68 in chips) 
Seat 5: RMilPoker ($107.18 in chips) 
Seat 6: peevoajax ($100 in chips) 
Seat 7: vrnMike ($117.24 in chips) 
Seat 8: YourKicker78 ($60.09 in chips) 
Seat 9: ruslik_by ($50.61 in chips) 
vrnMike: posts small blind $0.50
YourKicker78: posts big blind $1
vilo1070: sits out 
*** HOLE CARDS ***
Dealt to matiko09 [Jd 8h]
ruslik_by: folds 
I The King I: raises $2 to $3
matiko09: folds 
omorfadramou: folds 
RMilPoker: folds 
peevoajax: folds 
vrnMike: folds 
YourKicker78: calls $2
*** FLOP *** [8d 7c Js]
YourKicker78: checks 
I The King I: checks 
*** TURN *** [8d 7c Js] [6h]
YourKicker78: bets $4
I The King I: folds 
Uncalled bet ($4) returned to YourKicker78
YourKicker78 collected $6.18 from pot
YourKicker78: doesn't show hand 
*** SUMMARY ***
Total pot $6.50 | Rake $0.32 
Board [8d 7c Js 6h]
Seat 1: I The King I folded on the Turn
Seat 2: matiko09 folded before Flop (didn't bet)
Seat 4: omorfadramou folded before Flop (didn't bet)
Seat 5: RMilPoker folded before Flop (didn't bet)
Seat 6: peevoajax (button) folded before Flop (didn't bet)
Seat 7: vrnMike (small blind) folded before Flop
Seat 8: YourKicker78 (big blind) collected ($6.18)
Seat 9: ruslik_by folded before Flop (didn't bet)





PokerStars Hand #152559695777:  Hold'em No Limit ($0.50/$1.00 USD) - 2016/04/28 15:16:38 CET [2016/04/28 9:16:38 ET]
Table 'Musa II' 9-max Seat #6 is the button
Seat 4: CARLOSXV15 ($98.40 in chips) 
Seat 5: Painkiller72 ($107.65 in chips) 
Seat 6: skolombi77 ($83.97 in chips) 
Seat 7: ka100pka527 ($40.50 in chips) 
Seat 8: matiko09 ($101 in chips) 
Seat 9: Moszes360 ($147.08 in chips) 
ka100pka527: posts small blind $0.50
matiko09: posts big blind $1
HomerrrJay: sits out 
ozone2003: sits out 
vrnMike: sits out 
*** HOLE CARDS ***
Dealt to matiko09 [4c Ah]
Moszes360: folds 
CARLOSXV15: raises $2 to $3
Painkiller72: raises $6 to $9
skolombi77: folds 
ka100pka527: folds 
matiko09: folds 
CARLOSXV15: raises $19.50 to $28.50
Painkiller72: folds 
Uncalled bet ($19.50) returned to CARLOSXV15
CARLOSXV15 collected $19.50 from pot
*** SUMMARY ***
Total pot $19.50 | Rake $0 
Seat 4: CARLOSXV15 collected ($19.50)
Seat 5: Painkiller72 folded before Flop
Seat 6: skolombi77 (button) folded before Flop (didn't bet)
Seat 7: ka100pka527 (small blind) folded before Flop
Seat 8: matiko09 (big blind) folded before Flop
Seat 9: Moszes360 folded before Flop (didn't bet)





PokerStars Hand #152559698414:  Hold'em No Limit ($1/$2 USD) - 2016/04/28 15:16:43 CET [2016/04/28 9:16:43 ET]
Table 'Hakone II' 9-max Seat #2 is the button
Seat 1: Iggso ($200 in chips) 
Seat 2: matiko09 ($212 in chips) 
Seat 3: T0ny Adams ($81 in chips) 
Seat 4: SoNe1988 ($114.42 in chips) 
Seat 6: ersevi6 ($77 in chips) 
Seat 7: wiseyoyo ($207.35 in chips) 
Seat 8: Todox2pesos ($197 in chips) 
Seat 9: sofiya4 ($116.60 in chips) 
T0ny Adams: posts small blind $1
SoNe1988: posts big blind $2
*** HOLE CARDS ***
Dealt to matiko09 [Td 2d]
ersevi6: folds 
wiseyoyo: raises $3 to $5
Todox2pesos: folds 
sofiya4: calls $5
Iggso: folds 
matiko09: folds 
T0ny Adams: folds 
SoNe1988: folds 
*** FLOP *** [3c Ah Js]
wiseyoyo: bets $11.11
sofiya4: calls $11.11
*** TURN *** [3c Ah Js] [2h]
wiseyoyo: bets $28
sofiya4: calls $28
*** RIVER *** [3c Ah Js 2h] [Jc]
wiseyoyo: bets $72.48
sofiya4: raises $0.01 to $72.49 and is all-in
wiseyoyo: calls $0.01
*** SHOW DOWN ***
sofiya4: shows [Kc Ks] (two pair, Kings and Jacks)
wiseyoyo: shows [Qh Ac] (two pair, Aces and Jacks)
wiseyoyo collected $233.45 from pot
*** SUMMARY ***
Total pot $236.20 | Rake $2.75 
Board [3c Ah Js 2h Jc]
Seat 1: Iggso folded before Flop (didn't bet)
Seat 2: matiko09 (button) folded before Flop (didn't bet)
Seat 3: T0ny Adams (small blind) folded before Flop
Seat 4: SoNe1988 (big blind) folded before Flop
Seat 6: ersevi6 folded before Flop (didn't bet)
Seat 7: wiseyoyo showed [Qh Ac] and won ($233.45) with two pair, Aces and Jacks
Seat 8: Todox2pesos folded before Flop (didn't bet)
Seat 9: sofiya4 showed [Kc Ks] and lost with two pair, Kings and Jacks





PokerStars Hand #152559704215:  Hold'em No Limit ($0.50/$1.00 USD) - 2016/04/28 15:16:52 CET [2016/04/28 9:16:52 ET]
Table 'Zachia II' 9-max Seat #4 is the button
Seat 1: greyman571 ($137.05 in chips) 
Seat 2: sanpidk ($151.98 in chips) 
Seat 3: matiko09 ($118.82 in chips) 
Seat 4: omorfadramou ($107.43 in chips) 
Seat 5: vrnMike ($103.50 in chips) 
Seat 6: koksskrt ($104.12 in chips) 
Seat 7: ozone2003 ($100 in chips) 
Seat 8: aseban11 ($142.38 in chips) 
Seat 9: Painkiller72 ($100 in chips) 
vrnMike: posts small blind $0.50
koksskrt: posts big blind $1
*** HOLE CARDS ***
Dealt to matiko09 [Kc Jh]
ozone2003: folds 
aseban11: raises $1.50 to $2.50
Painkiller72: folds 
greyman571: folds 
sanpidk: folds 
matiko09: folds 
omorfadramou: folds 
vrnMike: folds 
koksskrt: folds 
Uncalled bet ($1.50) returned to aseban11
aseban11 collected $2.50 from pot
aseban11: doesn't show hand 
*** SUMMARY ***
Total pot $2.50 | Rake $0 
Seat 1: greyman571 folded before Flop (didn't bet)
Seat 2: sanpidk folded before Flop (didn't bet)
Seat 3: matiko09 folded before Flop (didn't bet)
Seat 4: omorfadramou (button) folded before Flop (didn't bet)
Seat 5: vrnMike (small blind) folded before Flop
Seat 6: koksskrt (big blind) folded before Flop
Seat 7: ozone2003 folded before Flop (didn't bet)
Seat 8: aseban11 collected ($2.50)
Seat 9: Painkiller72 folded before Flop (didn't bet)





PokerStars Hand #152559707635:  Hold'em No Limit (€0.50/€1.00 EUR) - 2016/04/28 15:16:58 CET [2016/04/28 9:16:58 ET]
Table 'Lumiere II' 9-max Seat #3 is the button
Seat 1: vrnMike (€149.07 in chips) 
Seat 2: Racushniak (€107.38 in chips) 
Seat 3: maxxmeister (€100 in chips) 
Seat 4: ruslik_by (€57.70 in chips) 
Seat 5: Schmidy7 (€61.70 in chips) 
Seat 6: azzad2007 (€100 in chips) 
Seat 7: hammerwife (€117.18 in chips) 
Seat 8: sanpidk (€104.12 in chips) 
Seat 9: matiko09 (€100 in chips) 
ruslik_by: posts small blind €0.50
Schmidy7: posts big blind €1
*** HOLE CARDS ***
Dealt to matiko09 [5h 6s]
azzad2007: folds 
hammerwife: folds 
sanpidk: folds 
matiko09: folds 
vrnMike: folds 
Racushniak: folds 
maxxmeister: raises €2 to €3
ruslik_by: folds 
Schmidy7: folds 
Uncalled bet (€2) returned to maxxmeister
maxxmeister collected €2.50 from pot
maxxmeister: doesn't show hand 
*** SUMMARY ***
Total pot €2.50 | Rake €0 
Seat 1: vrnMike folded before Flop (didn't bet)
Seat 2: Racushniak folded before Flop (didn't bet)
Seat 3: maxxmeister (button) collected (€2.50)
Seat 4: ruslik_by (small blind) folded before Flop
Seat 5: Schmidy7 (big blind) folded before Flop
Seat 6: azzad2007 folded before Flop (didn't bet)
Seat 7: hammerwife folded before Flop (didn't bet)
Seat 8: sanpidk folded before Flop (didn't bet)
Seat 9: matiko09 folded before Flop (didn't bet)





PokerStars Hand #152559709292:  Hold'em No Limit ($0.50/$1.00 USD) - 2016/04/28 15:17:01 CET [2016/04/28 9:17:01 ET]
Table 'Bruwer' 9-max Seat #6 is the button
Seat 1: aseban11 ($112.61 in chips) 
Seat 2: ruslik_by ($40 in chips) 
Seat 3: koksskrt ($133.51 in chips) 
Seat 4: matiko09 ($138.04 in chips) 
Seat 5: Carloszhang ($110.03 in chips) 
Seat 6: I The King I ($107.52 in chips) 
Seat 7: R1aki ($230.16 in chips) 
Seat 8: lumen21 ($103.50 in chips) 
Seat 9: Dantist1122 ($130.20 in chips) 
R1aki: posts small blind $0.50
lumen21: posts big blind $1
*** HOLE CARDS ***
Dealt to matiko09 [Ac 5d]
Dantist1122: folds 
aseban11: folds 
ruslik_by: folds 
koksskrt: folds 
matiko09: folds 
Carloszhang: folds 
I The King I: raises $1 to $2
R1aki: folds 
lumen21: folds 
Uncalled bet ($1) returned to I The King I
I The King I collected $2.50 from pot
I The King I: doesn't show hand 
*** SUMMARY ***
Total pot $2.50 | Rake $0 
Seat 1: aseban11 folded before Flop (didn't bet)
Seat 2: ruslik_by folded before Flop (didn't bet)
Seat 3: koksskrt folded before Flop (didn't bet)
Seat 4: matiko09 folded before Flop (didn't bet)
Seat 5: Carloszhang folded before Flop (didn't bet)
Seat 6: I The King I (button) collected ($2.50)
Seat 7: R1aki (small blind) folded before Flop
Seat 8: lumen21 (big blind) folded before Flop
Seat 9: Dantist1122 folded before Flop (didn't bet)





PokerStars Hand #152559709612:  Hold'em No Limit ($0.50/$1.00 USD) - 2016/04/28 15:17:02 CET [2016/04/28 9:17:02 ET]
Table 'Ciurlionis' 9-max Seat #5 is the button
Seat 1: sanpidk ($100 in chips) 
Seat 2: liuzhi14 ($62.05 in chips) 
Seat 3: I The King I ($130 in chips) 
Seat 4: ruslik_by ($207 in chips) 
Seat 5: matiko09 ($183.28 in chips) 
Seat 6: vrnMike ($100 in chips) 
Seat 7: Stopton ($92.50 in chips) 
Seat 8: omorfadramou ($100 in chips) 
Seat 9: Painkiller72 ($100 in chips) 
vrnMike: posts small blind $0.50
Stopton: posts big blind $1
*** HOLE CARDS ***
Dealt to matiko09 [9h 5c]
omorfadramou: folds 
Painkiller72: raises $1.50 to $2.50
sanpidk: folds 
liuzhi14: calls $2.50
I The King I: calls $2.50
ruslik_by: folds 
matiko09: folds 
vrnMike: folds 
Stopton: folds 
*** FLOP *** [Th Ts 9c]
Painkiller72: checks 
liuzhi14: checks 
I The King I: checks 
*** TURN *** [Th Ts 9c] [2c]
Painkiller72: checks 
liuzhi14: checks 
I The King I: checks 
*** RIVER *** [Th Ts 9c 2c] [8d]
Painkiller72: bets $5.98
liuzhi14: folds 
I The King I: folds 
Uncalled bet ($5.98) returned to Painkiller72
Painkiller72 collected $8.55 from pot
Painkiller72: doesn't show hand 
*** SUMMARY ***
Total pot $9 | Rake $0.45 
Board [Th Ts 9c 2c 8d]
Seat 1: sanpidk folded before Flop (didn't bet)
Seat 2: liuzhi14 folded on the River
Seat 3: I The King I folded on the River
Seat 4: ruslik_by folded before Flop (didn't bet)
Seat 5: matiko09 (button) folded before Flop (didn't bet)
Seat 6: vrnMike (small blind) folded before Flop
Seat 7: Stopton (big blind) folded before Flop
Seat 8: omorfadramou folded before Flop (didn't bet)
Seat 9: Painkiller72 collected ($8.55)





PokerStars Hand #152559710513:  Hold'em No Limit ($1/$2 USD) - 2016/04/28 15:17:03 CET [2016/04/28 9:17:03 ET]
Table 'Idomeneus II' 9-max Seat #3 is the button
Seat 1: 13Ghosts ($253.11 in chips) 
Seat 2: libbyyww ($353.85 in chips) 
Seat 3: adrenalin333 ($194.61 in chips) 
Seat 4: SoNe1988 ($80 in chips) 
Seat 5: matiko09 ($220.11 in chips) 
Seat 7: ersevi6 ($260.03 in chips) 
Seat 8: di0d80 ($200 in chips) 
SoNe1988: posts small blind $1
matiko09: posts big blind $2
rmanjkeee: sits out 
*** HOLE CARDS ***
Dealt to matiko09 [Tc Qs]
ersevi6: raises $3 to $5
di0d80: folds 
13Ghosts: folds 
libbyyww: folds 
adrenalin333: folds 
SoNe1988: raises $9 to $14
matiko09: folds 
ersevi6: folds 
Uncalled bet ($9) returned to SoNe1988
SoNe1988 collected $12 from pot
SoNe1988: doesn't show hand 
*** SUMMARY ***
Total pot $12 | Rake $0 
Seat 1: 13Ghosts folded before Flop (didn't bet)
Seat 2: libbyyww folded before Flop (didn't bet)
Seat 3: adrenalin333 (button) folded before Flop (didn't bet)
Seat 4: SoNe1988 (small blind) collected ($12)
Seat 5: matiko09 (big blind) folded before Flop
Seat 7: ersevi6 folded before Flop
Seat 8: di0d80 folded before Flop (didn't bet)





PokerStars Hand #152559712818:  Hold'em No Limit (€0.50/€1.00 EUR) - 2016/04/28 15:17:07 CET [2016/04/28 9:17:07 ET]
Table 'Clivia II' 9-max Seat #9 is the button
Seat 1: temujin011 (€98 in chips) 
Seat 3: Racushniak (€100 in chips) 
Seat 4: matiko09 (€114.23 in chips) 
Seat 5: sanpidk (€117.34 in chips) 
Seat 6: ruslik_by (€73.19 in chips) 
Seat 9: ozone2003 (€120.64 in chips) 
temujin011: posts small blind €0.50
HasBigBiceps: is sitting out 
Racushniak: posts big blind €1
*** HOLE CARDS ***
Dealt to matiko09 [Ah 2c]
matiko09: folds 
sanpidk: raises €2 to €3
ruslik_by: folds 
HasBigBiceps leaves the table
ozone2003: calls €3
temujin011: folds 
Racushniak: calls €2
*** FLOP *** [8s 8c Jd]
Racushniak: checks 
sanpidk: checks 
ozone2003: checks 
*** TURN *** [8s 8c Jd] [7h]
Racushniak: bets €4.96
sanpidk: folds 
maxxmeister joins the table at seat #2 
ozone2003: folds 
Uncalled bet (€4.96) returned to Racushniak
Racushniak collected €9.02 from pot
Racushniak: doesn't show hand 
*** SUMMARY ***
Total pot €9.50 | Rake €0.48 
Board [8s 8c Jd 7h]
Seat 1: temujin011 (small blind) folded before Flop
Seat 3: Racushniak (big blind) collected (€9.02)
Seat 4: matiko09 folded before Flop (didn't bet)
Seat 5: sanpidk folded on the Turn
Seat 6: ruslik_by folded before Flop (didn't bet)
Seat 9: ozone2003 (button) folded on the Turn





PokerStars Hand #152559715523:  Hold'em No Limit ($0.50/$1.00 USD) - 2016/04/28 15:17:12 CET [2016/04/28 9:17:12 ET]
Table 'Agapenor III' 9-max Seat #3 is the button
Seat 1: I The King I ($105.17 in chips) 
Seat 2: cerbisor1 ($38.50 in chips) 
Seat 3: sanpidk ($138.13 in chips) 
Seat 4: matiko09 ($100 in chips) 
Seat 5: Painkiller72 ($109.67 in chips) 
Seat 6: azzad2007 ($117.93 in chips) 
Seat 7: tylerz71 ($121.48 in chips) 
Seat 8: Ceanucs ($52.26 in chips) 
Seat 9: DYO1000 ($35.48 in chips) 
matiko09: posts small blind $0.50
Painkiller72: posts big blind $1
*** HOLE CARDS ***
Dealt to matiko09 [Js 3c]
azzad2007: folds 
tylerz71 has timed out
tylerz71: folds 
Ceanucs: raises $1 to $2
DYO1000: folds 
I The King I: folds 
cerbisor1: folds 
sanpidk: folds 
matiko09: folds 
Painkiller72: folds 
Uncalled bet ($1) returned to Ceanucs
Ceanucs collected $2.50 from pot
*** SUMMARY ***
Total pot $2.50 | Rake $0 
Seat 1: I The King I folded before Flop (didn't bet)
Seat 2: cerbisor1 folded before Flop (didn't bet)
Seat 3: sanpidk (button) folded before Flop (didn't bet)
Seat 4: matiko09 (small blind) folded before Flop
Seat 5: Painkiller72 (big blind) folded before Flop
Seat 6: azzad2007 folded before Flop (didn't bet)
Seat 7: tylerz71 folded before Flop (didn't bet)
Seat 8: Ceanucs collected ($2.50)
Seat 9: DYO1000 folded before Flop (didn't bet)





PokerStars Hand #152559723155:  Hold'em No Limit ($0.50/$1.00 USD) - 2016/04/28 15:17:24 CET [2016/04/28 9:17:24 ET]
Table 'Musa II' 9-max Seat #7 is the button
Seat 4: CARLOSXV15 ($108.90 in chips) 
Seat 5: Painkiller72 ($100 in chips) 
Seat 6: skolombi77 ($83.97 in chips) 
Seat 7: ka100pka527 ($40 in chips) 
Seat 8: matiko09 ($100 in chips) 
Seat 9: Moszes360 ($147.08 in chips) 
matiko09: posts small blind $0.50
Moszes360: posts big blind $1
HomerrrJay: sits out 
ozone2003: sits out 
vrnMike: sits out 
*** HOLE CARDS ***
Dealt to matiko09 [Ad 7h]
CARLOSXV15: folds 
Painkiller72: folds 
skolombi77: folds 
ka100pka527: raises $2 to $3
matiko09: folds 
Moszes360: folds 
Uncalled bet ($2) returned to ka100pka527
ka100pka527 collected $2.50 from pot
ka100pka527: doesn't show hand 
*** SUMMARY ***
Total pot $2.50 | Rake $0 
Seat 4: CARLOSXV15 folded before Flop (didn't bet)
Seat 5: Painkiller72 folded before Flop (didn't bet)
Seat 6: skolombi77 folded before Flop (didn't bet)
Seat 7: ka100pka527 (button) collected ($2.50)
Seat 8: matiko09 (small blind) folded before Flop
Seat 9: Moszes360 (big blind) folded before Flop





PokerStars Hand #152559723634:  Hold'em No Limit ($0.50/$1.00 USD) - 2016/04/28 15:17:25 CET [2016/04/28 9:17:25 ET]
Table 'Zachia II' 9-max Seat #5 is the button
Seat 1: greyman571 ($137.05 in chips) 
Seat 2: sanpidk ($151.98 in chips) 
Seat 3: matiko09 ($118.82 in chips) 
Seat 4: omorfadramou ($107.43 in chips) 
Seat 5: vrnMike ($103 in chips) 
Seat 6: koksskrt ($103.12 in chips) 
Seat 7: ozone2003 ($100 in chips) 
Seat 8: aseban11 ($143.88 in chips) 
Seat 9: Painkiller72 ($100 in chips) 
koksskrt: posts small blind $0.50
ozone2003: posts big blind $1
*** HOLE CARDS ***
Dealt to matiko09 [5d 2s]
aseban11: raises $2 to $3
Painkiller72: folds 
greyman571: folds 
sanpidk: folds 
matiko09: folds 
omorfadramou: calls $3
vrnMike: folds 
koksskrt: folds 
ozone2003: folds 
*** FLOP *** [8d Kh 8h]
aseban11: bets $3.56
omorfadramou: calls $3.56
*** TURN *** [8d Kh 8h] [3c]
aseban11: bets $8.50
omorfadramou: calls $8.50
*** RIVER *** [8d Kh 8h 3c] [7h]
aseban11: checks 
omorfadramou: checks 
*** SHOW DOWN ***
aseban11: shows [6c 6s] (two pair, Eights and Sixes)
omorfadramou: mucks hand 
aseban11 collected $30.04 from pot
*** SUMMARY ***
Total pot $31.62 | Rake $1.58 
Board [8d Kh 8h 3c 7h]
Seat 1: greyman571 folded before Flop (didn't bet)
Seat 2: sanpidk folded before Flop (didn't bet)
Seat 3: matiko09 folded before Flop (didn't bet)
Seat 4: omorfadramou mucked [Qd Ac]
Seat 5: vrnMike (button) folded before Flop (didn't bet)
Seat 6: koksskrt (small blind) folded before Flop
Seat 7: ozone2003 (big blind) folded before Flop
Seat 8: aseban11 showed [6c 6s] and won ($30.04) with two pair, Eights and Sixes
Seat 9: Painkiller72 folded before Flop (didn't bet)





PokerStars Hand #152559723918:  Hold'em No Limit (€0.50/€1.00 EUR) - 2016/04/28 15:17:26 CET [2016/04/28 9:17:26 ET]
Table 'Lumiere II' 9-max Seat #4 is the button
Seat 1: vrnMike (€149.07 in chips) 
Seat 2: Racushniak (€107.38 in chips) 
Seat 3: maxxmeister (€101.50 in chips) 
Seat 4: ruslik_by (€57.20 in chips) 
Seat 5: Schmidy7 (€60.70 in chips) 
Seat 6: azzad2007 (€100 in chips) 
Seat 7: hammerwife (€117.18 in chips) 
Seat 8: sanpidk (€104.12 in chips) 
Seat 9: matiko09 (€100 in chips) 
Schmidy7: posts small blind €0.50
azzad2007: posts big blind €1
*** HOLE CARDS ***
Dealt to matiko09 [8s 8h]
hammerwife: folds 
sanpidk: folds 
matiko09: raises €2 to €3
vrnMike: calls €3
Racushniak: folds 
maxxmeister: folds 
ruslik_by: folds 
Schmidy7: folds 
azzad2007: folds 
*** FLOP *** [Kc Js 7c]
matiko09: checks 
vrnMike: checks 
*** TURN *** [Kc Js 7c] [4d]
matiko09: checks 
vrnMike: checks 
*** RIVER *** [Kc Js 7c 4d] [Ks]
matiko09: checks 
vrnMike: checks 
*** SHOW DOWN ***
matiko09: shows [8s 8h] (two pair, Kings and Eights)
vrnMike: shows [9c 9s] (two pair, Kings and Nines)
vrnMike collected €7.12 from pot
*** SUMMARY ***
Total pot €7.50 | Rake €0.38 
Board [Kc Js 7c 4d Ks]
Seat 1: vrnMike showed [9c 9s] and won (€7.12) with two pair, Kings and Nines
Seat 2: Racushniak folded before Flop (didn't bet)
Seat 3: maxxmeister folded before Flop (didn't bet)
Seat 4: ruslik_by (button) folded before Flop (didn't bet)
Seat 5: Schmidy7 (small blind) folded before Flop
Seat 6: azzad2007 (big blind) folded before Flop
Seat 7: hammerwife folded before Flop (didn't bet)
Seat 8: sanpidk folded before Flop (didn't bet)
Seat 9: matiko09 showed [8s 8h] and lost with two pair, Kings and Eights





PokerStars Hand #152559729772:  Hold'em No Limit ($0.50/$1.00 USD) - 2016/04/28 15:17:36 CET [2016/04/28 9:17:36 ET]
Table 'Erynia' 9-max Seat #7 is the button
Seat 1: I The King I ($100 in chips) 
Seat 2: matiko09 ($141.32 in chips) 
Seat 4: omorfadramou ($110.68 in chips) 
Seat 5: RMilPoker ($107.18 in chips) 
Seat 6: peevoajax ($100 in chips) 
Seat 7: vrnMike ($116.74 in chips) 
Seat 8: YourKicker78 ($63.27 in chips) 
Seat 9: ruslik_by ($50.61 in chips) 
YourKicker78: posts small blind $0.50
ruslik_by: posts big blind $1
vilo1070: sits out 
*** HOLE CARDS ***
Dealt to matiko09 [5s Qc]
I The King I: folds 
matiko09: folds 
omorfadramou: folds 
RMilPoker: folds 
peevoajax: folds 
vrnMike: raises $2 to $3
YourKicker78: folds 
ruslik_by: raises $6 to $9
vrnMike: folds 
Uncalled bet ($6) returned to ruslik_by
ruslik_by collected $6.50 from pot
ruslik_by: doesn't show hand 
*** SUMMARY ***
Total pot $6.50 | Rake $0 
Seat 1: I The King I folded before Flop (didn't bet)
Seat 2: matiko09 folded before Flop (didn't bet)
Seat 4: omorfadramou folded before Flop (didn't bet)
Seat 5: RMilPoker folded before Flop (didn't bet)
Seat 6: peevoajax folded before Flop (didn't bet)
Seat 7: vrnMike (button) folded before Flop
Seat 8: YourKicker78 (small blind) folded before Flop
Seat 9: ruslik_by (big blind) collected ($6.50)





PokerStars Hand #152559731588:  Hold'em No Limit ($0.50/$1.00 USD) - 2016/04/28 15:17:39 CET [2016/04/28 9:17:39 ET]
Table 'Bruwer' 9-max Seat #7 is the button
Seat 1: aseban11 ($112.61 in chips) 
Seat 2: ruslik_by ($40 in chips) 
Seat 3: koksskrt ($133.51 in chips) 
Seat 4: matiko09 ($138.04 in chips) 
Seat 5: Carloszhang ($110.03 in chips) 
Seat 6: I The King I ($109.02 in chips) 
Seat 7: R1aki ($229.66 in chips) 
Seat 8: lumen21 ($102.50 in chips) 
Seat 9: Dantist1122 ($130.20 in chips) 
lumen21: posts small blind $0.50
Dantist1122: posts big blind $1
*** HOLE CARDS ***
Dealt to matiko09 [8h Jd]
aseban11: folds 
ruslik_by: folds 
koksskrt: folds 
matiko09: folds 
Carloszhang: folds 
I The King I: folds 
R1aki: folds 
lumen21: raises $1.50 to $2.50
Dantist1122: folds 
Uncalled bet ($1.50) returned to lumen21
lumen21 collected $2 from pot
lumen21: doesn't show hand 
*** SUMMARY ***
Total pot $2 | Rake $0 
Seat 1: aseban11 folded before Flop (didn't bet)
Seat 2: ruslik_by folded before Flop (didn't bet)
Seat 3: koksskrt folded before Flop (didn't bet)
Seat 4: matiko09 folded before Flop (didn't bet)
Seat 5: Carloszhang folded before Flop (didn't bet)
Seat 6: I The King I folded before Flop (didn't bet)
Seat 7: R1aki (button) folded before Flop (didn't bet)
Seat 8: lumen21 (small blind) collected ($2)
Seat 9: Dantist1122 (big blind) folded before Flop





PokerStars Hand #152559735423:  Hold'em No Limit ($1/$2 USD) - 2016/04/28 15:17:45 CET [2016/04/28 9:17:45 ET]
Table 'Idomeneus II' 9-max Seat #4 is the button
Seat 1: 13Ghosts ($253.11 in chips) 
Seat 2: libbyyww ($353.85 in chips) 
Seat 3: adrenalin333 ($194.61 in chips) 
Seat 4: SoNe1988 ($87 in chips) 
Seat 5: matiko09 ($218.11 in chips) 
Seat 6: rmanjkeee ($80 in chips) 
Seat 7: ersevi6 ($255.03 in chips) 
Seat 8: di0d80 ($200 in chips) 
matiko09: posts small blind $1
rmanjkeee: posts big blind $2
*** HOLE CARDS ***
Dealt to matiko09 [Kd 3s]
ersevi6: folds 
di0d80: folds 
13Ghosts: folds 
libbyyww: raises $4 to $6
adrenalin333: calls $6
SoNe1988: folds 
matiko09: folds 
rmanjkeee: folds 
*** FLOP *** [9s 6h Qd]
libbyyww: bets $10.68
adrenalin333 is disconnected 
adrenalin333 is connected 
adrenalin333: calls $10.68
*** TURN *** [9s 6h Qd] [Jc]
libbyyww: checks 
adrenalin333: bets $18
libbyyww: calls $18
*** RIVER *** [9s 6h Qd Jc] [7d]
libbyyww: checks 
adrenalin333: checks 
*** SHOW DOWN ***
libbyyww: shows [Kc Qc] (a pair of Queens)
adrenalin333: mucks hand 
libbyyww collected $69.61 from pot
*** SUMMARY ***
Total pot $72.36 | Rake $2.75 
Board [9s 6h Qd Jc 7d]
Seat 1: 13Ghosts folded before Flop (didn't bet)
Seat 2: libbyyww showed [Kc Qc] and won ($69.61) with a pair of Queens
Seat 3: adrenalin333 mucked [Ac Kh]
Seat 4: SoNe1988 (button) folded before Flop (didn't bet)
Seat 5: matiko09 (small blind) folded before Flop
Seat 6: rmanjkeee (big blind) folded before Flop
Seat 7: ersevi6 folded before Flop (didn't bet)
Seat 8: di0d80 folded before Flop (didn't bet)





PokerStars Hand #152559737130:  Hold'em No Limit ($0.50/$1.00 USD) - 2016/04/28 15:17:48 CET [2016/04/28 9:17:48 ET]
Table 'Musa II' 9-max Seat #8 is the button
Seat 1: HomerrrJay ($100 in chips) 
Seat 4: CARLOSXV15 ($108.90 in chips) 
Seat 5: Painkiller72 ($100 in chips) 
Seat 6: skolombi77 ($83.97 in chips) 
Seat 7: ka100pka527 ($41.50 in chips) 
Seat 8: matiko09 ($100 in chips) 
Seat 9: Moszes360 ($146.08 in chips) 
Moszes360: posts small blind $0.50
HomerrrJay: posts big blind $1
ozone2003: sits out 
vrnMike: sits out 
*** HOLE CARDS ***
Dealt to matiko09 [5s Ac]
CARLOSXV15: raises $1 to $2
Painkiller72: calls $2
skolombi77: folds 
ka100pka527: folds 
matiko09: folds 
Moszes360: folds 
HomerrrJay: folds 
*** FLOP *** [8h Qs Td]
CARLOSXV15: checks 
Painkiller72: checks 
*** TURN *** [8h Qs Td] [9c]
CARLOSXV15: bets $3
Painkiller72: folds 
Uncalled bet ($3) returned to CARLOSXV15
CARLOSXV15 collected $5.22 from pot
CARLOSXV15: doesn't show hand 
*** SUMMARY ***
Total pot $5.50 | Rake $0.28 
Board [8h Qs Td 9c]
Seat 1: HomerrrJay (big blind) folded before Flop
Seat 4: CARLOSXV15 collected ($5.22)
Seat 5: Painkiller72 folded on the Turn
Seat 6: skolombi77 folded before Flop (didn't bet)
Seat 7: ka100pka527 folded before Flop (didn't bet)
Seat 8: matiko09 (button) folded before Flop (didn't bet)
Seat 9: Moszes360 (small blind) folded before Flop





PokerStars Hand #152559750633:  Hold'em No Limit (€0.50/€1.00 EUR) - 2016/04/28 15:18:11 CET [2016/04/28 9:18:11 ET]
Table 'Clivia II' 9-max Seat #1 is the button
Seat 1: temujin011 (€97.50 in chips) 
Seat 3: Racushniak (€106.02 in chips) 
Seat 4: matiko09 (€114.23 in chips) 
Seat 5: sanpidk (€114.34 in chips) 
Seat 6: ruslik_by (€73.19 in chips) 
Seat 9: ozone2003 (€117.64 in chips) 
maxxmeister will be allowed to play after the button
Racushniak: posts small blind €0.50
matiko09: posts big blind €1
*** HOLE CARDS ***
Dealt to matiko09 [Ks Ac]
sanpidk: folds 
ruslik_by: folds 
ozone2003: folds 
temujin011: raises €1.40 to €2.40
Racushniak: folds 
matiko09: raises €6.60 to €9
temujin011: folds 
Uncalled bet (€6.60) returned to matiko09
matiko09 collected €5.30 from pot
matiko09: doesn't show hand 
*** SUMMARY ***
Total pot €5.30 | Rake €0 
Seat 1: temujin011 (button) folded before Flop
Seat 3: Racushniak (small blind) folded before Flop
Seat 4: matiko09 (big blind) collected (€5.30)
Seat 5: sanpidk folded before Flop (didn't bet)
Seat 6: ruslik_by folded before Flop (didn't bet)
Seat 9: ozone2003 folded before Flop (didn't bet)





PokerStars Hand #152559753998:  Hold'em No Limit ($0.50/$1.00 USD) - 2016/04/28 15:18:17 CET [2016/04/28 9:18:17 ET]
Table 'Agapenor III' 9-max Seat #4 is the button
Seat 1: I The King I ($105.17 in chips) 
Seat 2: cerbisor1 ($38.50 in chips) 
Seat 3: sanpidk ($138.13 in chips) 
Seat 4: matiko09 ($100 in chips) 
Seat 5: Painkiller72 ($108.67 in chips) 
Seat 6: azzad2007 ($117.93 in chips) 
Seat 8: Ceanucs ($53.76 in chips) 
Seat 9: DYO1000 ($35.48 in chips) 
Painkiller72: posts small blind $0.50
azzad2007: posts big blind $1
*** HOLE CARDS ***
Dealt to matiko09 [Ad Jc]
Ceanucs: folds 
DYO1000: folds 
I The King I: folds 
cerbisor1: folds 
sanpidk: raises $1.50 to $2.50
matiko09: calls $2.50
Painkiller72: folds 
azzad2007: folds 
*** FLOP *** [9d Qd 6h]
sanpidk: bets $4
matiko09: calls $4
*** TURN *** [9d Qd 6h] [Qh]
sanpidk: checks 
matiko09: checks 
*** RIVER *** [9d Qd 6h Qh] [5d]
sanpidk: checks 
matiko09: checks 
*** SHOW DOWN ***
sanpidk: shows [3d 3s] (two pair, Queens and Threes)
matiko09: mucks hand 
sanpidk collected $13.78 from pot
*** SUMMARY ***
Total pot $14.50 | Rake $0.72 
Board [9d Qd 6h Qh 5d]
Seat 1: I The King I folded before Flop (didn't bet)
Seat 2: cerbisor1 folded before Flop (didn't bet)
Seat 3: sanpidk showed [3d 3s] and won ($13.78) with two pair, Queens and Threes
Seat 4: matiko09 (button) mucked [Ad Jc]
Seat 5: Painkiller72 (small blind) folded before Flop
Seat 6: azzad2007 (big blind) folded before Flop
Seat 8: Ceanucs folded before Flop (didn't bet)
Seat 9: DYO1000 folded before Flop (didn't bet)





PokerStars Hand #152559758343:  Hold'em No Limit (€0.50/€1.00 EUR) - 2016/04/28 15:18:24 CET [2016/04/28 9:18:24 ET]
Table 'Lumiere II' 9-max Seat #5 is the button
Seat 1: vrnMike (€153.19 in chips) 
Seat 2: Racushniak (€107.38 in chips) 
Seat 3: maxxmeister (€101.50 in chips) 
Seat 4: ruslik_by (€57.20 in chips) 
Seat 5: Schmidy7 (€60.20 in chips) 
Seat 6: azzad2007 (€99 in chips) 
Seat 7: hammerwife (€117.18 in chips) 
Seat 8: sanpidk (€104.12 in chips) 
Seat 9: matiko09 (€100 in chips) 
azzad2007: posts small blind €0.50
hammerwife: posts big blind €1
*** HOLE CARDS ***
Dealt to matiko09 [6s 8h]
sanpidk: raises €2 to €3
matiko09: folds 
vrnMike: folds 
Racushniak: folds 
maxxmeister: folds 
ruslik_by: folds 
Schmidy7: folds 
azzad2007: folds 
hammerwife: folds 
Uncalled bet (€2) returned to sanpidk
sanpidk collected €2.50 from pot
sanpidk: doesn't show hand 
*** SUMMARY ***
Total pot €2.50 | Rake €0 
Seat 1: vrnMike folded before Flop (didn't bet)
Seat 2: Racushniak folded before Flop (didn't bet)
Seat 3: maxxmeister folded before Flop (didn't bet)
Seat 4: ruslik_by folded before Flop (didn't bet)
Seat 5: Schmidy7 (button) folded before Flop (didn't bet)
Seat 6: azzad2007 (small blind) folded before Flop
Seat 7: hammerwife (big blind) folded before Flop
Seat 8: sanpidk collected (€2.50)
Seat 9: matiko09 folded before Flop (didn't bet)





PokerStars Hand #152559759217:  Hold'em No Limit ($0.50/$1.00 USD) - 2016/04/28 15:18:26 CET [2016/04/28 9:18:26 ET]
Table 'Musa II' 9-max Seat #9 is the button
Seat 1: HomerrrJay ($100 in chips) 
Seat 2: ozone2003 ($100 in chips) 
Seat 4: CARLOSXV15 ($112.12 in chips) 
Seat 5: Painkiller72 ($100 in chips) 
Seat 6: skolombi77 ($83.97 in chips) 
Seat 7: ka100pka527 ($41.50 in chips) 
Seat 8: matiko09 ($100 in chips) 
Seat 9: Moszes360 ($145.58 in chips) 
HomerrrJay: posts small blind $0.50
ozone2003: posts big blind $1
vrnMike: sits out 
*** HOLE CARDS ***
Dealt to matiko09 [8d Kc]
CARLOSXV15: raises $1 to $2
Painkiller72: raises $5.50 to $7.50
skolombi77: folds 
ka100pka527: folds 
matiko09: folds 
Moszes360: folds 
HomerrrJay: folds 
ozone2003: folds 
CARLOSXV15: calls $5.50
*** FLOP *** [2c Ah 6c]
CARLOSXV15: checks 
Painkiller72: bets $8.50
CARLOSXV15: calls $8.50
*** TURN *** [2c Ah 6c] [7d]
CARLOSXV15: checks 
Painkiller72: checks 
*** RIVER *** [2c Ah 6c 7d] [3h]
CARLOSXV15: checks 
Painkiller72: checks 
*** SHOW DOWN ***
CARLOSXV15: shows [9c 9h] (a pair of Nines)
Painkiller72: mucks hand 
CARLOSXV15 collected $31.82 from pot
*** SUMMARY ***
Total pot $33.50 | Rake $1.68 
Board [2c Ah 6c 7d 3h]
Seat 1: HomerrrJay (small blind) folded before Flop
Seat 2: ozone2003 (big blind) folded before Flop
Seat 4: CARLOSXV15 showed [9c 9h] and won ($31.82) with a pair of Nines
Seat 5: Painkiller72 mucked [Jc Ks]
Seat 6: skolombi77 folded before Flop (didn't bet)
Seat 7: ka100pka527 folded before Flop (didn't bet)
Seat 8: matiko09 folded before Flop (didn't bet)
Seat 9: Moszes360 (button) folded before Flop (didn't bet)





PokerStars Hand #152559760661:  Hold'em No Limit ($0.50/$1.00 USD) - 2016/04/28 15:18:28 CET [2016/04/28 9:18:28 ET]
Table 'Bruwer' 9-max Seat #8 is the button
Seat 2: ruslik_by ($40 in chips) 
Seat 3: koksskrt ($133.51 in chips) 
Seat 4: matiko09 ($138.04 in chips) 
Seat 5: Carloszhang ($110.03 in chips) 
Seat 6: I The King I ($109.02 in chips) 
Seat 7: R1aki ($229.66 in chips) 
Seat 8: lumen21 ($103.50 in chips) 
Seat 9: Dantist1122 ($129.20 in chips) 
Dantist1122: posts small blind $0.50
aseban11: is sitting out 
ruslik_by: posts big blind $1
*** HOLE CARDS ***
Dealt to matiko09 [6h Jc]
aseban11 leaves the table
koksskrt: folds 
di0d80 joins the table at seat #1 
di0d80 leaves the table
peevoajax joins the table at seat #1 
matiko09: folds 
Carloszhang: folds 
I The King I: folds 
R1aki: folds 
lumen21 has timed out
lumen21: folds 
Dantist1122: raises $1.05 to $2.05
ruslik_by: calls $1.05
*** FLOP *** [Ks 5c Kd]
Dantist1122: checks 
ruslik_by: bets $1.80
Dantist1122: folds 
Uncalled bet ($1.80) returned to ruslik_by
ruslik_by collected $3.90 from pot
ruslik_by: doesn't show hand 
*** SUMMARY ***
Total pot $4.10 | Rake $0.20 
Board [Ks 5c Kd]
Seat 2: ruslik_by (big blind) collected ($3.90)
Seat 3: koksskrt folded before Flop (didn't bet)
Seat 4: matiko09 folded before Flop (didn't bet)
Seat 5: Carloszhang folded before Flop (didn't bet)
Seat 6: I The King I folded before Flop (didn't bet)
Seat 7: R1aki folded before Flop (didn't bet)
Seat 8: lumen21 (button) folded before Flop (didn't bet)
Seat 9: Dantist1122 (small blind) folded on the Flop





PokerStars Hand #152559762761:  Hold'em No Limit ($0.50/$1.00 USD) - 2016/04/28 15:18:31 CET [2016/04/28 9:18:31 ET]
Table 'Erynia' 9-max Seat #8 is the button
Seat 1: I The King I ($100 in chips) 
Seat 2: matiko09 ($141.32 in chips) 
Seat 4: omorfadramou ($110.68 in chips) 
Seat 5: RMilPoker ($107.18 in chips) 
Seat 6: peevoajax ($100 in chips) 
Seat 7: vrnMike ($113.74 in chips) 
Seat 8: YourKicker78 ($62.77 in chips) 
Seat 9: ruslik_by ($54.11 in chips) 
ruslik_by: posts small blind $0.50
I The King I: posts big blind $1
vilo1070: sits out 
*** HOLE CARDS ***
Dealt to matiko09 [Kd Js]
matiko09: folds 
omorfadramou: folds 
RMilPoker: raises $2 to $3
peevoajax: folds 
vrnMike: folds 
YourKicker78: folds 
ruslik_by: folds 
I The King I: folds 
Uncalled bet ($2) returned to RMilPoker
RMilPoker collected $2.50 from pot
RMilPoker: doesn't show hand 
*** SUMMARY ***
Total pot $2.50 | Rake $0 
Seat 1: I The King I (big blind) folded before Flop
Seat 2: matiko09 folded before Flop (didn't bet)
Seat 4: omorfadramou folded before Flop (didn't bet)
Seat 5: RMilPoker collected ($2.50)
Seat 6: peevoajax folded before Flop (didn't bet)
Seat 7: vrnMike folded before Flop (didn't bet)
Seat 8: YourKicker78 (button) folded before Flop (didn't bet)
Seat 9: ruslik_by (small blind) folded before Flop





PokerStars Hand #152559766694:  Hold'em No Limit ($1/$2 USD) - 2016/04/28 15:18:38 CET [2016/04/28 9:18:38 ET]
Table 'Hakone II' 9-max Seat #3 is the button
Seat 1: Iggso ($200 in chips) 
Seat 2: matiko09 ($212 in chips) 
Seat 3: T0ny Adams ($80 in chips) 
Seat 4: SoNe1988 ($112.42 in chips) 
Seat 6: ersevi6 ($77 in chips) 
Seat 7: wiseyoyo ($324.20 in chips) 
Seat 8: Todox2pesos ($197 in chips) 
SoNe1988: posts small blind $1
ersevi6: posts big blind $2
*** HOLE CARDS ***
Dealt to matiko09 [4s 3h]
wiseyoyo: folds 
Todox2pesos: folds 
Iggso: folds 
matiko09: folds 
T0ny Adams: folds 
SoNe1988: folds 
Uncalled bet ($1) returned to ersevi6
ersevi6 collected $2 from pot
ersevi6: doesn't show hand 
*** SUMMARY ***
Total pot $2 | Rake $0 
Seat 1: Iggso folded before Flop (didn't bet)
Seat 2: matiko09 folded before Flop (didn't bet)
Seat 3: T0ny Adams (button) folded before Flop (didn't bet)
Seat 4: SoNe1988 (small blind) folded before Flop
Seat 6: ersevi6 (big blind) collected ($2)
Seat 7: wiseyoyo folded before Flop (didn't bet)
Seat 8: Todox2pesos folded before Flop (didn't bet)





PokerStars Hand #152559769123:  Hold'em No Limit ($0.50/$1.00 USD) - 2016/04/28 15:18:42 CET [2016/04/28 9:18:42 ET]
Table 'Zachia II' 9-max Seat #6 is the button
Seat 1: greyman571 ($137.05 in chips) 
Seat 2: sanpidk ($151.98 in chips) 
Seat 3: matiko09 ($118.82 in chips) 
Seat 4: omorfadramou ($100 in chips) 
Seat 5: vrnMike ($103 in chips) 
Seat 6: koksskrt ($102.62 in chips) 
Seat 7: ozone2003 ($100 in chips) 
Seat 9: Painkiller72 ($100 in chips) 
ozone2003: posts small blind $0.50
aseban11: is sitting out 
Painkiller72: posts big blind $1
*** HOLE CARDS ***
Dealt to matiko09 [4s 6h]
aseban11 leaves the table
I The King I joins the table at seat #8 
I The King I leaves the table
greyman571: raises $2 to $3
sanpidk: folds 
matiko09: folds 
omorfadramou: folds 
vrnMike: folds 
koksskrt: folds 
ozone2003: folds 
Painkiller72: folds 
Uncalled bet ($2) returned to greyman571
greyman571 collected $2.50 from pot
greyman571: doesn't show hand 
*** SUMMARY ***
Total pot $2.50 | Rake $0 
Seat 1: greyman571 collected ($2.50)
Seat 2: sanpidk folded before Flop (didn't bet)
Seat 3: matiko09 folded before Flop (didn't bet)
Seat 4: omorfadramou folded before Flop (didn't bet)
Seat 5: vrnMike folded before Flop (didn't bet)
Seat 6: koksskrt (button) folded before Flop (didn't bet)
Seat 7: ozone2003 (small blind) folded before Flop
Seat 9: Painkiller72 (big blind) folded before Flop





PokerStars Hand #152559770962:  Hold'em No Limit ($0.50/$1.00 USD) - 2016/04/28 15:18:45 CET [2016/04/28 9:18:45 ET]
Table 'Ciurlionis' 9-max Seat #6 is the button
Seat 1: sanpidk ($100 in chips) 
Seat 2: liuzhi14 ($59.55 in chips) 
Seat 3: I The King I ($127.50 in chips) 
Seat 4: ruslik_by ($207 in chips) 
Seat 5: matiko09 ($183.28 in chips) 
Seat 6: vrnMike ($100 in chips) 
Seat 7: Stopton ($91.50 in chips) 
Seat 8: omorfadramou ($100 in chips) 
Seat 9: Painkiller72 ($106.05 in chips) 
Stopton: posts small blind $0.50
omorfadramou: posts big blind $1
*** HOLE CARDS ***
Dealt to matiko09 [8h 4h]
Painkiller72: folds 
sanpidk: folds 
liuzhi14: calls $1
I The King I: folds 
ruslik_by: folds 
matiko09: folds 
vrnMike: folds 
Stopton: calls $0.50
omorfadramou: checks 
*** FLOP *** [7d Ah Ad]
Stopton: checks 
omorfadramou: checks 
liuzhi14: checks 
*** TURN *** [7d Ah Ad] [3s]
Stopton: checks 
omorfadramou: checks 
liuzhi14: checks 
*** RIVER *** [7d Ah Ad 3s] [7c]
Stopton: checks 
omorfadramou: checks 
liuzhi14: checks 
*** SHOW DOWN ***
Stopton: shows [7s Td] (a full house, Sevens full of Aces)
omorfadramou: mucks hand 
liuzhi14: mucks hand 
Stopton collected $2.85 from pot
*** SUMMARY ***
Total pot $3 | Rake $0.15 
Board [7d Ah Ad 3s 7c]
Seat 1: sanpidk folded before Flop (didn't bet)
Seat 2: liuzhi14 mucked [Kd Tc]
Seat 3: I The King I folded before Flop (didn't bet)
Seat 4: ruslik_by folded before Flop (didn't bet)
Seat 5: matiko09 folded before Flop (didn't bet)
Seat 6: vrnMike (button) folded before Flop (didn't bet)
Seat 7: Stopton (small blind) showed [7s Td] and won ($2.85) with a full house, Sevens full of Aces
Seat 8: omorfadramou (big blind) mucked [6d Qc]
Seat 9: Painkiller72 folded before Flop (didn't bet)





PokerStars Hand #152559773179:  Hold'em No Limit (€0.50/€1.00 EUR) - 2016/04/28 15:18:49 CET [2016/04/28 9:18:49 ET]
Table 'Lumiere II' 9-max Seat #6 is the button
Seat 1: vrnMike (€153.19 in chips) 
Seat 2: Racushniak (€107.38 in chips) 
Seat 3: maxxmeister (€101.50 in chips) 
Seat 4: ruslik_by (€57.20 in chips) 
Seat 5: Schmidy7 (€60.20 in chips) 
Seat 6: azzad2007 (€98.50 in chips) 
Seat 7: hammerwife (€116.18 in chips) 
Seat 8: sanpidk (€105.62 in chips) 
Seat 9: matiko09 (€100 in chips) 
hammerwife: posts small blind €0.50
sanpidk: posts big blind €1
*** HOLE CARDS ***
Dealt to matiko09 [5c 3d]
matiko09: folds 
vrnMike: folds 
Racushniak: folds 
maxxmeister: folds 
ruslik_by: folds 
Schmidy7: folds 
azzad2007: folds 
hammerwife: folds 
Uncalled bet (€0.50) returned to sanpidk
sanpidk collected €1 from pot
sanpidk: doesn't show hand 
*** SUMMARY ***
Total pot €1 | Rake €0 
Seat 1: vrnMike folded before Flop (didn't bet)
Seat 2: Racushniak folded before Flop (didn't bet)
Seat 3: maxxmeister folded before Flop (didn't bet)
Seat 4: ruslik_by folded before Flop (didn't bet)
Seat 5: Schmidy7 folded before Flop (didn't bet)
Seat 6: azzad2007 (button) folded before Flop (didn't bet)
Seat 7: hammerwife (small blind) folded before Flop
Seat 8: sanpidk (big blind) collected (€1)
Seat 9: matiko09 folded before Flop (didn't bet)





PokerStars Hand #152559774530:  Hold'em No Limit (€0.50/€1.00 EUR) - 2016/04/28 15:18:51 CET [2016/04/28 9:18:51 ET]
Table 'Clivia II' 9-max Seat #3 is the button
Seat 1: temujin011 (€95.10 in chips) 
Seat 3: Racushniak (€105.52 in chips) 
Seat 4: matiko09 (€117.13 in chips) 
Seat 5: sanpidk (€114.34 in chips) 
Seat 6: ruslik_by (€73.19 in chips) 
Seat 9: ozone2003 (€117.64 in chips) 
matiko09: posts small blind €0.50
sanpidk: posts big blind €1
maxxmeister: sits out 
*** HOLE CARDS ***
Dealt to matiko09 [2h 3d]
ruslik_by: folds 
ozone2003: raises €2 to €3
temujin011: folds 
Racushniak: folds 
matiko09: folds 
sanpidk: folds 
Uncalled bet (€2) returned to ozone2003
ozone2003 collected €2.50 from pot
ozone2003: doesn't show hand 
*** SUMMARY ***
Total pot €2.50 | Rake €0 
Seat 1: temujin011 folded before Flop (didn't bet)
Seat 3: Racushniak (button) folded before Flop (didn't bet)
Seat 4: matiko09 (small blind) folded before Flop
Seat 5: sanpidk (big blind) folded before Flop
Seat 6: ruslik_by folded before Flop (didn't bet)
Seat 9: ozone2003 collected (€2.50)





PokerStars Hand #152559776924:  Hold'em No Limit ($1/$2 USD) - 2016/04/28 15:18:55 CET [2016/04/28 9:18:55 ET]
Table 'Hakone II' 9-max Seat #4 is the button
Seat 1: Iggso ($200 in chips) 
Seat 2: matiko09 ($212 in chips) 
Seat 3: T0ny Adams ($80 in chips) 
Seat 4: SoNe1988 ($111.42 in chips) 
Seat 6: ersevi6 ($78 in chips) 
Seat 7: wiseyoyo ($324.20 in chips) 
Seat 8: Todox2pesos ($197 in chips) 
ersevi6: posts small blind $1
wiseyoyo: posts big blind $2
*** HOLE CARDS ***
Dealt to matiko09 [7s 2d]
sofiya4 leaves the table
I The King I joins the table at seat #9 
Todox2pesos: folds 
Iggso: folds 
I The King I leaves the table
matiko09: folds 
XKTTBOBV11 leaves the table
T0ny Adams: raises $2.68 to $4.68
SoNe1988: folds 
CI58 joins the table at seat #9 
ersevi6: folds 
CI58 leaves the table
wiseyoyo: folds 
Uncalled bet ($2.68) returned to T0ny Adams
T0ny Adams collected $5 from pot
T0ny Adams: doesn't show hand 
*** SUMMARY ***
Total pot $5 | Rake $0 
Seat 1: Iggso folded before Flop (didn't bet)
Seat 2: matiko09 folded before Flop (didn't bet)
Seat 3: T0ny Adams collected ($5)
Seat 4: SoNe1988 (button) folded before Flop (didn't bet)
Seat 6: ersevi6 (small blind) folded before Flop
Seat 7: wiseyoyo (big blind) folded before Flop
Seat 8: Todox2pesos folded before Flop (didn't bet)





PokerStars Hand #152559783721:  Hold'em No Limit ($0.50/$1.00 USD) - 2016/04/28 15:19:07 CET [2016/04/28 9:19:07 ET]
Table 'Erynia' 9-max Seat #9 is the button
Seat 1: I The King I ($100 in chips) 
Seat 2: matiko09 ($141.32 in chips) 
Seat 4: omorfadramou ($110.68 in chips) 
Seat 5: RMilPoker ($108.68 in chips) 
Seat 6: peevoajax ($100 in chips) 
Seat 7: vrnMike ($113.74 in chips) 
Seat 8: YourKicker78 ($62.77 in chips) 
Seat 9: ruslik_by ($53.61 in chips) 
I The King I: posts small blind $0.50
matiko09: posts big blind $1
vilo1070: sits out 
*** HOLE CARDS ***
Dealt to matiko09 [9h Tc]
omorfadramou: folds 
RMilPoker: folds 
peevoajax: folds 
vrnMike: folds 
YourKicker78: raises $2 to $3
ruslik_by: folds 
I The King I: folds 
matiko09: folds 
Uncalled bet ($2) returned to YourKicker78
YourKicker78 collected $2.50 from pot
YourKicker78: doesn't show hand 
*** SUMMARY ***
Total pot $2.50 | Rake $0 
Seat 1: I The King I (small blind) folded before Flop
Seat 2: matiko09 (big blind) folded before Flop
Seat 4: omorfadramou folded before Flop (didn't bet)
Seat 5: RMilPoker folded before Flop (didn't bet)
Seat 6: peevoajax folded before Flop (didn't bet)
Seat 7: vrnMike folded before Flop (didn't bet)
Seat 8: YourKicker78 collected ($2.50)
Seat 9: ruslik_by (button) folded before Flop (didn't bet)





PokerStars Hand #152559788543:  Hold'em No Limit (€0.50/€1.00 EUR) - 2016/04/28 15:19:15 CET [2016/04/28 9:19:15 ET]
Table 'Lumiere II' 9-max Seat #7 is the button
Seat 1: vrnMike (€153.19 in chips) 
Seat 2: Racushniak (€107.38 in chips) 
Seat 3: maxxmeister (€101.50 in chips) 
Seat 4: ruslik_by (€57.20 in chips) 
Seat 5: Schmidy7 (€60.20 in chips) 
Seat 6: azzad2007 (€98.50 in chips) 
Seat 7: hammerwife (€115.68 in chips) 
Seat 8: sanpidk (€106.12 in chips) 
Seat 9: matiko09 (€100 in chips) 
sanpidk: posts small blind €0.50
matiko09: posts big blind €1
*** HOLE CARDS ***
Dealt to matiko09 [2s Ks]
vrnMike: folds 
Racushniak: raises €2 to €3
maxxmeister: folds 
ruslik_by: folds 
Schmidy7: folds 
azzad2007: folds 
hammerwife: raises €6 to €9
sanpidk: folds 
matiko09: folds 
Racushniak: folds 
Uncalled bet (€6) returned to hammerwife
hammerwife collected €7.50 from pot
hammerwife: doesn't show hand 
*** SUMMARY ***
Total pot €7.50 | Rake €0 
Seat 1: vrnMike folded before Flop (didn't bet)
Seat 2: Racushniak folded before Flop
Seat 3: maxxmeister folded before Flop (didn't bet)
Seat 4: ruslik_by folded before Flop (didn't bet)
Seat 5: Schmidy7 folded before Flop (didn't bet)
Seat 6: azzad2007 folded before Flop (didn't bet)
Seat 7: hammerwife (button) collected (€7.50)
Seat 8: sanpidk (small blind) folded before Flop
Seat 9: matiko09 (big blind) folded before Flop





PokerStars Hand #152559791916:  Hold'em No Limit ($1/$2 USD) - 2016/04/28 15:19:21 CET [2016/04/28 9:19:21 ET]
Table 'Idomeneus II' 9-max Seat #5 is the button
Seat 1: 13Ghosts ($253.11 in chips) 
Seat 2: libbyyww ($388.78 in chips) 
Seat 3: adrenalin333 ($159.93 in chips) 
Seat 4: SoNe1988 ($87 in chips) 
Seat 5: matiko09 ($217.11 in chips) 
Seat 6: rmanjkeee ($80 in chips) 
Seat 7: ersevi6 ($255.03 in chips) 
Seat 8: di0d80 ($200 in chips) 
rmanjkeee: posts small blind $1
ersevi6: posts big blind $2
*** HOLE CARDS ***
Dealt to matiko09 [8c 3c]
di0d80: raises $3 to $5
13Ghosts: folds 
libbyyww: folds 
adrenalin333: calls $5
SoNe1988: folds 
matiko09: folds 
rmanjkeee: folds 
ersevi6: raises $17 to $22
di0d80: calls $17
adrenalin333: folds 
*** FLOP *** [Kd 5s 9h]
ersevi6: checks 
di0d80: checks 
*** TURN *** [Kd 5s 9h] [9d]
ersevi6: checks 
di0d80: checks 
*** RIVER *** [Kd 5s 9h 9d] [Qc]
ersevi6: checks 
di0d80: bets $6
ersevi6: folds 
Uncalled bet ($6) returned to di0d80
di0d80 collected $47.50 from pot
di0d80: doesn't show hand 
*** SUMMARY ***
Total pot $50 | Rake $2.50 
Board [Kd 5s 9h 9d Qc]
Seat 1: 13Ghosts folded before Flop (didn't bet)
Seat 2: libbyyww folded before Flop (didn't bet)
Seat 3: adrenalin333 folded before Flop
Seat 4: SoNe1988 folded before Flop (didn't bet)
Seat 5: matiko09 (button) folded before Flop (didn't bet)
Seat 6: rmanjkeee (small blind) folded before Flop
Seat 7: ersevi6 (big blind) folded on the River
Seat 8: di0d80 collected ($47.50)





PokerStars Hand #152559794255:  Hold'em No Limit ($0.50/$1.00 USD) - 2016/04/28 15:19:25 CET [2016/04/28 9:19:25 ET]
Table 'Musa II' 9-max Seat #1 is the button
Seat 1: HomerrrJay ($100 in chips) 
Seat 2: ozone2003 ($100 in chips) 
Seat 3: vrnMike ($100 in chips) 
Seat 4: CARLOSXV15 ($127.94 in chips) 
Seat 5: Painkiller72 ($100 in chips) 
Seat 6: skolombi77 ($83.97 in chips) 
Seat 7: ka100pka527 ($41.50 in chips) 
Seat 8: matiko09 ($100 in chips) 
Seat 9: Moszes360 ($145.58 in chips) 
ozone2003: posts small blind $0.50
vrnMike: posts big blind $1
*** HOLE CARDS ***
Dealt to matiko09 [8h 4h]
CARLOSXV15: folds 
Painkiller72: folds 
skolombi77: folds 
ka100pka527: folds 
matiko09: folds 
Moszes360: folds 
HomerrrJay: folds 
ozone2003: folds 
Uncalled bet ($0.50) returned to vrnMike
CARLOSXV15 leaves the table
vrnMike collected $1 from pot
*** SUMMARY ***
Total pot $1 | Rake $0 
Seat 1: HomerrrJay (button) folded before Flop (didn't bet)
Seat 2: ozone2003 (small blind) folded before Flop
Seat 3: vrnMike (big blind) collected ($1)
Seat 4: CARLOSXV15 folded before Flop (didn't bet)
Seat 5: Painkiller72 folded before Flop (didn't bet)
Seat 6: skolombi77 folded before Flop (didn't bet)
Seat 7: ka100pka527 folded before Flop (didn't bet)
Seat 8: matiko09 folded before Flop (didn't bet)
Seat 9: Moszes360 folded before Flop (didn't bet)





PokerStars Hand #152559797314:  Hold'em No Limit (€0.50/€1.00 EUR) - 2016/04/28 15:19:30 CET [2016/04/28 9:19:30 ET]
Table 'Clivia II' 9-max Seat #4 is the button
Seat 1: temujin011 (€95.10 in chips) 
Seat 3: Racushniak (€105.52 in chips) 
Seat 4: matiko09 (€116.63 in chips) 
Seat 5: sanpidk (€113.34 in chips) 
Seat 6: ruslik_by (€73.19 in chips) 
Seat 9: ozone2003 (€119.14 in chips) 
sanpidk: posts small blind €0.50
ruslik_by: posts big blind €1
maxxmeister: sits out 
*** HOLE CARDS ***
Dealt to matiko09 [Jh Ad]
ozone2003: folds 
temujin011: folds 
ozone2003 leaves the table
Racushniak: folds 
matiko09: raises €1.27 to €2.27
sanpidk: calls €1.77
ruslik_by: calls €1.27
*** FLOP *** [8s 4d 2c]
sanpidk: bets €4.50
ruslik_by: folds 
matiko09: folds 
Uncalled bet (€4.50) returned to sanpidk
sanpidk collected €6.47 from pot
sanpidk: doesn't show hand 
*** SUMMARY ***
Total pot €6.81 | Rake €0.34 
Board [8s 4d 2c]
Seat 1: temujin011 folded before Flop (didn't bet)
Seat 3: Racushniak folded before Flop (didn't bet)
Seat 4: matiko09 (button) folded on the Flop
Seat 5: sanpidk (small blind) collected (€6.47)
Seat 6: ruslik_by (big blind) folded on the Flop
Seat 9: ozone2003 folded before Flop (didn't bet)





PokerStars Hand #152559797474:  Hold'em No Limit ($0.50/$1.00 USD) - 2016/04/28 15:19:30 CET [2016/04/28 9:19:30 ET]
Table 'Zachia II' 9-max Seat #7 is the button
Seat 1: greyman571 ($138.55 in chips) 
Seat 2: sanpidk ($151.98 in chips) 
Seat 3: matiko09 ($118.82 in chips) 
Seat 4: omorfadramou ($100 in chips) 
Seat 5: vrnMike ($103 in chips) 
Seat 6: koksskrt ($102.62 in chips) 
Seat 7: ozone2003 ($100 in chips) 
Seat 9: Painkiller72 ($100 in chips) 
Painkiller72: posts small blind $0.50
greyman571: posts big blind $1
*** HOLE CARDS ***
Dealt to matiko09 [5s 4h]
sanpidk: folds 
CI58 joins the table at seat #8 
matiko09: folds 
omorfadramou: folds 
vrnMike: folds 
koksskrt: raises $1.50 to $2.50
ozone2003: folds 
Painkiller72: calls $2
greyman571: folds 
*** FLOP *** [Jh Ad 7s]
Painkiller72: checks 
koksskrt: bets $2.96
Painkiller72: calls $2.96
*** TURN *** [Jh Ad 7s] [7h]
Painkiller72: checks 
koksskrt: bets $7.13
Painkiller72: folds 
Uncalled bet ($7.13) returned to koksskrt
koksskrt collected $11.32 from pot
koksskrt: doesn't show hand 
*** SUMMARY ***
Total pot $11.92 | Rake $0.60 
Board [Jh Ad 7s 7h]
Seat 1: greyman571 (big blind) folded before Flop
Seat 2: sanpidk folded before Flop (didn't bet)
Seat 3: matiko09 folded before Flop (didn't bet)
Seat 4: omorfadramou folded before Flop (didn't bet)
Seat 5: vrnMike folded before Flop (didn't bet)
Seat 6: koksskrt collected ($11.32)
Seat 7: ozone2003 (button) folded before Flop (didn't bet)
Seat 9: Painkiller72 (small blind) folded on the Turn





PokerStars Hand #152559801256:  Hold'em No Limit ($0.50/$1.00 USD) - 2016/04/28 15:19:36 CET [2016/04/28 9:19:36 ET]
Table 'Erynia' 9-max Seat #1 is the button
Seat 1: I The King I ($100 in chips) 
Seat 2: matiko09 ($140.32 in chips) 
Seat 3: vilo1070 ($100 in chips) 
Seat 4: omorfadramou ($110.68 in chips) 
Seat 5: RMilPoker ($108.68 in chips) 
Seat 6: peevoajax ($100 in chips) 
Seat 7: vrnMike ($113.74 in chips) 
Seat 8: YourKicker78 ($64.27 in chips) 
Seat 9: ruslik_by ($53.61 in chips) 
matiko09: posts small blind $0.50
vilo1070: posts big blind $1
*** HOLE CARDS ***
Dealt to matiko09 [8h 4h]
omorfadramou: folds 
RMilPoker: folds 
peevoajax: folds 
vrnMike: folds 
YourKicker78: raises $2 to $3
ruslik_by: folds 
I The King I: raises $6 to $9
matiko09: folds 
vilo1070: folds 
YourKicker78: raises $55.27 to $64.27 and is all-in
I The King I: folds 
Uncalled bet ($55.27) returned to YourKicker78
YourKicker78 collected $19.50 from pot
YourKicker78: doesn't show hand 
*** SUMMARY ***
Total pot $19.50 | Rake $0 
Seat 1: I The King I (button) folded before Flop
Seat 2: matiko09 (small blind) folded before Flop
Seat 3: vilo1070 (big blind) folded before Flop
Seat 4: omorfadramou folded before Flop (didn't bet)
Seat 5: RMilPoker folded before Flop (didn't bet)
Seat 6: peevoajax folded before Flop (didn't bet)
Seat 7: vrnMike folded before Flop (didn't bet)
Seat 8: YourKicker78 collected ($19.50)
Seat 9: ruslik_by folded before Flop (didn't bet)





PokerStars Hand #152559801720:  Hold'em No Limit ($1/$2 USD) - 2016/04/28 15:19:37 CET [2016/04/28 9:19:37 ET]
Table 'Hakone II' 9-max Seat #6 is the button
Seat 1: Iggso ($200 in chips) 
Seat 2: matiko09 ($212 in chips) 
Seat 3: T0ny Adams ($83 in chips) 
Seat 4: SoNe1988 ($111.42 in chips) 
Seat 6: ersevi6 ($77 in chips) 
Seat 7: wiseyoyo ($322.20 in chips) 
Seat 8: Todox2pesos ($197 in chips) 
InsomniaRU joins the table at seat #9 
wiseyoyo: posts small blind $1
Todox2pesos: posts big blind $2
*** HOLE CARDS ***
Dealt to matiko09 [2h 4s]
InsomniaRU leaves the table
Iggso: folds 
di0d80 joins the table at seat #9 
di0d80 leaves the table
matiko09: folds 
prominente joins the table at seat #9 
T0ny Adams: raises $2.68 to $4.68
SoNe1988: folds 
ersevi6: folds 
wiseyoyo: folds 
Todox2pesos: calls $2.68
*** FLOP *** [As Qs 4h]
Todox2pesos: checks 
T0ny Adams: bets $3.34
Todox2pesos: folds 
Uncalled bet ($3.34) returned to T0ny Adams
T0ny Adams collected $9.84 from pot
T0ny Adams: doesn't show hand 
*** SUMMARY ***
Total pot $10.36 | Rake $0.52 
Board [As Qs 4h]
Seat 1: Iggso folded before Flop (didn't bet)
Seat 2: matiko09 folded before Flop (didn't bet)
Seat 3: T0ny Adams collected ($9.84)
Seat 4: SoNe1988 folded before Flop (didn't bet)
Seat 6: ersevi6 (button) folded before Flop (didn't bet)
Seat 7: wiseyoyo (small blind) folded before Flop
Seat 8: Todox2pesos (big blind) folded on the Flop





PokerStars Hand #152559806793:  Hold'em No Limit ($0.50/$1.00 USD) - 2016/04/28 15:19:46 CET [2016/04/28 9:19:46 ET]
Table 'Musa II' 9-max Seat #2 is the button
Seat 1: HomerrrJay ($100 in chips) 
Seat 2: ozone2003 ($100 in chips) 
Seat 3: vrnMike ($100.50 in chips) 
Seat 5: Painkiller72 ($100 in chips) 
Seat 6: skolombi77 ($83.97 in chips) 
Seat 7: ka100pka527 ($41.50 in chips) 
Seat 8: matiko09 ($100 in chips) 
Seat 9: Moszes360 ($145.58 in chips) 
vrnMike: posts small blind $0.50
Painkiller72: posts big blind $1
*** HOLE CARDS ***
Dealt to matiko09 [9c 7c]
skolombi77: folds 
ka100pka527: folds 
matiko09: folds 
Moszes360: folds 
HomerrrJay: raises $2 to $3
ozone2003: raises $6 to $9
vrnMike: folds 
Painkiller72: folds 
ipashutapkom joins the table at seat #4 
HomerrrJay: raises $14.50 to $23.50
ozone2003: folds 
Uncalled bet ($14.50) returned to HomerrrJay
HomerrrJay collected $19.50 from pot
HomerrrJay: doesn't show hand 
*** SUMMARY ***
Total pot $19.50 | Rake $0 
Seat 1: HomerrrJay collected ($19.50)
Seat 2: ozone2003 (button) folded before Flop
Seat 3: vrnMike (small blind) folded before Flop
Seat 5: Painkiller72 (big blind) folded before Flop
Seat 6: skolombi77 folded before Flop (didn't bet)
Seat 7: ka100pka527 folded before Flop (didn't bet)
Seat 8: matiko09 folded before Flop (didn't bet)
Seat 9: Moszes360 folded before Flop (didn't bet)





PokerStars Hand #152559808381:  Hold'em No Limit ($0.50/$1.00 USD) - 2016/04/28 15:19:48 CET [2016/04/28 9:19:48 ET]
Table 'Agapenor III' 9-max Seat #5 is the button
Seat 1: I The King I ($105.17 in chips) 
Seat 2: cerbisor1 ($38.50 in chips) 
Seat 3: sanpidk ($145.41 in chips) 
Seat 4: matiko09 ($100 in chips) 
Seat 5: Painkiller72 ($108.17 in chips) 
Seat 6: azzad2007 ($116.93 in chips) 
Seat 7: tylerz71 ($121.48 in chips) 
Seat 8: Ceanucs ($53.76 in chips) 
Seat 9: DYO1000 ($35.48 in chips) 
azzad2007: posts small blind $0.50
tylerz71: posts big blind $1
*** HOLE CARDS ***
Dealt to matiko09 [6c Tc]
Ceanucs: folds 
DYO1000: folds 
I The King I: folds 
cerbisor1: folds 
sanpidk: folds 
matiko09: folds 
Painkiller72: folds 
azzad2007: folds 
Uncalled bet ($0.50) returned to tylerz71
tylerz71 collected $1 from pot
tylerz71: doesn't show hand 
*** SUMMARY ***
Total pot $1 | Rake $0 
Seat 1: I The King I folded before Flop (didn't bet)
Seat 2: cerbisor1 folded before Flop (didn't bet)
Seat 3: sanpidk folded before Flop (didn't bet)
Seat 4: matiko09 folded before Flop (didn't bet)
Seat 5: Painkiller72 (button) folded before Flop (didn't bet)
Seat 6: azzad2007 (small blind) folded before Flop
Seat 7: tylerz71 (big blind) collected ($1)
Seat 8: Ceanucs folded before Flop (didn't bet)
Seat 9: DYO1000 folded before Flop (didn't bet)





PokerStars Hand #152559811756:  Hold'em No Limit ($0.50/$1.00 USD) - 2016/04/28 15:19:54 CET [2016/04/28 9:19:54 ET]
Table 'Bruwer' 9-max Seat #9 is the button
Seat 2: ruslik_by ($41.85 in chips) 
Seat 3: koksskrt ($133.51 in chips) 
Seat 4: matiko09 ($138.04 in chips) 
Seat 5: Carloszhang ($110.03 in chips) 
Seat 6: I The King I ($109.02 in chips) 
Seat 7: R1aki ($229.66 in chips) 
Seat 8: lumen21 ($103.50 in chips) 
Seat 9: Dantist1122 ($127.15 in chips) 
peevoajax will be allowed to play after the button
ruslik_by: posts small blind $0.50
koksskrt: posts big blind $1
*** HOLE CARDS ***
Dealt to matiko09 [4s 6h]
matiko09: folds 
Carloszhang: folds 
I The King I: folds 
R1aki has timed out
R1aki: folds 
lumen21: raises $1.50 to $2.50
Dantist1122: folds 
ruslik_by: folds 
koksskrt: folds 
Uncalled bet ($1.50) returned to lumen21
lumen21 collected $2.50 from pot
lumen21: doesn't show hand 
*** SUMMARY ***
Total pot $2.50 | Rake $0 
Seat 2: ruslik_by (small blind) folded before Flop
Seat 3: koksskrt (big blind) folded before Flop
Seat 4: matiko09 folded before Flop (didn't bet)
Seat 5: Carloszhang folded before Flop (didn't bet)
Seat 6: I The King I folded before Flop (didn't bet)
Seat 7: R1aki folded before Flop (didn't bet)
Seat 8: lumen21 collected ($2.50)
Seat 9: Dantist1122 (button) folded before Flop (didn't bet)





PokerStars Hand #152559816327:  Hold'em No Limit (€0.50/€1.00 EUR) - 2016/04/28 15:20:01 CET [2016/04/28 9:20:01 ET]
Table 'Lumiere II' 9-max Seat #8 is the button
Seat 1: vrnMike (€153.19 in chips) 
Seat 2: Racushniak (€104.38 in chips) 
Seat 3: maxxmeister (€101.50 in chips) 
Seat 4: ruslik_by (€57.20 in chips) 
Seat 5: Schmidy7 (€60.20 in chips) 
Seat 6: azzad2007 (€98.50 in chips) 
Seat 7: hammerwife (€120.18 in chips) 
Seat 8: sanpidk (€105.62 in chips) 
Seat 9: matiko09 (€100 in chips) 
matiko09: posts small blind €0.50
vrnMike: posts big blind €1
*** HOLE CARDS ***
Dealt to matiko09 [Qs 7c]
Racushniak: folds 
maxxmeister: folds 
ruslik_by: folds 
Schmidy7: folds 
azzad2007: folds 
hammerwife: folds 
sanpidk: folds 
matiko09: folds 
Uncalled bet (€0.50) returned to vrnMike
vrnMike collected €1 from pot
*** SUMMARY ***
Total pot €1 | Rake €0 
Seat 1: vrnMike (big blind) collected (€1)
Seat 2: Racushniak folded before Flop (didn't bet)
Seat 3: maxxmeister folded before Flop (didn't bet)
Seat 4: ruslik_by folded before Flop (didn't bet)
Seat 5: Schmidy7 folded before Flop (didn't bet)
Seat 6: azzad2007 folded before Flop (didn't bet)
Seat 7: hammerwife folded before Flop (didn't bet)
Seat 8: sanpidk (button) folded before Flop (didn't bet)
Seat 9: matiko09 (small blind) folded before Flop





PokerStars Hand #152559821058:  Hold'em No Limit (€0.50/€1.00 EUR) - 2016/04/28 15:20:09 CET [2016/04/28 9:20:09 ET]
Table 'Clivia II' 9-max Seat #5 is the button
Seat 2: maxxmeister (€100 in chips) 
Seat 3: Racushniak (€105.52 in chips) 
Seat 4: matiko09 (€114.36 in chips) 
Seat 5: sanpidk (€117.54 in chips) 
Seat 6: ruslik_by (€70.92 in chips) 
ruslik_by: posts small blind €0.50
temujin011: is sitting out 
maxxmeister: posts big blind €1
*** HOLE CARDS ***
Dealt to matiko09 [Qh 9c]
Racushniak: folds 
matiko09: folds 
sanpidk: raises €1.24 to €2.24
ruslik_by: folds 
maxxmeister: calls €1.24
*** FLOP *** [Ad Ah 7h]
maxxmeister: checks 
sanpidk: bets €3
maxxmeister: folds 
Uncalled bet (€3) returned to sanpidk
sanpidk collected €4.73 from pot
sanpidk: doesn't show hand 
*** SUMMARY ***
Total pot €4.98 | Rake €0.25 
Board [Ad Ah 7h]
Seat 2: maxxmeister (big blind) folded on the Flop
Seat 3: Racushniak folded before Flop (didn't bet)
Seat 4: matiko09 folded before Flop (didn't bet)
Seat 5: sanpidk (button) collected (€4.73)
Seat 6: ruslik_by (small blind) folded before Flop





PokerStars Hand #152559825487:  Hold'em No Limit ($0.50/$1.00 USD) - 2016/04/28 15:20:17 CET [2016/04/28 9:20:17 ET]
Table 'Agapenor III' 9-max Seat #6 is the button
Seat 1: I The King I ($105.17 in chips) 
Seat 2: cerbisor1 ($38.50 in chips) 
Seat 3: sanpidk ($145.41 in chips) 
Seat 4: matiko09 ($100 in chips) 
Seat 5: Painkiller72 ($108.17 in chips) 
Seat 6: azzad2007 ($116.43 in chips) 
Seat 7: tylerz71 ($121.98 in chips) 
Seat 8: Ceanucs ($53.76 in chips) 
Seat 9: DYO1000 ($35.48 in chips) 
tylerz71: posts small blind $0.50
Ceanucs: posts big blind $1
*** HOLE CARDS ***
Dealt to matiko09 [6h 3c]
DYO1000: folds 
I The King I: folds 
cerbisor1: folds 
sanpidk: folds 
matiko09: folds 
Painkiller72: raises $1.50 to $2.50
azzad2007: folds 
tylerz71: folds 
Ceanucs: folds 
Uncalled bet ($1.50) returned to Painkiller72
Painkiller72 collected $2.50 from pot
Painkiller72: doesn't show hand 
*** SUMMARY ***
Total pot $2.50 | Rake $0 
Seat 1: I The King I folded before Flop (didn't bet)
Seat 2: cerbisor1 folded before Flop (didn't bet)
Seat 3: sanpidk folded before Flop (didn't bet)
Seat 4: matiko09 folded before Flop (didn't bet)
Seat 5: Painkiller72 collected ($2.50)
Seat 6: azzad2007 (button) folded before Flop (didn't bet)
Seat 7: tylerz71 (small blind) folded before Flop
Seat 8: Ceanucs (big blind) folded before Flop
Seat 9: DYO1000 folded before Flop (didn't bet)





PokerStars Hand #152559826343:  Hold'em No Limit ($1/$2 USD) - 2016/04/28 15:20:18 CET [2016/04/28 9:20:18 ET]
Table 'Hakone II' 9-max Seat #7 is the button
Seat 1: Iggso ($200 in chips) 
Seat 2: matiko09 ($212 in chips) 
Seat 3: T0ny Adams ($88.16 in chips) 
Seat 4: SoNe1988 ($111.42 in chips) 
Seat 6: ersevi6 ($77 in chips) 
Seat 7: wiseyoyo ($321.20 in chips) 
Seat 8: Todox2pesos ($192.32 in chips) 
Seat 9: prominente ($200 in chips) 
Todox2pesos: posts small blind $1
prominente: posts big blind $2
*** HOLE CARDS ***
Dealt to matiko09 [Jh 9c]
Iggso: folds 
matiko09: folds 
Iggso leaves the table
T0ny Adams: folds 
SoNe1988: folds 
ersevi6: folds 
wiseyoyo: raises $2 to $4
Todox2pesos: folds 
prominente: folds 
Uncalled bet ($2) returned to wiseyoyo
wiseyoyo collected $5 from pot
wiseyoyo: doesn't show hand 
*** SUMMARY ***
Total pot $5 | Rake $0 
Seat 1: Iggso folded before Flop (didn't bet)
Seat 2: matiko09 folded before Flop (didn't bet)
Seat 3: T0ny Adams folded before Flop (didn't bet)
Seat 4: SoNe1988 folded before Flop (didn't bet)
Seat 6: ersevi6 folded before Flop (didn't bet)
Seat 7: wiseyoyo (button) collected ($5)
Seat 8: Todox2pesos (small blind) folded before Flop
Seat 9: prominente (big blind) folded before Flop





PokerStars Hand #152559833321:  Hold'em No Limit ($0.50/$1.00 USD) - 2016/04/28 15:20:30 CET [2016/04/28 9:20:30 ET]
Table 'Erynia' 9-max Seat #2 is the button
Seat 1: I The King I ($100 in chips) 
Seat 2: matiko09 ($139.82 in chips) 
Seat 3: vilo1070 ($100 in chips) 
Seat 4: omorfadramou ($110.68 in chips) 
Seat 5: RMilPoker ($108.68 in chips) 
Seat 6: peevoajax ($100 in chips) 
Seat 7: vrnMike ($113.74 in chips) 
Seat 8: YourKicker78 ($74.77 in chips) 
Seat 9: ruslik_by ($53.61 in chips) 
vilo1070: posts small blind $0.50
omorfadramou: posts big blind $1
*** HOLE CARDS ***
Dealt to matiko09 [Kh 7d]
RMilPoker: folds 
peevoajax: folds 
vrnMike: folds 
YourKicker78: raises $2 to $3
ruslik_by: folds 
I The King I: calls $3
matiko09: folds 
vilo1070: folds 
omorfadramou: folds 
*** FLOP *** [Ac 9d Jc]
YourKicker78: bets $4
I The King I: calls $4
*** TURN *** [Ac 9d Jc] [4s]
YourKicker78: checks 
I The King I: checks 
*** RIVER *** [Ac 9d Jc 4s] [8d]
YourKicker78: bets $9
I The King I: calls $9
*** SHOW DOWN ***
YourKicker78: shows [Ad 4d] (two pair, Aces and Fours)
I The King I: mucks hand 
YourKicker78 collected $31.82 from pot
*** SUMMARY ***
Total pot $33.50 | Rake $1.68 
Board [Ac 9d Jc 4s 8d]
Seat 1: I The King I mucked [Qh Jh]
Seat 2: matiko09 (button) folded before Flop (didn't bet)
Seat 3: vilo1070 (small blind) folded before Flop
Seat 4: omorfadramou (big blind) folded before Flop
Seat 5: RMilPoker folded before Flop (didn't bet)
Seat 6: peevoajax folded before Flop (didn't bet)
Seat 7: vrnMike folded before Flop (didn't bet)
Seat 8: YourKicker78 showed [Ad 4d] and won ($31.82) with two pair, Aces and Fours
Seat 9: ruslik_by folded before Flop (didn't bet)





PokerStars Hand #152559840318:  Hold'em No Limit (€0.50/€1.00 EUR) - 2016/04/28 15:20:42 CET [2016/04/28 9:20:42 ET]
Table 'Lumiere II' 9-max Seat #9 is the button
Seat 1: vrnMike (€153.69 in chips) 
Seat 2: Racushniak (€104.38 in chips) 
Seat 3: maxxmeister (€101.50 in chips) 
Seat 4: ruslik_by (€57.20 in chips) 
Seat 5: Schmidy7 (€60.20 in chips) 
Seat 6: azzad2007 (€98.50 in chips) 
Seat 7: hammerwife (€120.18 in chips) 
Seat 8: sanpidk (€105.62 in chips) 
Seat 9: matiko09 (€100 in chips) 
vrnMike: posts small blind €0.50
Racushniak: posts big blind €1
*** HOLE CARDS ***
Dealt to matiko09 [Qs 3h]
maxxmeister: folds 
maxxmeister leaves the table
ruslik_by: folds 
Schmidy7: folds 
azzad2007: folds 
hammerwife: folds 
sanpidk: folds 
matiko09: folds 
vrnMike: folds 
Uncalled bet (€0.50) returned to Racushniak
Racushniak collected €1 from pot
Racushniak: doesn't show hand 
*** SUMMARY ***
Total pot €1 | Rake €0 
Seat 1: vrnMike (small blind) folded before Flop
Seat 2: Racushniak (big blind) collected (€1)
Seat 3: maxxmeister folded before Flop (didn't bet)
Seat 4: ruslik_by folded before Flop (didn't bet)
Seat 5: Schmidy7 folded before Flop (didn't bet)
Seat 6: azzad2007 folded before Flop (didn't bet)
Seat 7: hammerwife folded before Flop (didn't bet)
Seat 8: sanpidk folded before Flop (didn't bet)
Seat 9: matiko09 (button) folded before Flop (didn't bet)





PokerStars Hand #152559843936:  Hold'em No Limit ($0.50/$1.00 USD) - 2016/04/28 15:20:48 CET [2016/04/28 9:20:48 ET]
Table 'Agapenor III' 9-max Seat #7 is the button
Seat 1: I The King I ($105.17 in chips) 
Seat 2: cerbisor1 ($38.50 in chips) 
Seat 3: sanpidk ($145.41 in chips) 
Seat 4: matiko09 ($100 in chips) 
Seat 5: Painkiller72 ($109.67 in chips) 
Seat 6: azzad2007 ($116.43 in chips) 
Seat 7: tylerz71 ($121.48 in chips) 
Seat 8: Ceanucs ($52.76 in chips) 
Seat 9: DYO1000 ($35.48 in chips) 
Ceanucs: posts small blind $0.50
DYO1000: posts big blind $1
*** HOLE CARDS ***
Dealt to matiko09 [7s 3d]
I The King I: folds 
cerbisor1: folds 
sanpidk: folds 
matiko09: folds 
Painkiller72: raises $1.50 to $2.50
azzad2007: folds 
tylerz71: folds 
Ceanucs: folds 
DYO1000: calls $1.50
*** FLOP *** [2h 6c Kd]
DYO1000: checks 
Painkiller72: bets $3.65
DYO1000: calls $3.65
*** TURN *** [2h 6c Kd] [Qd]
DYO1000: checks 
Painkiller72: checks 
*** RIVER *** [2h 6c Kd Qd] [Js]
DYO1000: bets $12.16
Painkiller72: folds 
Uncalled bet ($12.16) returned to DYO1000
DYO1000 collected $12.16 from pot
DYO1000: doesn't show hand 
*** SUMMARY ***
Total pot $12.80 | Rake $0.64 
Board [2h 6c Kd Qd Js]
Seat 1: I The King I folded before Flop (didn't bet)
Seat 2: cerbisor1 folded before Flop (didn't bet)
Seat 3: sanpidk folded before Flop (didn't bet)
Seat 4: matiko09 folded before Flop (didn't bet)
Seat 5: Painkiller72 folded on the River
Seat 6: azzad2007 folded before Flop (didn't bet)
Seat 7: tylerz71 (button) folded before Flop (didn't bet)
Seat 8: Ceanucs (small blind) folded before Flop
Seat 9: DYO1000 (big blind) collected ($12.16)





PokerStars Hand #152559843985:  Hold'em No Limit ($0.50/$1.00 USD) - 2016/04/28 15:20:49 CET [2016/04/28 9:20:49 ET]
Table 'Ciurlionis' 9-max Seat #7 is the button
Seat 1: sanpidk ($100 in chips) 
Seat 2: liuzhi14 ($58.55 in chips) 
Seat 3: I The King I ($127.50 in chips) 
Seat 4: ruslik_by ($207 in chips) 
Seat 5: matiko09 ($183.28 in chips) 
Seat 6: vrnMike ($100 in chips) 
Seat 7: Stopton ($93.35 in chips) 
Seat 8: omorfadramou ($100 in chips) 
Seat 9: Painkiller72 ($106.05 in chips) 
omorfadramou: posts small blind $0.50
Painkiller72: posts big blind $1
*** HOLE CARDS ***
Dealt to matiko09 [7s Kc]
sanpidk: raises $2 to $3
liuzhi14: calls $3
I The King I: folds 
ruslik_by: folds 
matiko09: folds 
vrnMike: folds 
Stopton: folds 
omorfadramou: folds 
Painkiller72: folds 
*** FLOP *** [3s 3h Qh]
sanpidk: bets $5.50
liuzhi14: calls $5.50
*** TURN *** [3s 3h Qh] [9d]
sanpidk: bets $13.90
liuzhi14: folds 
Uncalled bet ($13.90) returned to sanpidk
sanpidk collected $17.58 from pot
sanpidk: doesn't show hand 
*** SUMMARY ***
Total pot $18.50 | Rake $0.92 
Board [3s 3h Qh 9d]
Seat 1: sanpidk collected ($17.58)
Seat 2: liuzhi14 folded on the Turn
Seat 3: I The King I folded before Flop (didn't bet)
Seat 4: ruslik_by folded before Flop (didn't bet)
Seat 5: matiko09 folded before Flop (didn't bet)
Seat 6: vrnMike folded before Flop (didn't bet)
Seat 7: Stopton (button) folded before Flop (didn't bet)
Seat 8: omorfadramou (small blind) folded before Flop
Seat 9: Painkiller72 (big blind) folded before Flop





PokerStars Hand #152559852860:  Hold'em No Limit ($0.50/$1.00 USD) - 2016/04/28 15:21:03 CET [2016/04/28 9:21:03 ET]
Table 'Bruwer' 9-max Seat #2 is the button
Seat 2: ruslik_by ($41.35 in chips) 
Seat 3: koksskrt ($132.51 in chips) 
Seat 4: matiko09 ($138.04 in chips) 
Seat 5: Carloszhang ($110.03 in chips) 
Seat 6: I The King I ($109.02 in chips) 
Seat 7: R1aki ($229.66 in chips) 
Seat 8: lumen21 ($105 in chips) 
Seat 9: Dantist1122 ($127.15 in chips) 
koksskrt: posts small blind $0.50
matiko09: posts big blind $1
peevoajax: sits out 
*** HOLE CARDS ***
Dealt to matiko09 [8d 5s]
Carloszhang: folds 
I The King I: folds 
R1aki: folds 
lumen21: folds 
Dantist1122: folds 
ruslik_by: raises $1 to $2
koksskrt: folds 
matiko09: folds 
Uncalled bet ($1) returned to ruslik_by
ruslik_by collected $2.50 from pot
ruslik_by: doesn't show hand 
*** SUMMARY ***
Total pot $2.50 | Rake $0 
Seat 2: ruslik_by (button) collected ($2.50)
Seat 3: koksskrt (small blind) folded before Flop
Seat 4: matiko09 (big blind) folded before Flop
Seat 5: Carloszhang folded before Flop (didn't bet)
Seat 6: I The King I folded before Flop (didn't bet)
Seat 7: R1aki folded before Flop (didn't bet)
Seat 8: lumen21 folded before Flop (didn't bet)
Seat 9: Dantist1122 folded before Flop (didn't bet)





PokerStars Hand #152559855417:  Hold'em No Limit ($0.50/$1.00 USD) - 2016/04/28 15:21:08 CET [2016/04/28 9:21:08 ET]
Table 'Zachia II' 9-max Seat #9 is the button
Seat 1: greyman571 ($137.55 in chips) 
Seat 2: sanpidk ($151.98 in chips) 
Seat 3: matiko09 ($118.82 in chips) 
Seat 4: omorfadramou ($100 in chips) 
Seat 5: vrnMike ($103 in chips) 
Seat 6: koksskrt ($108.48 in chips) 
Seat 7: ozone2003 ($100 in chips) 
Seat 9: Painkiller72 ($100 in chips) 
greyman571: posts small blind $0.50
sanpidk: posts big blind $1
CI58: sits out 
*** HOLE CARDS ***
Dealt to matiko09 [8h 2h]
matiko09: folds 
omorfadramou: folds 
vrnMike: folds 
koksskrt: raises $2 to $3
ozone2003: folds 
Painkiller72: calls $3
greyman571: folds 
sanpidk: folds 
*** FLOP *** [Tc 2d Td]
koksskrt: checks 
Painkiller72: checks 
*** TURN *** [Tc 2d Td] [8c]
koksskrt: checks 
Painkiller72: checks 
*** RIVER *** [Tc 2d Td 8c] [Qh]
koksskrt: checks 
Painkiller72: checks 
*** SHOW DOWN ***
koksskrt: shows [As Jh] (a pair of Tens)
Painkiller72: shows [Ac Jd] (a pair of Tens)
koksskrt collected $3.56 from pot
Painkiller72 collected $3.56 from pot
*** SUMMARY ***
Total pot $7.50 | Rake $0.38 
Board [Tc 2d Td 8c Qh]
Seat 1: greyman571 (small blind) folded before Flop
Seat 2: sanpidk (big blind) folded before Flop
Seat 3: matiko09 folded before Flop (didn't bet)
Seat 4: omorfadramou folded before Flop (didn't bet)
Seat 5: vrnMike folded before Flop (didn't bet)
Seat 6: koksskrt showed [As Jh] and won ($3.56) with a pair of Tens
Seat 7: ozone2003 folded before Flop (didn't bet)
Seat 9: Painkiller72 (button) showed [Ac Jd] and won ($3.56) with a pair of Tens





PokerStars Hand #152559856655:  Hold'em No Limit ($1/$2 USD) - 2016/04/28 15:21:10 CET [2016/04/28 9:21:10 ET]
Table 'Idomeneus II' 9-max Seat #6 is the button
Seat 1: 13Ghosts ($253.11 in chips) 
Seat 2: libbyyww ($388.78 in chips) 
Seat 3: adrenalin333 ($154.93 in chips) 
Seat 4: SoNe1988 ($87 in chips) 
Seat 5: matiko09 ($217.11 in chips) 
Seat 6: rmanjkeee ($80 in chips) 
Seat 7: ersevi6 ($233.03 in chips) 
Seat 8: di0d80 ($225.50 in chips) 
ersevi6: posts small blind $1
di0d80: posts big blind $2
prominente: sits out 
*** HOLE CARDS ***
Dealt to matiko09 [Qs 2h]
13Ghosts: folds 
libbyyww: folds 
adrenalin333: raises $4 to $6
SoNe1988: folds 
matiko09: folds 
rmanjkeee: folds 
ersevi6: folds 
di0d80: folds 
Uncalled bet ($4) returned to adrenalin333
adrenalin333 collected $5 from pot
adrenalin333: doesn't show hand 
*** SUMMARY ***
Total pot $5 | Rake $0 
Seat 1: 13Ghosts folded before Flop (didn't bet)
Seat 2: libbyyww folded before Flop (didn't bet)
Seat 3: adrenalin333 collected ($5)
Seat 4: SoNe1988 folded before Flop (didn't bet)
Seat 5: matiko09 folded before Flop (didn't bet)
Seat 6: rmanjkeee (button) folded before Flop (didn't bet)
Seat 7: ersevi6 (small blind) folded before Flop
Seat 8: di0d80 (big blind) folded before Flop





PokerStars Hand #152559862496:  Hold'em No Limit ($0.50/$1.00 USD) - 2016/04/28 15:21:20 CET [2016/04/28 9:21:20 ET]
Table 'Musa II' 9-max Seat #3 is the button
Seat 1: HomerrrJay ($110.50 in chips) 
Seat 2: ozone2003 ($100 in chips) 
Seat 3: vrnMike ($100 in chips) 
Seat 5: Painkiller72 ($100 in chips) 
Seat 6: skolombi77 ($83.97 in chips) 
Seat 7: ka100pka527 ($41.50 in chips) 
Seat 8: matiko09 ($100 in chips) 
Seat 9: Moszes360 ($145.58 in chips) 
ipashutapkom will be allowed to play after the button
Painkiller72: posts small blind $0.50
skolombi77: posts big blind $1
*** HOLE CARDS ***
Dealt to matiko09 [6c Qc]
ka100pka527: folds 
matiko09: folds 
Moszes360: folds 
HomerrrJay: folds 
ozone2003: raises $1.50 to $2.50
vrnMike: folds 
Painkiller72: folds 
skolombi77: folds 
Uncalled bet ($1.50) returned to ozone2003
ozone2003 collected $2.50 from pot
ozone2003: doesn't show hand 
*** SUMMARY ***
Total pot $2.50 | Rake $0 
Seat 1: HomerrrJay folded before Flop (didn't bet)
Seat 2: ozone2003 collected ($2.50)
Seat 3: vrnMike (button) folded before Flop (didn't bet)
Seat 5: Painkiller72 (small blind) folded before Flop
Seat 6: skolombi77 (big blind) folded before Flop
Seat 7: ka100pka527 folded before Flop (didn't bet)
Seat 8: matiko09 folded before Flop (didn't bet)
Seat 9: Moszes360 folded before Flop (didn't bet)





PokerStars Hand #152559863841:  Hold'em No Limit (€0.50/€1.00 EUR) - 2016/04/28 15:21:22 CET [2016/04/28 9:21:22 ET]
Table 'Lumiere II' 9-max Seat #1 is the button
Seat 1: vrnMike (€153.19 in chips) 
Seat 2: Racushniak (€104.88 in chips) 
Seat 4: ruslik_by (€57.20 in chips) 
Seat 5: Schmidy7 (€60.20 in chips) 
Seat 6: azzad2007 (€98.50 in chips) 
Seat 7: hammerwife (€120.18 in chips) 
Seat 8: sanpidk (€105.62 in chips) 
Seat 9: matiko09 (€100 in chips) 
Racushniak: posts small blind €0.50
ruslik_by: posts big blind €1
*** HOLE CARDS ***
Dealt to matiko09 [Ac 6h]
Schmidy7: folds 
azzad2007: folds 
hammerwife: folds 
sanpidk: folds 
matiko09: folds 
vrnMike: raises €2 to €3
maxxmeister joins the table at seat #3 
Racushniak: raises €6 to €9
maxxmeister leaves the table
ruslik_by: folds 
vrnMike: folds 
Uncalled bet (€6) returned to Racushniak
Racushniak collected €7 from pot
Racushniak: doesn't show hand 
*** SUMMARY ***
Total pot €7 | Rake €0 
Seat 1: vrnMike (button) folded before Flop
Seat 2: Racushniak (small blind) collected (€7)
Seat 4: ruslik_by (big blind) folded before Flop
Seat 5: Schmidy7 folded before Flop (didn't bet)
Seat 6: azzad2007 folded before Flop (didn't bet)
Seat 7: hammerwife folded before Flop (didn't bet)
Seat 8: sanpidk folded before Flop (didn't bet)
Seat 9: matiko09 folded before Flop (didn't bet)





PokerStars Hand #152559876971:  Hold'em No Limit ($0.50/$1.00 USD) - 2016/04/28 15:21:44 CET [2016/04/28 9:21:44 ET]
Table 'Bruwer' 9-max Seat #3 is the button
Seat 2: ruslik_by ($42.85 in chips) 
Seat 3: koksskrt ($132.01 in chips) 
Seat 4: matiko09 ($137.04 in chips) 
Seat 5: Carloszhang ($110.03 in chips) 
Seat 6: I The King I ($109.02 in chips) 
Seat 7: R1aki ($229.66 in chips) 
Seat 8: lumen21 ($105 in chips) 
Seat 9: Dantist1122 ($127.15 in chips) 
matiko09: posts small blind $0.50
Carloszhang: posts big blind $1
peevoajax: sits out 
*** HOLE CARDS ***
Dealt to matiko09 [Jd 7d]
I The King I: folds 
R1aki: folds 
lumen21: folds 
Dantist1122: folds 
ruslik_by: folds 
koksskrt: raises $1 to $2
matiko09: folds 
Carloszhang: calls $1
*** FLOP *** [5c 5s 2s]
Carloszhang: checks 
koksskrt: bets $2.69
Carloszhang: calls $2.69
*** TURN *** [5c 5s 2s] [Tc]
Carloszhang: checks 
koksskrt: checks 
*** RIVER *** [5c 5s 2s Tc] [Ad]
Carloszhang: bets $7
koksskrt: calls $7
*** SHOW DOWN ***
Carloszhang: shows [Qc 7c] (a pair of Fives)
koksskrt: shows [Jc As] (two pair, Aces and Fives)
koksskrt collected $22.69 from pot
*** SUMMARY ***
Total pot $23.88 | Rake $1.19 
Board [5c 5s 2s Tc Ad]
Seat 2: ruslik_by folded before Flop (didn't bet)
Seat 3: koksskrt (button) showed [Jc As] and won ($22.69) with two pair, Aces and Fives
Seat 4: matiko09 (small blind) folded before Flop
Seat 5: Carloszhang (big blind) showed [Qc 7c] and lost with a pair of Fives
Seat 6: I The King I folded before Flop (didn't bet)
Seat 7: R1aki folded before Flop (didn't bet)
Seat 8: lumen21 folded before Flop (didn't bet)
Seat 9: Dantist1122 folded before Flop (didn't bet)





PokerStars Hand #152559877079:  Hold'em No Limit ($0.50/$1.00 USD) - 2016/04/28 15:21:44 CET [2016/04/28 9:21:44 ET]
Table 'Musa II' 9-max Seat #5 is the button
Seat 1: HomerrrJay ($110.50 in chips) 
Seat 2: ozone2003 ($101.50 in chips) 
Seat 3: vrnMike ($100 in chips) 
Seat 5: Painkiller72 ($100 in chips) 
Seat 6: skolombi77 ($82.97 in chips) 
Seat 7: ka100pka527 ($41.50 in chips) 
Seat 8: matiko09 ($100 in chips) 
Seat 9: Moszes360 ($145.58 in chips) 
skolombi77: posts small blind $0.50
ka100pka527: posts big blind $1
ipashutapkom: sits out 
*** HOLE CARDS ***
Dealt to matiko09 [4d 3c]
matiko09: folds 
Moszes360: folds 
HomerrrJay: folds 
matiko09 leaves the table
ozone2003: folds 
vrnMike: raises $1 to $2
Painkiller72: folds 
skolombi77: folds 
ka100pka527: raises $5 to $7
vrnMike: raises $8.50 to $15.50
ka100pka527: raises $26 to $41.50 and is all-in
vrnMike: calls $26
*** FLOP *** [Td Ts 2h]
darren1031 joins the table at seat #8 
*** TURN *** [Td Ts 2h] [8s]
*** RIVER *** [Td Ts 2h 8s] [6d]
*** SHOW DOWN ***
ka100pka527: shows [7c 7s] (two pair, Tens and Sevens)
vrnMike: shows [Kc Ad] (a pair of Tens)
ka100pka527 collected $81 from pot
*** SUMMARY ***
Total pot $83.50 | Rake $2.50 
Board [Td Ts 2h 8s 6d]
Seat 1: HomerrrJay folded before Flop (didn't bet)
Seat 2: ozone2003 folded before Flop (didn't bet)
Seat 3: vrnMike showed [Kc Ad] and lost with a pair of Tens
Seat 5: Painkiller72 (button) folded before Flop (didn't bet)
Seat 6: skolombi77 (small blind) folded before Flop
Seat 7: ka100pka527 (big blind) showed [7c 7s] and won ($81) with two pair, Tens and Sevens
Seat 8: matiko09 folded before Flop (didn't bet)
Seat 9: Moszes360 folded before Flop (didn't bet)





PokerStars Hand #152559880873:  Hold'em No Limit ($0.50/$1.00 USD) - 2016/04/28 15:21:50 CET [2016/04/28 9:21:50 ET]
Table 'Erynia' 9-max Seat #3 is the button
Seat 1: I The King I ($100 in chips) 
Seat 2: matiko09 ($139.82 in chips) 
Seat 3: vilo1070 ($100 in chips) 
Seat 4: omorfadramou ($109.68 in chips) 
Seat 5: RMilPoker ($108.68 in chips) 
Seat 6: peevoajax ($100 in chips) 
Seat 7: vrnMike ($113.74 in chips) 
Seat 8: YourKicker78 ($90.59 in chips) 
Seat 9: ruslik_by ($53.61 in chips) 
omorfadramou: posts small blind $0.50
RMilPoker: posts big blind $1
*** HOLE CARDS ***
Dealt to matiko09 [Tc 8c]
peevoajax: folds 
vrnMike: folds 
YourKicker78: folds 
ruslik_by: folds 
I The King I: folds 
matiko09: raises $1.50 to $2.50
vilo1070: folds 
omorfadramou: folds 
RMilPoker: folds 
Uncalled bet ($1.50) returned to matiko09
matiko09 collected $2.50 from pot
matiko09: doesn't show hand 
*** SUMMARY ***
Total pot $2.50 | Rake $0 
Seat 1: I The King I folded before Flop (didn't bet)
Seat 2: matiko09 collected ($2.50)
Seat 3: vilo1070 (button) folded before Flop (didn't bet)
Seat 4: omorfadramou (small blind) folded before Flop
Seat 5: RMilPoker (big blind) folded before Flop
Seat 6: peevoajax folded before Flop (didn't bet)
Seat 7: vrnMike folded before Flop (didn't bet)
Seat 8: YourKicker78 folded before Flop (didn't bet)
Seat 9: ruslik_by folded before Flop (didn't bet)





PokerStars Hand #152559883307:  Hold'em No Limit ($0.50/$1.00 USD) - 2016/04/28 15:21:54 CET [2016/04/28 9:21:54 ET]
Table 'Agapenor III' 9-max Seat #8 is the button
Seat 1: I The King I ($105.17 in chips) 
Seat 2: cerbisor1 ($38.50 in chips) 
Seat 3: sanpidk ($145.41 in chips) 
Seat 4: matiko09 ($100 in chips) 
Seat 5: Painkiller72 ($103.52 in chips) 
Seat 6: azzad2007 ($116.43 in chips) 
Seat 7: tylerz71 ($121.48 in chips) 
Seat 8: Ceanucs ($52.26 in chips) 
Seat 9: DYO1000 ($41.49 in chips) 
DYO1000: posts small blind $0.50
I The King I: posts big blind $1
*** HOLE CARDS ***
Dealt to matiko09 [3s 2s]
cerbisor1: folds 
sanpidk: folds 
matiko09: folds 
Painkiller72: folds 
azzad2007: folds 
tylerz71: folds 
Ceanucs: calls $1
DYO1000: calls $0.50
I The King I: checks 
*** FLOP *** [Kc Ts 8s]
DYO1000: checks 
I The King I: checks 
Ceanucs: checks 
*** TURN *** [Kc Ts 8s] [9s]
DYO1000: checks 
I The King I: checks 
Ceanucs: checks 
*** RIVER *** [Kc Ts 8s 9s] [Js]
DYO1000: checks 
I The King I: checks 
Ceanucs: checks 
*** SHOW DOWN ***
DYO1000: shows [Jh 8h] (two pair, Jacks and Eights)
I The King I: shows [6s 3d] (a flush, Jack high)
Ceanucs: shows [7s 6c] (a straight flush, Seven to Jack)
Ceanucs collected $2.85 from pot
*** SUMMARY ***
Total pot $3 | Rake $0.15 
Board [Kc Ts 8s 9s Js]
Seat 1: I The King I (big blind) showed [6s 3d] and lost with a flush, Jack high
Seat 2: cerbisor1 folded before Flop (didn't bet)
Seat 3: sanpidk folded before Flop (didn't bet)
Seat 4: matiko09 folded before Flop (didn't bet)
Seat 5: Painkiller72 folded before Flop (didn't bet)
Seat 6: azzad2007 folded before Flop (didn't bet)
Seat 7: tylerz71 folded before Flop (didn't bet)
Seat 8: Ceanucs (button) showed [7s 6c] and won ($2.85) with a straight flush, Seven to Jack
Seat 9: DYO1000 (small blind) showed [Jh 8h] and lost with two pair, Jacks and Eights





PokerStars Hand #152559885764:  Hold'em No Limit ($1/$2 USD) - 2016/04/28 15:21:59 CET [2016/04/28 9:21:59 ET]
Table 'Idomeneus II' 9-max Seat #7 is the button
Seat 1: 13Ghosts ($253.11 in chips) 
Seat 2: libbyyww ($388.78 in chips) 
Seat 3: adrenalin333 ($157.93 in chips) 
Seat 4: SoNe1988 ($87 in chips) 
Seat 5: matiko09 ($217.11 in chips) 
Seat 6: rmanjkeee ($80 in chips) 
Seat 7: ersevi6 ($232.03 in chips) 
Seat 8: di0d80 ($223.50 in chips) 
Seat 9: prominente ($200 in chips) 
di0d80: posts small blind $1
prominente: posts big blind $2
*** HOLE CARDS ***
Dealt to matiko09 [3d 3c]
13Ghosts: folds 
libbyyww: folds 
adrenalin333: calls $2
SoNe1988: raises $6 to $8
matiko09: calls $8
rmanjkeee: raises $16 to $24
ersevi6: folds 
di0d80: folds 
prominente: folds 
adrenalin333: folds 
SoNe1988: folds 
matiko09: folds 
Uncalled bet ($16) returned to rmanjkeee
rmanjkeee collected $29 from pot
rmanjkeee: doesn't show hand 
*** SUMMARY ***
Total pot $29 | Rake $0 
Seat 1: 13Ghosts folded before Flop (didn't bet)
Seat 2: libbyyww folded before Flop (didn't bet)
Seat 3: adrenalin333 folded before Flop
Seat 4: SoNe1988 folded before Flop
Seat 5: matiko09 folded before Flop
Seat 6: rmanjkeee collected ($29)
Seat 7: ersevi6 (button) folded before Flop (didn't bet)
Seat 8: di0d80 (small blind) folded before Flop
Seat 9: prominente (big blind) folded before Flop





PokerStars Hand #152559893276:  Hold'em No Limit (€0.50/€1.00 EUR) - 2016/04/28 15:22:11 CET [2016/04/28 9:22:11 ET]
Table 'Lumiere II' 9-max Seat #2 is the button
Seat 1: vrnMike (€150.19 in chips) 
Seat 2: Racushniak (€108.88 in chips) 
Seat 4: ruslik_by (€56.20 in chips) 
Seat 5: Schmidy7 (€60.20 in chips) 
Seat 6: azzad2007 (€98.50 in chips) 
Seat 7: hammerwife (€120.18 in chips) 
Seat 8: sanpidk (€105.62 in chips) 
Seat 9: matiko09 (€100 in chips) 
ruslik_by: posts small blind €0.50
Schmidy7: posts big blind €1
*** HOLE CARDS ***
Dealt to matiko09 [Th 8h]
azzad2007: folds 
hammerwife: folds 
sanpidk: folds 
matiko09: folds 
vrnMike: raises €1 to €2
Racushniak: calls €2
ruslik_by: folds 
Schmidy7: folds 
*** FLOP *** [3c 8c Ah]
vrnMike: checks 
Racushniak: bets €2
vrnMike: calls €2
*** TURN *** [3c 8c Ah] [9h]
vrnMike: checks 
Racushniak: checks 
*** RIVER *** [3c 8c Ah 9h] [Qd]
vrnMike: bets €3
Racushniak: folds 
Uncalled bet (€3) returned to vrnMike
vrnMike collected €9.02 from pot
*** SUMMARY ***
Total pot €9.50 | Rake €0.48 
Board [3c 8c Ah 9h Qd]
Seat 1: vrnMike collected (€9.02)
Seat 2: Racushniak (button) folded on the River
Seat 4: ruslik_by (small blind) folded before Flop
Seat 5: Schmidy7 (big blind) folded before Flop
Seat 6: azzad2007 folded before Flop (didn't bet)
Seat 7: hammerwife folded before Flop (didn't bet)
Seat 8: sanpidk folded before Flop (didn't bet)
Seat 9: matiko09 folded before Flop (didn't bet)





PokerStars Hand #152559894325:  Hold'em No Limit ($0.50/$1.00 USD) - 2016/04/28 15:22:13 CET [2016/04/28 9:22:13 ET]
Table 'Halleria' 9-max Seat #7 is the button
Seat 1: vrnMike ($106.28 in chips) 
Seat 2: R1aki ($103 in chips) 
Seat 3: ozone2003 ($100 in chips) 
Seat 4: ka100pka527 ($38.50 in chips) 
Seat 6: hammerwife ($142.64 in chips) 
Seat 7: I The King I ($100 in chips) 
Seat 8: sanpidk ($112.12 in chips) 
Seat 9: matiko09 ($100 in chips) 
sanpidk: posts small blind $0.50
matiko09: posts big blind $1
*** HOLE CARDS ***
Dealt to matiko09 [Kd Td]
vrnMike: folds 
R1aki: folds 
ozone2003: folds 
ka100pka527: raises $2 to $3
hammerwife: folds 
gcz_1886_1 joins the table at seat #5 
I The King I: folds 
sanpidk: folds 
matiko09: folds 
Uncalled bet ($2) returned to ka100pka527
ka100pka527 collected $2.50 from pot
ka100pka527: doesn't show hand 
*** SUMMARY ***
Total pot $2.50 | Rake $0 
Seat 1: vrnMike folded before Flop (didn't bet)
Seat 2: R1aki folded before Flop (didn't bet)
Seat 3: ozone2003 folded before Flop (didn't bet)
Seat 4: ka100pka527 collected ($2.50)
Seat 6: hammerwife folded before Flop (didn't bet)
Seat 7: I The King I (button) folded before Flop (didn't bet)
Seat 8: sanpidk (small blind) folded before Flop
Seat 9: matiko09 (big blind) folded before Flop





PokerStars Hand #152559894681:  Hold'em No Limit ($0.50/$1.00 USD) - 2016/04/28 15:22:14 CET [2016/04/28 9:22:14 ET]
Table 'Erynia' 9-max Seat #4 is the button
Seat 1: I The King I ($100 in chips) 
Seat 2: matiko09 ($141.32 in chips) 
Seat 3: vilo1070 ($100 in chips) 
Seat 4: omorfadramou ($109.18 in chips) 
Seat 5: RMilPoker ($107.68 in chips) 
Seat 6: peevoajax ($100 in chips) 
Seat 7: vrnMike ($113.74 in chips) 
Seat 8: YourKicker78 ($90.59 in chips) 
Seat 9: ruslik_by ($53.61 in chips) 
RMilPoker: posts small blind $0.50
peevoajax: posts big blind $1
*** HOLE CARDS ***
Dealt to matiko09 [7d Kh]
vrnMike: folds 
YourKicker78: raises $2 to $3
ruslik_by: folds 
I The King I: folds 
matiko09: folds 
vilo1070: folds 
omorfadramou: folds 
RMilPoker: folds 
peevoajax: folds 
Uncalled bet ($2) returned to YourKicker78
YourKicker78 collected $2.50 from pot
YourKicker78: doesn't show hand 
*** SUMMARY ***
Total pot $2.50 | Rake $0 
Seat 1: I The King I folded before Flop (didn't bet)
Seat 2: matiko09 folded before Flop (didn't bet)
Seat 3: vilo1070 folded before Flop (didn't bet)
Seat 4: omorfadramou (button) folded before Flop (didn't bet)
Seat 5: RMilPoker (small blind) folded before Flop
Seat 6: peevoajax (big blind) folded before Flop
Seat 7: vrnMike folded before Flop (didn't bet)
Seat 8: YourKicker78 collected ($2.50)
Seat 9: ruslik_by folded before Flop (didn't bet)





PokerStars Hand #152559901357:  Hold'em No Limit ($0.50/$1.00 USD) - 2016/04/28 15:22:25 CET [2016/04/28 9:22:25 ET]
Table 'Ciurlionis' 9-max Seat #8 is the button
Seat 1: sanpidk ($109.08 in chips) 
Seat 2: liuzhi14 ($50.05 in chips) 
Seat 3: I The King I ($127.50 in chips) 
Seat 4: ruslik_by ($207 in chips) 
Seat 5: matiko09 ($183.28 in chips) 
Seat 6: vrnMike ($100 in chips) 
Seat 7: Stopton ($93.35 in chips) 
Seat 8: omorfadramou ($100 in chips) 
Seat 9: Painkiller72 ($105.05 in chips) 
Painkiller72: posts small blind $0.50
sanpidk: posts big blind $1
*** HOLE CARDS ***
Dealt to matiko09 [9d Jh]
liuzhi14: raises $2 to $3
I The King I: folds 
ruslik_by: folds 
matiko09: folds 
vrnMike: folds 
Stopton: folds 
omorfadramou: folds 
Painkiller72: folds 
sanpidk: folds 
Uncalled bet ($2) returned to liuzhi14
liuzhi14 collected $2.50 from pot
liuzhi14: doesn't show hand 
*** SUMMARY ***
Total pot $2.50 | Rake $0 
Seat 1: sanpidk (big blind) folded before Flop
Seat 2: liuzhi14 collected ($2.50)
Seat 3: I The King I folded before Flop (didn't bet)
Seat 4: ruslik_by folded before Flop (didn't bet)
Seat 5: matiko09 folded before Flop (didn't bet)
Seat 6: vrnMike folded before Flop (didn't bet)
Seat 7: Stopton folded before Flop (didn't bet)
Seat 8: omorfadramou (button) folded before Flop (didn't bet)
Seat 9: Painkiller72 (small blind) folded before Flop





PokerStars Hand #152559902492:  Hold'em No Limit ($0.50/$1.00 USD) - 2016/04/28 15:22:27 CET [2016/04/28 9:22:27 ET]
Table 'Zachia II' 9-max Seat #1 is the button
Seat 1: greyman571 ($137.05 in chips) 
Seat 2: sanpidk ($150.98 in chips) 
Seat 3: matiko09 ($118.82 in chips) 
Seat 4: omorfadramou ($100 in chips) 
Seat 5: vrnMike ($103 in chips) 
Seat 6: koksskrt ($109.04 in chips) 
Seat 7: ozone2003 ($100 in chips) 
Seat 9: Painkiller72 ($100.56 in chips) 
sanpidk: posts small blind $0.50
matiko09: posts big blind $1
CI58: sits out 
*** HOLE CARDS ***
Dealt to matiko09 [Ac Ts]
omorfadramou: folds 
vrnMike: folds 
koksskrt: folds 
ozone2003: folds 
Painkiller72: raises $1.50 to $2.50
greyman571: folds 
sanpidk: folds 
matiko09: calls $1.50
*** FLOP *** [4h Ah 7h]
matiko09: checks 
Painkiller72: checks 
*** TURN *** [4h Ah 7h] [Qh]
matiko09: checks 
Painkiller72: checks 
*** RIVER *** [4h Ah 7h Qh] [Ad]
matiko09: checks 
Painkiller72: checks 
*** SHOW DOWN ***
matiko09: shows [Ac Ts] (three of a kind, Aces)
Painkiller72: shows [2d 2h] (a flush, Ace high)
Painkiller72 collected $5.22 from pot
*** SUMMARY ***
Total pot $5.50 | Rake $0.28 
Board [4h Ah 7h Qh Ad]
Seat 1: greyman571 (button) folded before Flop (didn't bet)
Seat 2: sanpidk (small blind) folded before Flop
Seat 3: matiko09 (big blind) showed [Ac Ts] and lost with three of a kind, Aces
Seat 4: omorfadramou folded before Flop (didn't bet)
Seat 5: vrnMike folded before Flop (didn't bet)
Seat 6: koksskrt folded before Flop (didn't bet)
Seat 7: ozone2003 folded before Flop (didn't bet)
Seat 9: Painkiller72 showed [2d 2h] and won ($5.22) with a flush, Ace high





PokerStars Hand #152559912107:  Hold'em No Limit ($0.50/$1.00 USD) - 2016/04/28 15:22:43 CET [2016/04/28 9:22:43 ET]
Table 'Erynia' 9-max Seat #5 is the button
Seat 1: I The King I ($100 in chips) 
Seat 2: matiko09 ($141.32 in chips) 
Seat 3: vilo1070 ($100 in chips) 
Seat 4: omorfadramou ($109.18 in chips) 
Seat 5: RMilPoker ($107.18 in chips) 
Seat 6: peevoajax ($100 in chips) 
Seat 7: vrnMike ($113.74 in chips) 
Seat 8: YourKicker78 ($92.09 in chips) 
Seat 9: ruslik_by ($53.61 in chips) 
peevoajax: posts small blind $0.50
vrnMike: posts big blind $1
*** HOLE CARDS ***
Dealt to matiko09 [Ac Qh]
YourKicker78: folds 
ruslik_by: raises $2 to $3
I The King I: folds 
matiko09: calls $3
vilo1070: folds 
omorfadramou: folds 
RMilPoker: calls $3
peevoajax: folds 
vrnMike: folds 
*** FLOP *** [4s 4c 2h]
ruslik_by: checks 
matiko09: bets $5.18
RMilPoker: folds 
ruslik_by: folds 
Uncalled bet ($5.18) returned to matiko09
matiko09 collected $9.98 from pot
matiko09: doesn't show hand 
*** SUMMARY ***
Total pot $10.50 | Rake $0.52 
Board [4s 4c 2h]
Seat 1: I The King I folded before Flop (didn't bet)
Seat 2: matiko09 collected ($9.98)
Seat 3: vilo1070 folded before Flop (didn't bet)
Seat 4: omorfadramou folded before Flop (didn't bet)
Seat 5: RMilPoker (button) folded on the Flop
Seat 6: peevoajax (small blind) folded before Flop
Seat 7: vrnMike (big blind) folded before Flop
Seat 8: YourKicker78 folded before Flop (didn't bet)
Seat 9: ruslik_by folded on the Flop





PokerStars Hand #152559918857:  Hold'em No Limit ($0.50/$1.00 USD) - 2016/04/28 15:22:54 CET [2016/04/28 9:22:54 ET]
Table 'Halleria' 9-max Seat #8 is the button
Seat 1: vrnMike ($106.28 in chips) 
Seat 2: R1aki ($103 in chips) 
Seat 3: ozone2003 ($100 in chips) 
Seat 4: ka100pka527 ($40 in chips) 
Seat 6: hammerwife ($142.64 in chips) 
Seat 7: I The King I ($100 in chips) 
Seat 8: sanpidk ($111.62 in chips) 
Seat 9: matiko09 ($100 in chips) 
matiko09: posts small blind $0.50
vrnMike: posts big blind $1
gcz_1886_1: sits out 
*** HOLE CARDS ***
Dealt to matiko09 [8c 4c]
R1aki: raises $1.50 to $2.50
ozone2003: folds 
ka100pka527: folds 
hammerwife: folds 
I The King I: folds 
sanpidk: calls $2.50
matiko09: folds 
vrnMike: folds 
*** FLOP *** [7d 6c 8s]
R1aki: checks 
sanpidk: bets $4
R1aki: calls $4
*** TURN *** [7d 6c 8s] [Jh]
R1aki: checks 
sanpidk: checks 
*** RIVER *** [7d 6c 8s Jh] [3c]
R1aki: checks 
sanpidk: checks 
*** SHOW DOWN ***
R1aki: shows [Ts Tc] (a pair of Tens)
sanpidk: mucks hand 
R1aki collected $13.78 from pot
*** SUMMARY ***
Total pot $14.50 | Rake $0.72 
Board [7d 6c 8s Jh 3c]
Seat 1: vrnMike (big blind) folded before Flop
Seat 2: R1aki showed [Ts Tc] and won ($13.78) with a pair of Tens
Seat 3: ozone2003 folded before Flop (didn't bet)
Seat 4: ka100pka527 folded before Flop (didn't bet)
Seat 6: hammerwife folded before Flop (didn't bet)
Seat 7: I The King I folded before Flop (didn't bet)
Seat 8: sanpidk (button) mucked [Ad Td]
Seat 9: matiko09 (small blind) folded before Flop





PokerStars Hand #152559920861:  Hold'em No Limit ($0.50/$1.00 USD) - 2016/04/28 15:22:57 CET [2016/04/28 9:22:57 ET]
Table 'Ciurlionis' 9-max Seat #9 is the button
Seat 1: sanpidk ($108.08 in chips) 
Seat 2: liuzhi14 ($51.55 in chips) 
Seat 3: I The King I ($127.50 in chips) 
Seat 4: ruslik_by ($207 in chips) 
Seat 5: matiko09 ($183.28 in chips) 
Seat 6: vrnMike ($100 in chips) 
Seat 7: Stopton ($93.35 in chips) 
Seat 8: omorfadramou ($100 in chips) 
Seat 9: Painkiller72 ($104.55 in chips) 
sanpidk: posts small blind $0.50
liuzhi14: posts big blind $1
*** HOLE CARDS ***
Dealt to matiko09 [Qh 4d]
I The King I: folds 
ruslik_by: raises $2 to $3
matiko09: folds 
vrnMike: folds 
Stopton: raises $6 to $9
omorfadramou: folds 
Painkiller72: folds 
sanpidk: folds 
liuzhi14: folds 
ruslik_by: folds 
Uncalled bet ($6) returned to Stopton
Stopton collected $7.50 from pot
Stopton: doesn't show hand 
*** SUMMARY ***
Total pot $7.50 | Rake $0 
Seat 1: sanpidk (small blind) folded before Flop
Seat 2: liuzhi14 (big blind) folded before Flop
Seat 3: I The King I folded before Flop (didn't bet)
Seat 4: ruslik_by folded before Flop
Seat 5: matiko09 folded before Flop (didn't bet)
Seat 6: vrnMike folded before Flop (didn't bet)
Seat 7: Stopton collected ($7.50)
Seat 8: omorfadramou folded before Flop (didn't bet)
Seat 9: Painkiller72 (button) folded before Flop (didn't bet)





PokerStars Hand #152559932524:  Hold'em No Limit ($0.50/$1.00 USD) - 2016/04/28 15:23:16 CET [2016/04/28 9:23:16 ET]
Table 'Zachia II' 9-max Seat #2 is the button
Seat 1: greyman571 ($137.05 in chips) 
Seat 2: sanpidk ($150.48 in chips) 
Seat 3: matiko09 ($116.32 in chips) 
Seat 4: omorfadramou ($100 in chips) 
Seat 5: vrnMike ($103 in chips) 
Seat 6: koksskrt ($109.04 in chips) 
Seat 7: ozone2003 ($100 in chips) 
Seat 9: Painkiller72 ($103.28 in chips) 
matiko09: posts small blind $0.50
omorfadramou: posts big blind $1
CI58: sits out 
*** HOLE CARDS ***
Dealt to matiko09 [4c 5s]
vrnMike: folds 
koksskrt: folds 
ozone2003: folds 
Painkiller72: folds 
greyman571: raises $2 to $3
sanpidk: calls $3
matiko09: folds 
omorfadramou: folds 
*** FLOP *** [Td 5h Ah]
greyman571: bets $3
sanpidk: raises $5.50 to $8.50
greyman571: calls $5.50
*** TURN *** [Td 5h Ah] [7d]
greyman571: checks 
sanpidk: bets $17
greyman571: folds 
Uncalled bet ($17) returned to sanpidk
sanpidk collected $23.28 from pot
sanpidk: doesn't show hand 
*** SUMMARY ***
Total pot $24.50 | Rake $1.22 
Board [Td 5h Ah 7d]
Seat 1: greyman571 folded on the Turn
Seat 2: sanpidk (button) collected ($23.28)
Seat 3: matiko09 (small blind) folded before Flop
Seat 4: omorfadramou (big blind) folded before Flop
Seat 5: vrnMike folded before Flop (didn't bet)
Seat 6: koksskrt folded before Flop (didn't bet)
Seat 7: ozone2003 folded before Flop (didn't bet)
Seat 9: Painkiller72 folded before Flop (didn't bet)





PokerStars Hand #152559934465:  Hold'em No Limit ($0.50/$1.00 USD) - 2016/04/28 15:23:19 CET [2016/04/28 9:23:19 ET]
Table 'Agapenor III' 9-max Seat #9 is the button
Seat 1: I The King I ($104.17 in chips) 
Seat 2: cerbisor1 ($38.50 in chips) 
Seat 3: sanpidk ($145.41 in chips) 
Seat 4: matiko09 ($100 in chips) 
Seat 5: Painkiller72 ($103.52 in chips) 
Seat 6: azzad2007 ($116.43 in chips) 
Seat 7: tylerz71 ($121.48 in chips) 
Seat 8: Ceanucs ($54.11 in chips) 
Seat 9: DYO1000 ($40.49 in chips) 
I The King I: posts small blind $0.50
cerbisor1: posts big blind $1
*** HOLE CARDS ***
Dealt to matiko09 [Qc 8s]
sanpidk: folds 
matiko09: folds 
Painkiller72: folds 
azzad2007: folds 
tylerz71: folds 
Ceanucs: calls $1
DYO1000: raises $2 to $3
I The King I: folds 
cerbisor1: folds 
Ceanucs: calls $2
*** FLOP *** [Td 6d Js]
Ceanucs: checks 
DYO1000: bets $3.56
Ceanucs: calls $3.56
*** TURN *** [Td 6d Js] [Ah]
Ceanucs: bets $5
DYO1000: calls $5
*** RIVER *** [Td 6d Js Ah] [Qh]
Ceanucs: checks 
DYO1000: bets $11.69
Ceanucs: folds 
Uncalled bet ($11.69) returned to DYO1000
DYO1000 collected $23.39 from pot
DYO1000: doesn't show hand 
*** SUMMARY ***
Total pot $24.62 | Rake $1.23 
Board [Td 6d Js Ah Qh]
Seat 1: I The King I (small blind) folded before Flop
Seat 2: cerbisor1 (big blind) folded before Flop
Seat 3: sanpidk folded before Flop (didn't bet)
Seat 4: matiko09 folded before Flop (didn't bet)
Seat 5: Painkiller72 folded before Flop (didn't bet)
Seat 6: azzad2007 folded before Flop (didn't bet)
Seat 7: tylerz71 folded before Flop (didn't bet)
Seat 8: Ceanucs folded on the River
Seat 9: DYO1000 (button) collected ($23.39)





PokerStars Hand #152559941162:  Hold'em No Limit ($1/$2 USD) - 2016/04/28 15:23:30 CET [2016/04/28 9:23:30 ET]
Table 'Idomeneus II' 9-max Seat #8 is the button
Seat 1: 13Ghosts ($253.11 in chips) 
Seat 2: libbyyww ($388.78 in chips) 
Seat 3: adrenalin333 ($155.93 in chips) 
Seat 4: SoNe1988 ($80 in chips) 
Seat 5: matiko09 ($209.11 in chips) 
Seat 6: rmanjkeee ($101 in chips) 
Seat 7: ersevi6 ($232.03 in chips) 
Seat 8: di0d80 ($222.50 in chips) 
Seat 9: prominente ($200 in chips) 
prominente: posts small blind $1
13Ghosts: posts big blind $2
*** HOLE CARDS ***
Dealt to matiko09 [3c 9d]
libbyyww: folds 
adrenalin333: raises $2 to $4
SoNe1988: folds 
matiko09: folds 
rmanjkeee: folds 
ersevi6: folds 
di0d80: folds 
prominente: folds 
13Ghosts: folds 
Uncalled bet ($2) returned to adrenalin333
adrenalin333 collected $5 from pot
adrenalin333: doesn't show hand 
*** SUMMARY ***
Total pot $5 | Rake $0 
Seat 1: 13Ghosts (big blind) folded before Flop
Seat 2: libbyyww folded before Flop (didn't bet)
Seat 3: adrenalin333 collected ($5)
Seat 4: SoNe1988 folded before Flop (didn't bet)
Seat 5: matiko09 folded before Flop (didn't bet)
Seat 6: rmanjkeee folded before Flop (didn't bet)
Seat 7: ersevi6 folded before Flop (didn't bet)
Seat 8: di0d80 (button) folded before Flop (didn't bet)
Seat 9: prominente (small blind) folded before Flop





PokerStars Hand #152559944189:  Hold'em No Limit (€0.50/€1.00 EUR) - 2016/04/28 15:23:36 CET [2016/04/28 9:23:36 ET]
Table 'Lumiere II' 9-max Seat #4 is the button
Seat 1: vrnMike (€155.21 in chips) 
Seat 2: Racushniak (€104.88 in chips) 
Seat 4: ruslik_by (€55.70 in chips) 
Seat 5: Schmidy7 (€59.20 in chips) 
Seat 6: azzad2007 (€98.50 in chips) 
Seat 7: hammerwife (€120.18 in chips) 
Seat 8: sanpidk (€105.62 in chips) 
Seat 9: matiko09 (€100 in chips) 
Schmidy7: posts small blind €0.50
azzad2007: posts big blind €1
*** HOLE CARDS ***
Dealt to matiko09 [4c 6c]
hammerwife: raises €2 to €3
sanpidk: folds 
matiko09: folds 
vrnMike: folds 
Racushniak: folds 
ruslik_by: folds 
Schmidy7: folds 
azzad2007: folds 
Uncalled bet (€2) returned to hammerwife
hammerwife collected €2.50 from pot
hammerwife: doesn't show hand 
*** SUMMARY ***
Total pot €2.50 | Rake €0 
Seat 1: vrnMike folded before Flop (didn't bet)
Seat 2: Racushniak folded before Flop (didn't bet)
Seat 4: ruslik_by (button) folded before Flop (didn't bet)
Seat 5: Schmidy7 (small blind) folded before Flop
Seat 6: azzad2007 (big blind) folded before Flop
Seat 7: hammerwife collected (€2.50)
Seat 8: sanpidk folded before Flop (didn't bet)
Seat 9: matiko09 folded before Flop (didn't bet)





PokerStars Hand #152559954765:  Hold'em No Limit ($0.50/$1.00 USD) - 2016/04/28 15:23:53 CET [2016/04/28 9:23:53 ET]
Table 'Erynia' 9-max Seat #6 is the button
Seat 1: I The King I ($100 in chips) 
Seat 2: matiko09 ($148.30 in chips) 
Seat 3: vilo1070 ($100 in chips) 
Seat 4: omorfadramou ($109.18 in chips) 
Seat 5: RMilPoker ($104.18 in chips) 
Seat 6: peevoajax ($100 in chips) 
Seat 7: vrnMike ($112.74 in chips) 
Seat 8: YourKicker78 ($92.09 in chips) 
Seat 9: ruslik_by ($50.61 in chips) 
vrnMike: posts small blind $0.50
YourKicker78: posts big blind $1
*** HOLE CARDS ***
Dealt to matiko09 [Jh Ad]
ruslik_by: folds 
I The King I: folds 
matiko09: raises $2 to $3
vilo1070: folds 
omorfadramou: folds 
RMilPoker: folds 
peevoajax: folds 
vrnMike: folds 
YourKicker78: folds 
Uncalled bet ($2) returned to matiko09
matiko09 collected $2.50 from pot
matiko09: doesn't show hand 
*** SUMMARY ***
Total pot $2.50 | Rake $0 
Seat 1: I The King I folded before Flop (didn't bet)
Seat 2: matiko09 collected ($2.50)
Seat 3: vilo1070 folded before Flop (didn't bet)
Seat 4: omorfadramou folded before Flop (didn't bet)
Seat 5: RMilPoker folded before Flop (didn't bet)
Seat 6: peevoajax (button) folded before Flop (didn't bet)
Seat 7: vrnMike (small blind) folded before Flop
Seat 8: YourKicker78 (big blind) folded before Flop
Seat 9: ruslik_by folded before Flop (didn't bet)





PokerStars Hand #152559961573:  Hold'em No Limit ($0.50/$1.00 USD) - 2016/04/28 15:24:04 CET [2016/04/28 9:24:04 ET]
Table 'Bruwer' 9-max Seat #4 is the button
Seat 2: ruslik_by ($42.85 in chips) 
Seat 3: koksskrt ($143.01 in chips) 
Seat 4: matiko09 ($136.54 in chips) 
Seat 5: Carloszhang ($98.34 in chips) 
Seat 6: I The King I ($109.02 in chips) 
Seat 7: R1aki ($229.66 in chips) 
Seat 8: lumen21 ($105 in chips) 
Seat 9: Dantist1122 ($127.15 in chips) 
Carloszhang: posts small blind $0.50
I The King I: posts big blind $1
peevoajax: sits out 
*** HOLE CARDS ***
Dealt to matiko09 [9c Th]
R1aki: folds 
lumen21: raises $2 to $3
Dantist1122: folds 
ruslik_by: folds 
koksskrt: folds 
matiko09: folds 
Carloszhang: folds 
I The King I: folds 
Uncalled bet ($2) returned to lumen21
lumen21 collected $2.50 from pot
lumen21: doesn't show hand 
*** SUMMARY ***
Total pot $2.50 | Rake $0 
Seat 2: ruslik_by folded before Flop (didn't bet)
Seat 3: koksskrt folded before Flop (didn't bet)
Seat 4: matiko09 (button) folded before Flop (didn't bet)
Seat 5: Carloszhang (small blind) folded before Flop
Seat 6: I The King I (big blind) folded before Flop
Seat 7: R1aki folded before Flop (didn't bet)
Seat 8: lumen21 collected ($2.50)
Seat 9: Dantist1122 folded before Flop (didn't bet)





PokerStars Hand #152559961491:  Hold'em No Limit ($0.50/$1.00 USD) - 2016/04/28 15:24:04 CET [2016/04/28 9:24:04 ET]
Table 'Halleria' 9-max Seat #9 is the button
Seat 1: vrnMike ($105.28 in chips) 
Seat 4: ka100pka527 ($40 in chips) 
Seat 6: hammerwife ($142.64 in chips) 
Seat 7: I The King I ($100 in chips) 
Seat 8: sanpidk ($105.12 in chips) 
Seat 9: matiko09 ($100 in chips) 
vrnMike: posts small blind $0.50
R1aki: is sitting out 
ozone2003: is sitting out 
ka100pka527: posts big blind $1
gcz_1886_1: sits out 
*** HOLE CARDS ***
Dealt to matiko09 [3h Qd]
R1aki leaves the table
hammerwife: raises $1.50 to $2.50
I The King I: folds 
sanpidk: folds 
matiko09: folds 
vrnMike: folds 
ka100pka527: folds 
Uncalled bet ($1.50) returned to hammerwife
hammerwife collected $2.50 from pot
hammerwife: doesn't show hand 
*** SUMMARY ***
Total pot $2.50 | Rake $0 
Seat 1: vrnMike (small blind) folded before Flop
Seat 4: ka100pka527 (big blind) folded before Flop
Seat 6: hammerwife collected ($2.50)
Seat 7: I The King I folded before Flop (didn't bet)
Seat 8: sanpidk folded before Flop (didn't bet)
Seat 9: matiko09 (button) folded before Flop (didn't bet)





PokerStars Hand #152559962709:  Hold'em No Limit ($1/$2 USD) - 2016/04/28 15:24:06 CET [2016/04/28 9:24:06 ET]
Table 'Idomeneus II' 9-max Seat #9 is the button
Seat 1: 13Ghosts ($251.11 in chips) 
Seat 2: libbyyww ($388.78 in chips) 
Seat 3: adrenalin333 ($158.93 in chips) 
Seat 4: SoNe1988 ($80 in chips) 
Seat 5: matiko09 ($209.11 in chips) 
Seat 6: rmanjkeee ($101 in chips) 
Seat 7: ersevi6 ($232.03 in chips) 
Seat 8: di0d80 ($222.50 in chips) 
Seat 9: prominente ($200 in chips) 
13Ghosts: posts small blind $1
libbyyww: posts big blind $2
*** HOLE CARDS ***
Dealt to matiko09 [9h Ac]
adrenalin333: folds 
SoNe1988: folds 
matiko09: folds 
rmanjkeee: folds 
ersevi6: folds 
di0d80: folds 
prominente: raises $2 to $4
13Ghosts: folds 
libbyyww: folds 
Uncalled bet ($2) returned to prominente
prominente collected $5 from pot
prominente: doesn't show hand 
*** SUMMARY ***
Total pot $5 | Rake $0 
Seat 1: 13Ghosts (small blind) folded before Flop
Seat 2: libbyyww (big blind) folded before Flop
Seat 3: adrenalin333 folded before Flop (didn't bet)
Seat 4: SoNe1988 folded before Flop (didn't bet)
Seat 5: matiko09 folded before Flop (didn't bet)
Seat 6: rmanjkeee folded before Flop (didn't bet)
Seat 7: ersevi6 folded before Flop (didn't bet)
Seat 8: di0d80 folded before Flop (didn't bet)
Seat 9: prominente (button) collected ($5)





PokerStars Hand #152559963891:  Hold'em No Limit (€0.50/€1.00 EUR) - 2016/04/28 15:24:08 CET [2016/04/28 9:24:08 ET]
Table 'Lumiere II' 9-max Seat #5 is the button
Seat 1: vrnMike (€155.21 in chips) 
Seat 2: Racushniak (€104.88 in chips) 
Seat 4: ruslik_by (€55.70 in chips) 
Seat 5: Schmidy7 (€58.70 in chips) 
Seat 6: azzad2007 (€97.50 in chips) 
Seat 7: hammerwife (€121.68 in chips) 
Seat 8: sanpidk (€105.62 in chips) 
Seat 9: matiko09 (€100 in chips) 
azzad2007: posts small blind €0.50
hammerwife: posts big blind €1
*** HOLE CARDS ***
Dealt to matiko09 [Ks 9h]
sanpidk: folds 
matiko09: folds 
vrnMike: folds 
Racushniak: raises €2 to €3
ruslik_by: folds 
Schmidy7: calls €3
azzad2007: folds 
hammerwife: calls €2
*** FLOP *** [7s Qd Ts]
hammerwife: checks 
Racushniak: bets €5
Schmidy7: folds 
hammerwife: folds 
Uncalled bet (€5) returned to Racushniak
Racushniak collected €9.02 from pot
Racushniak: doesn't show hand 
*** SUMMARY ***
Total pot €9.50 | Rake €0.48 
Board [7s Qd Ts]
Seat 1: vrnMike folded before Flop (didn't bet)
Seat 2: Racushniak collected (€9.02)
Seat 4: ruslik_by folded before Flop (didn't bet)
Seat 5: Schmidy7 (button) folded on the Flop
Seat 6: azzad2007 (small blind) folded before Flop
Seat 7: hammerwife (big blind) folded on the Flop
Seat 8: sanpidk folded before Flop (didn't bet)
Seat 9: matiko09 folded before Flop (didn't bet)





PokerStars Hand #152559967151:  Hold'em No Limit ($0.50/$1.00 USD) - 2016/04/28 15:24:14 CET [2016/04/28 9:24:14 ET]
Table 'Ciurlionis' 9-max Seat #1 is the button
Seat 1: sanpidk ($107.58 in chips) 
Seat 2: liuzhi14 ($50.55 in chips) 
Seat 3: I The King I ($127.50 in chips) 
Seat 4: ruslik_by ($204 in chips) 
Seat 5: matiko09 ($183.28 in chips) 
Seat 6: vrnMike ($100 in chips) 
Seat 7: Stopton ($97.85 in chips) 
Seat 8: omorfadramou ($100 in chips) 
Seat 9: Painkiller72 ($104.55 in chips) 
liuzhi14: posts small blind $0.50
I The King I: posts big blind $1
*** HOLE CARDS ***
Dealt to matiko09 [Kd 3c]
ruslik_by: raises $2 to $3
matiko09: folds 
vrnMike: folds 
Stopton: folds 
omorfadramou: folds 
Painkiller72: folds 
sanpidk: folds 
liuzhi14: folds 
I The King I: folds 
Uncalled bet ($2) returned to ruslik_by
ruslik_by collected $2.50 from pot
ruslik_by: doesn't show hand 
*** SUMMARY ***
Total pot $2.50 | Rake $0 
Seat 1: sanpidk (button) folded before Flop (didn't bet)
Seat 2: liuzhi14 (small blind) folded before Flop
Seat 3: I The King I (big blind) folded before Flop
Seat 4: ruslik_by collected ($2.50)
Seat 5: matiko09 folded before Flop (didn't bet)
Seat 6: vrnMike folded before Flop (didn't bet)
Seat 7: Stopton folded before Flop (didn't bet)
Seat 8: omorfadramou folded before Flop (didn't bet)
Seat 9: Painkiller72 folded before Flop (didn't bet)





PokerStars Hand #152559976288:  Hold'em No Limit ($0.50/$1.00 USD) - 2016/04/28 15:24:29 CET [2016/04/28 9:24:29 ET]
Table 'Zachia II' 9-max Seat #3 is the button
Seat 1: greyman571 ($125.55 in chips) 
Seat 2: sanpidk ($162.26 in chips) 
Seat 3: matiko09 ($115.82 in chips) 
Seat 4: omorfadramou ($100 in chips) 
Seat 5: vrnMike ($103 in chips) 
Seat 6: koksskrt ($109.04 in chips) 
Seat 7: ozone2003 ($100 in chips) 
Seat 9: Painkiller72 ($103.28 in chips) 
omorfadramou: posts small blind $0.50
vrnMike: posts big blind $1
CI58: sits out 
*** HOLE CARDS ***
Dealt to matiko09 [Ac Kh]
koksskrt: folds 
ozone2003: folds 
Painkiller72: folds 
greyman571: folds 
sanpidk: folds 
matiko09: raises $1.27 to $2.27
omorfadramou: raises $5.73 to $8
vrnMike: folds 
matiko09: calls $5.73
*** FLOP *** [9c 6c 5d]
omorfadramou: bets $12.59
matiko09: folds 
Uncalled bet ($12.59) returned to omorfadramou
omorfadramou collected $16.15 from pot
omorfadramou: doesn't show hand 
*** SUMMARY ***
Total pot $17 | Rake $0.85 
Board [9c 6c 5d]
Seat 1: greyman571 folded before Flop (didn't bet)
Seat 2: sanpidk folded before Flop (didn't bet)
Seat 3: matiko09 (button) folded on the Flop
Seat 4: omorfadramou (small blind) collected ($16.15)
Seat 5: vrnMike (big blind) folded before Flop
Seat 6: koksskrt folded before Flop (didn't bet)
Seat 7: ozone2003 folded before Flop (didn't bet)
Seat 9: Painkiller72 folded before Flop (didn't bet)





PokerStars Hand #152559976331:  Hold'em No Limit ($0.50/$1.00 USD) - 2016/04/28 15:24:29 CET [2016/04/28 9:24:29 ET]
Table 'Halleria' 9-max Seat #1 is the button
Seat 1: vrnMike ($104.78 in chips) 
Seat 4: ka100pka527 ($39 in chips) 
Seat 5: gcz_1886_1 ($100 in chips) 
Seat 6: hammerwife ($144.14 in chips) 
Seat 7: I The King I ($100 in chips) 
Seat 8: sanpidk ($105.12 in chips) 
Seat 9: matiko09 ($100 in chips) 
ka100pka527: posts small blind $0.50
gcz_1886_1: posts big blind $1
*** HOLE CARDS ***
Dealt to matiko09 [3h 6d]
ozone2003 leaves the table
hammerwife: folds 
I The King I: folds 
sanpidk: folds 
maxxmeister joins the table at seat #3 
matiko09: folds 
vrnMike: folds 
ka100pka527: raises $2 to $3
gcz_1886_1: folds 
Uncalled bet ($2) returned to ka100pka527
ka100pka527 collected $2 from pot
ka100pka527: doesn't show hand 
*** SUMMARY ***
Total pot $2 | Rake $0 
Seat 1: vrnMike (button) folded before Flop (didn't bet)
Seat 4: ka100pka527 (small blind) collected ($2)
Seat 5: gcz_1886_1 (big blind) folded before Flop
Seat 6: hammerwife folded before Flop (didn't bet)
Seat 7: I The King I folded before Flop (didn't bet)
Seat 8: sanpidk folded before Flop (didn't bet)
Seat 9: matiko09 folded before Flop (didn't bet)





PokerStars Hand #152559977843:  Hold'em No Limit ($0.50/$1.00 USD) - 2016/04/28 15:24:31 CET [2016/04/28 9:24:31 ET]
Table 'Agapenor III' 9-max Seat #1 is the button
Seat 1: I The King I ($103.67 in chips) 
Seat 2: cerbisor1 ($37.50 in chips) 
Seat 3: sanpidk ($145.41 in chips) 
Seat 4: matiko09 ($100 in chips) 
Seat 5: Painkiller72 ($103.52 in chips) 
Seat 6: azzad2007 ($116.43 in chips) 
Seat 7: tylerz71 ($121.48 in chips) 
Seat 8: Ceanucs ($42.55 in chips) 
Seat 9: DYO1000 ($52.32 in chips) 
cerbisor1: posts small blind $0.50
sanpidk: posts big blind $1
*** HOLE CARDS ***
Dealt to matiko09 [8d 3h]
matiko09: folds 
Painkiller72: raises $1.50 to $2.50
azzad2007: folds 
tylerz71: folds 
Ceanucs: calls $2.50
DYO1000: folds 
I The King I: folds 
cerbisor1: folds 
sanpidk: folds 
*** FLOP *** [4d 5s 8c]
Painkiller72: bets $4.32
Ceanucs: calls $4.32
*** TURN *** [4d 5s 8c] [Ks]
Painkiller72: checks 
Ceanucs: checks 
*** RIVER *** [4d 5s 8c Ks] [Kh]
Painkiller72: checks 
Ceanucs: bets $6
Painkiller72: calls $6
*** SHOW DOWN ***
Ceanucs: shows [Jd Js] (two pair, Kings and Jacks)
Painkiller72: mucks hand 
Ceanucs collected $25.78 from pot
*** SUMMARY ***
Total pot $27.14 | Rake $1.36 
Board [4d 5s 8c Ks Kh]
Seat 1: I The King I (button) folded before Flop (didn't bet)
Seat 2: cerbisor1 (small blind) folded before Flop
Seat 3: sanpidk (big blind) folded before Flop
Seat 4: matiko09 folded before Flop (didn't bet)
Seat 5: Painkiller72 mucked [8s 9s]
Seat 6: azzad2007 folded before Flop (didn't bet)
Seat 7: tylerz71 folded before Flop (didn't bet)
Seat 8: Ceanucs showed [Jd Js] and won ($25.78) with two pair, Kings and Jacks
Seat 9: DYO1000 folded before Flop (didn't bet)





PokerStars Hand #152559981653:  Hold'em No Limit ($0.50/$1.00 USD) - 2016/04/28 15:24:38 CET [2016/04/28 9:24:38 ET]
Table 'Erynia' 9-max Seat #7 is the button
Seat 1: I The King I ($100 in chips) 
Seat 2: matiko09 ($149.80 in chips) 
Seat 3: vilo1070 ($100 in chips) 
Seat 4: omorfadramou ($109.18 in chips) 
Seat 5: RMilPoker ($104.18 in chips) 
Seat 6: peevoajax ($100 in chips) 
Seat 7: vrnMike ($112.24 in chips) 
Seat 8: YourKicker78 ($91.09 in chips) 
Seat 9: ruslik_by ($50.61 in chips) 
YourKicker78: posts small blind $0.50
ruslik_by: posts big blind $1
*** HOLE CARDS ***
Dealt to matiko09 [2c Kc]
I The King I: folds 
matiko09: folds 
vilo1070: folds 
omorfadramou: raises $2 to $3
RMilPoker: raises $6 to $9
peevoajax: folds 
vrnMike: folds 
YourKicker78: folds 
ruslik_by: folds 
omorfadramou: raises $11 to $20
RMilPoker: folds 
Uncalled bet ($11) returned to omorfadramou
omorfadramou collected $19.50 from pot
omorfadramou: doesn't show hand 
*** SUMMARY ***
Total pot $19.50 | Rake $0 
Seat 1: I The King I folded before Flop (didn't bet)
Seat 2: matiko09 folded before Flop (didn't bet)
Seat 3: vilo1070 folded before Flop (didn't bet)
Seat 4: omorfadramou collected ($19.50)
Seat 5: RMilPoker folded before Flop
Seat 6: peevoajax folded before Flop (didn't bet)
Seat 7: vrnMike (button) folded before Flop (didn't bet)
Seat 8: YourKicker78 (small blind) folded before Flop
Seat 9: ruslik_by (big blind) folded before Flop





PokerStars Hand #152559988836:  Hold'em No Limit ($0.50/$1.00 USD) - 2016/04/28 15:24:50 CET [2016/04/28 9:24:50 ET]
Table 'Bruwer' 9-max Seat #5 is the button
Seat 2: ruslik_by ($42.85 in chips) 
Seat 3: koksskrt ($143.01 in chips) 
Seat 4: matiko09 ($136.54 in chips) 
Seat 5: Carloszhang ($97.84 in chips) 
Seat 6: I The King I ($108.02 in chips) 
Seat 7: R1aki ($229.66 in chips) 
Seat 8: lumen21 ($106.50 in chips) 
Seat 9: Dantist1122 ($127.15 in chips) 
I The King I: posts small blind $0.50
R1aki: posts big blind $1
peevoajax: sits out 
*** HOLE CARDS ***
Dealt to matiko09 [4c 9d]
lumen21: folds 
Dantist1122: folds 
ruslik_by: folds 
koksskrt: folds 
matiko09: folds 
Carloszhang: raises $1 to $2
I The King I: folds 
R1aki: raises $6.50 to $8.50
lumen21 leaves the table
ozone2003 joins the table at seat #8 
Carloszhang: calls $6.50
*** FLOP *** [8d Th 2h]
R1aki: checks 
Carloszhang: checks 
*** TURN *** [8d Th 2h] [7d]
R1aki: checks 
Carloszhang: checks 
*** RIVER *** [8d Th 2h 7d] [7c]
R1aki: checks 
Carloszhang: bets $12
R1aki: folds 
Uncalled bet ($12) returned to Carloszhang
Carloszhang collected $16.62 from pot
*** SUMMARY ***
Total pot $17.50 | Rake $0.88 
Board [8d Th 2h 7d 7c]
Seat 2: ruslik_by folded before Flop (didn't bet)
Seat 3: koksskrt folded before Flop (didn't bet)
Seat 4: matiko09 folded before Flop (didn't bet)
Seat 5: Carloszhang (button) collected ($16.62)
Seat 6: I The King I (small blind) folded before Flop
Seat 7: R1aki (big blind) folded on the River
Seat 8: lumen21 folded before Flop (didn't bet)
Seat 9: Dantist1122 folded before Flop (didn't bet)





PokerStars Hand #152559990752:  Hold'em No Limit ($0.50/$1.00 USD) - 2016/04/28 15:24:53 CET [2016/04/28 9:24:53 ET]
Table 'Ciurlionis' 9-max Seat #2 is the button
Seat 1: sanpidk ($107.58 in chips) 
Seat 2: liuzhi14 ($50.05 in chips) 
Seat 3: I The King I ($126.50 in chips) 
Seat 4: ruslik_by ($205.50 in chips) 
Seat 5: matiko09 ($183.28 in chips) 
Seat 6: vrnMike ($100 in chips) 
Seat 7: Stopton ($97.85 in chips) 
Seat 8: omorfadramou ($100 in chips) 
Seat 9: Painkiller72 ($104.55 in chips) 
I The King I: posts small blind $0.50
ruslik_by: posts big blind $1
*** HOLE CARDS ***
Dealt to matiko09 [7h Jc]
matiko09: folds 
vrnMike: folds 
Stopton: folds 
omorfadramou: folds 
Painkiller72: folds 
sanpidk: raises $1.50 to $2.50
liuzhi14: folds 
I The King I: folds 
ruslik_by: folds 
Uncalled bet ($1.50) returned to sanpidk
sanpidk collected $2.50 from pot
sanpidk: doesn't show hand 
*** SUMMARY ***
Total pot $2.50 | Rake $0 
Seat 1: sanpidk collected ($2.50)
Seat 2: liuzhi14 (button) folded before Flop (didn't bet)
Seat 3: I The King I (small blind) folded before Flop
Seat 4: ruslik_by (big blind) folded before Flop
Seat 5: matiko09 folded before Flop (didn't bet)
Seat 6: vrnMike folded before Flop (didn't bet)
Seat 7: Stopton folded before Flop (didn't bet)
Seat 8: omorfadramou folded before Flop (didn't bet)
Seat 9: Painkiller72 folded before Flop (didn't bet)





PokerStars Hand #152559991760:  Hold'em No Limit (€0.50/€1.00 EUR) - 2016/04/28 15:24:55 CET [2016/04/28 9:24:55 ET]
Table 'Lumiere II' 9-max Seat #6 is the button
Seat 1: vrnMike (€155.21 in chips) 
Seat 2: Racushniak (€110.90 in chips) 
Seat 4: ruslik_by (€55.70 in chips) 
Seat 5: Schmidy7 (€55.70 in chips) 
Seat 6: azzad2007 (€97 in chips) 
Seat 7: hammerwife (€118.68 in chips) 
Seat 8: sanpidk (€105.62 in chips) 
Seat 9: matiko09 (€100 in chips) 
hammerwife: posts small blind €0.50
sanpidk: posts big blind €1
*** HOLE CARDS ***
Dealt to matiko09 [Kh 3d]
matiko09: folds 
vrnMike: raises €1 to €2
Racushniak: folds 
ruslik_by: folds 
Schmidy7: calls €2
azzad2007: folds 
hammerwife: calls €1.50
sanpidk: folds 
*** FLOP *** [7s 4d 2c]
hammerwife: checks 
vrnMike: bets €5
Schmidy7: folds 
hammerwife: calls €5
*** TURN *** [7s 4d 2c] [Th]
hammerwife: checks 
vrnMike: checks 
*** RIVER *** [7s 4d 2c Th] [Kc]
hammerwife: checks 
vrnMike: bets €5
hammerwife: calls €5
*** SHOW DOWN ***
vrnMike: shows [As Ah] (a pair of Aces)
hammerwife: mucks hand 
vrnMike collected €25.65 from pot
*** SUMMARY ***
Total pot €27 | Rake €1.35 
Board [7s 4d 2c Th Kc]
Seat 1: vrnMike showed [As Ah] and won (€25.65) with a pair of Aces
Seat 2: Racushniak folded before Flop (didn't bet)
Seat 4: ruslik_by folded before Flop (didn't bet)
Seat 5: Schmidy7 folded on the Flop
Seat 6: azzad2007 (button) folded before Flop (didn't bet)
Seat 7: hammerwife (small blind) mucked [Td Ad]
Seat 8: sanpidk (big blind) folded before Flop
Seat 9: matiko09 folded before Flop (didn't bet)





PokerStars Hand #152559994291:  Hold'em No Limit ($1/$2 USD) - 2016/04/28 15:24:59 CET [2016/04/28 9:24:59 ET]
Table 'Idomeneus II' 9-max Seat #1 is the button
Seat 1: 13Ghosts ($250.11 in chips) 
Seat 2: libbyyww ($386.78 in chips) 
Seat 3: adrenalin333 ($158.93 in chips) 
Seat 4: SoNe1988 ($80 in chips) 
Seat 5: matiko09 ($209.11 in chips) 
Seat 6: rmanjkeee ($101 in chips) 
Seat 7: ersevi6 ($232.03 in chips) 
Seat 8: di0d80 ($222.50 in chips) 
Seat 9: prominente ($203 in chips) 
libbyyww: posts small blind $1
adrenalin333: posts big blind $2
*** HOLE CARDS ***
Dealt to matiko09 [8s Qd]
SoNe1988: folds 
matiko09: folds 
rmanjkeee: folds 
ersevi6: folds 
di0d80: folds 
prominente: folds 
13Ghosts: raises $2.78 to $4.78
libbyyww: folds 
adrenalin333: calls $2.78
*** FLOP *** [Jd Td 5h]
adrenalin333: checks 
13Ghosts: bets $6.11
adrenalin333: folds 
Uncalled bet ($6.11) returned to 13Ghosts
13Ghosts collected $10.03 from pot
13Ghosts: doesn't show hand 
*** SUMMARY ***
Total pot $10.56 | Rake $0.53 
Board [Jd Td 5h]
Seat 1: 13Ghosts (button) collected ($10.03)
Seat 2: libbyyww (small blind) folded before Flop
Seat 3: adrenalin333 (big blind) folded on the Flop
Seat 4: SoNe1988 folded before Flop (didn't bet)
Seat 5: matiko09 folded before Flop (didn't bet)
Seat 6: rmanjkeee folded before Flop (didn't bet)
Seat 7: ersevi6 folded before Flop (didn't bet)
Seat 8: di0d80 folded before Flop (didn't bet)
Seat 9: prominente folded before Flop (didn't bet)





PokerStars Hand #152559994974:  Hold'em No Limit ($0.50/$1.00 USD) - 2016/04/28 15:25:00 CET [2016/04/28 9:25:00 ET]
Table 'Halleria' 9-max Seat #4 is the button
Seat 1: vrnMike ($104.78 in chips) 
Seat 4: ka100pka527 ($40 in chips) 
Seat 5: gcz_1886_1 ($99 in chips) 
Seat 7: I The King I ($100 in chips) 
Seat 8: sanpidk ($105.12 in chips) 
Seat 9: matiko09 ($100 in chips) 
gcz_1886_1: posts small blind $0.50
hammerwife: is sitting out 
I The King I: posts big blind $1
maxxmeister: sits out 
*** HOLE CARDS ***
Dealt to matiko09 [Kc 9s]
sanpidk: folds 
hammerwife leaves the table
matiko09: folds 
vrnMike: raises $1 to $2
ka100pka527: folds 
gcz_1886_1: raises $5 to $7
I The King I: folds 
vrnMike: calls $5
*** FLOP *** [Td 5h Ts]
gcz_1886_1: bets $8
cl.trind joins the table at seat #6 
R1aki joins the table at seat #2 
vrnMike: calls $8
*** TURN *** [Td 5h Ts] [6d]
gcz_1886_1: bets $19
vrnMike: folds 
Uncalled bet ($19) returned to gcz_1886_1
gcz_1886_1 collected $29.45 from pot
gcz_1886_1: doesn't show hand 
*** SUMMARY ***
Total pot $31 | Rake $1.55 
Board [Td 5h Ts 6d]
Seat 1: vrnMike folded on the Turn
Seat 4: ka100pka527 (button) folded before Flop (didn't bet)
Seat 5: gcz_1886_1 (small blind) collected ($29.45)
Seat 7: I The King I (big blind) folded before Flop
Seat 8: sanpidk folded before Flop (didn't bet)
Seat 9: matiko09 folded before Flop (didn't bet)





PokerStars Hand #152560002666:  Hold'em No Limit ($0.50/$1.00 USD) - 2016/04/28 15:25:13 CET [2016/04/28 9:25:13 ET]
Table 'Musa II' 9-max Seat #8 is the button
Seat 1: matiko09 ($100 in chips) 
Seat 2: ozone2003 ($101.50 in chips) 
Seat 3: vrnMike ($103.22 in chips) 
Seat 5: Painkiller72 ($106.01 in chips) 
Seat 6: skolombi77 ($82.47 in chips) 
Seat 7: ka100pka527 ($78.50 in chips) 
Seat 8: darren1031 ($80 in chips) 
Seat 9: Moszes360 ($144.58 in chips) 
Moszes360: posts small blind $0.50
matiko09: posts big blind $1
ipashutapkom: sits out 
*** HOLE CARDS ***
Dealt to matiko09 [8c Qc]
ozone2003: folds 
vrnMike: folds 
Painkiller72: folds 
skolombi77: folds 
ka100pka527: folds 
darren1031: folds 
Moszes360: raises $2 to $3
matiko09: calls $2
*** FLOP *** [Qd 5s Td]
Moszes360: checks 
matiko09: bets $3.71
Moszes360: folds 
Uncalled bet ($3.71) returned to matiko09
matiko09 collected $5.70 from pot
matiko09: doesn't show hand 
*** SUMMARY ***
Total pot $6 | Rake $0.30 
Board [Qd 5s Td]
Seat 1: matiko09 (big blind) collected ($5.70)
Seat 2: ozone2003 folded before Flop (didn't bet)
Seat 3: vrnMike folded before Flop (didn't bet)
Seat 5: Painkiller72 folded before Flop (didn't bet)
Seat 6: skolombi77 folded before Flop (didn't bet)
Seat 7: ka100pka527 folded before Flop (didn't bet)
Seat 8: darren1031 (button) folded before Flop (didn't bet)
Seat 9: Moszes360 (small blind) folded on the Flop





PokerStars Hand #152560013981:  Hold'em No Limit ($0.50/$1.00 USD) - 2016/04/28 15:25:31 CET [2016/04/28 9:25:31 ET]
Table 'Ciurlionis' 9-max Seat #3 is the button
Seat 1: sanpidk ($109.08 in chips) 
Seat 2: liuzhi14 ($100 in chips) 
Seat 3: I The King I ($126 in chips) 
Seat 4: ruslik_by ($204.50 in chips) 
Seat 5: matiko09 ($183.28 in chips) 
Seat 6: vrnMike ($100 in chips) 
Seat 7: Stopton ($97.85 in chips) 
Seat 8: omorfadramou ($100 in chips) 
Seat 9: Painkiller72 ($104.55 in chips) 
ruslik_by: posts small blind $0.50
matiko09: posts big blind $1
*** HOLE CARDS ***
Dealt to matiko09 [8s Qc]
vrnMike: folds 
Stopton: folds 
omorfadramou: folds 
Painkiller72: raises $1.50 to $2.50
sanpidk: folds 
liuzhi14: calls $2.50
I The King I: folds 
ruslik_by: folds 
matiko09: folds 
*** FLOP *** [6h Td Js]
Painkiller72: bets $4.32
liuzhi14: calls $4.32
*** TURN *** [6h Td Js] [Th]
Painkiller72: checks 
liuzhi14: bets $8
Painkiller72: calls $8
*** RIVER *** [6h Td Js Th] [Ad]
Painkiller72: checks 
liuzhi14: checks 
*** SHOW DOWN ***
Painkiller72: shows [9d Jd] (two pair, Jacks and Tens)
liuzhi14: shows [Jh 9h] (two pair, Jacks and Tens)
Painkiller72 collected $14.79 from pot
liuzhi14 collected $14.79 from pot
*** SUMMARY ***
Total pot $31.14 | Rake $1.56 
Board [6h Td Js Th Ad]
Seat 1: sanpidk folded before Flop (didn't bet)
Seat 2: liuzhi14 showed [Jh 9h] and won ($14.79) with two pair, Jacks and Tens
Seat 3: I The King I (button) folded before Flop (didn't bet)
Seat 4: ruslik_by (small blind) folded before Flop
Seat 5: matiko09 (big blind) folded before Flop
Seat 6: vrnMike folded before Flop (didn't bet)
Seat 7: Stopton folded before Flop (didn't bet)
Seat 8: omorfadramou folded before Flop (didn't bet)
Seat 9: Painkiller72 showed [9d Jd] and won ($14.79) with two pair, Jacks and Tens





PokerStars Hand #152560024756:  Hold'em No Limit ($0.50/$1.00 USD) - 2016/04/28 15:25:49 CET [2016/04/28 9:25:49 ET]
Table 'Agapenor III' 9-max Seat #2 is the button
Seat 1: I The King I ($103.67 in chips) 
Seat 2: cerbisor1 ($37 in chips) 
Seat 3: sanpidk ($144.41 in chips) 
Seat 4: matiko09 ($100 in chips) 
Seat 5: Painkiller72 ($100 in chips) 
Seat 6: azzad2007 ($116.43 in chips) 
Seat 7: tylerz71 ($121.48 in chips) 
Seat 8: Ceanucs ($55.51 in chips) 
Seat 9: DYO1000 ($52.32 in chips) 
sanpidk: posts small blind $0.50
matiko09: posts big blind $1
*** HOLE CARDS ***
Dealt to matiko09 [5d 4h]
Painkiller72: folds 
azzad2007: folds 
tylerz71: folds 
Ceanucs: folds 
DYO1000: folds 
I The King I: folds 
cerbisor1: folds 
sanpidk: raises $1.24 to $2.24
matiko09: folds 
Uncalled bet ($1.24) returned to sanpidk
sanpidk collected $2 from pot
sanpidk: doesn't show hand 
*** SUMMARY ***
Total pot $2 | Rake $0 
Seat 1: I The King I folded before Flop (didn't bet)
Seat 2: cerbisor1 (button) folded before Flop (didn't bet)
Seat 3: sanpidk (small blind) collected ($2)
Seat 4: matiko09 (big blind) folded before Flop
Seat 5: Painkiller72 folded before Flop (didn't bet)
Seat 6: azzad2007 folded before Flop (didn't bet)
Seat 7: tylerz71 folded before Flop (didn't bet)
Seat 8: Ceanucs folded before Flop (didn't bet)
Seat 9: DYO1000 folded before Flop (didn't bet)





PokerStars Hand #152560027631:  Hold'em No Limit ($0.50/$1.00 USD) - 2016/04/28 15:25:54 CET [2016/04/28 9:25:54 ET]
Table 'Zachia II' 9-max Seat #4 is the button
Seat 1: greyman571 ($125.55 in chips) 
Seat 2: sanpidk ($162.26 in chips) 
Seat 3: matiko09 ($107.82 in chips) 
Seat 4: omorfadramou ($108.15 in chips) 
Seat 5: vrnMike ($102 in chips) 
Seat 6: koksskrt ($109.04 in chips) 
Seat 7: ozone2003 ($100 in chips) 
Seat 9: Painkiller72 ($103.28 in chips) 
vrnMike: posts small blind $0.50
koksskrt: posts big blind $1
CI58: sits out 
*** HOLE CARDS ***
Dealt to matiko09 [Qh Jh]
ozone2003: folds 
Painkiller72: folds 
greyman571: raises $2 to $3
sanpidk: calls $3
matiko09: calls $3
omorfadramou: calls $3
vrnMike: folds 
koksskrt: folds 
*** FLOP *** [Qc Js 6c]
greyman571: bets $4
sanpidk: folds 
matiko09: raises $11 to $15
omorfadramou: folds 
greyman571: calls $11
*** TURN *** [Qc Js 6c] [4d]
greyman571: checks 
matiko09: bets $28
greyman571: calls $28
*** RIVER *** [Qc Js 6c 4d] [8c]
greyman571: checks 
matiko09: checks 
*** SHOW DOWN ***
greyman571: shows [5c 7c] (a flush, Queen high)
matiko09: mucks hand 
greyman571 collected $97 from pot
*** SUMMARY ***
Total pot $99.50 | Rake $2.50 
Board [Qc Js 6c 4d 8c]
Seat 1: greyman571 showed [5c 7c] and won ($97) with a flush, Queen high
Seat 2: sanpidk folded on the Flop
Seat 3: matiko09 mucked [Qh Jh]
Seat 4: omorfadramou (button) folded on the Flop
Seat 5: vrnMike (small blind) folded before Flop
Seat 6: koksskrt (big blind) folded before Flop
Seat 7: ozone2003 folded before Flop (didn't bet)
Seat 9: Painkiller72 folded before Flop (didn't bet)





PokerStars Hand #152560030057:  Hold'em No Limit ($0.50/$1.00 USD) - 2016/04/28 15:25:58 CET [2016/04/28 9:25:58 ET]
Table 'Musa II' 9-max Seat #9 is the button
Seat 1: matiko09 ($102.70 in chips) 
Seat 2: ozone2003 ($101.50 in chips) 
Seat 3: vrnMike ($103.22 in chips) 
Seat 5: Painkiller72 ($106.01 in chips) 
Seat 6: skolombi77 ($82.47 in chips) 
Seat 7: ka100pka527 ($78.50 in chips) 
Seat 8: darren1031 ($80 in chips) 
Seat 9: Moszes360 ($141.58 in chips) 
matiko09: posts small blind $0.50
ozone2003: posts big blind $1
ipashutapkom: sits out 
*** HOLE CARDS ***
Dealt to matiko09 [Qd 7s]
vrnMike: folds 
Painkiller72: raises $1.50 to $2.50
skolombi77: folds 
ka100pka527: folds 
darren1031: folds 
Moszes360: folds 
matiko09: folds 
ozone2003: folds 
Uncalled bet ($1.50) returned to Painkiller72
Painkiller72 collected $2.50 from pot
Painkiller72: doesn't show hand 
*** SUMMARY ***
Total pot $2.50 | Rake $0 
Seat 1: matiko09 (small blind) folded before Flop
Seat 2: ozone2003 (big blind) folded before Flop
Seat 3: vrnMike folded before Flop (didn't bet)
Seat 5: Painkiller72 collected ($2.50)
Seat 6: skolombi77 folded before Flop (didn't bet)
Seat 7: ka100pka527 folded before Flop (didn't bet)
Seat 8: darren1031 folded before Flop (didn't bet)
Seat 9: Moszes360 (button) folded before Flop (didn't bet)





PokerStars Hand #152560037639:  Hold'em No Limit ($1/$2 USD) - 2016/04/28 15:26:11 CET [2016/04/28 9:26:11 ET]
Table 'Idomeneus II' 9-max Seat #2 is the button
Seat 1: 13Ghosts ($255.36 in chips) 
Seat 2: libbyyww ($385.78 in chips) 
Seat 3: adrenalin333 ($154.15 in chips) 
Seat 4: SoNe1988 ($80 in chips) 
Seat 5: matiko09 ($209.11 in chips) 
Seat 6: rmanjkeee ($101 in chips) 
Seat 7: ersevi6 ($232.03 in chips) 
Seat 8: di0d80 ($222.50 in chips) 
Seat 9: prominente ($203 in chips) 
adrenalin333: posts small blind $1
SoNe1988: posts big blind $2
*** HOLE CARDS ***
Dealt to matiko09 [Js 3h]
matiko09: folds 
rmanjkeee: folds 
ersevi6: folds 
di0d80: folds 
prominente: raises $3 to $5
13Ghosts: folds 
libbyyww: folds 
adrenalin333: calls $4
SoNe1988: raises $33 to $38
prominente: folds 
adrenalin333: folds 
Uncalled bet ($33) returned to SoNe1988
SoNe1988 collected $15 from pot
SoNe1988: doesn't show hand 
*** SUMMARY ***
Total pot $15 | Rake $0 
Seat 1: 13Ghosts folded before Flop (didn't bet)
Seat 2: libbyyww (button) folded before Flop (didn't bet)
Seat 3: adrenalin333 (small blind) folded before Flop
Seat 4: SoNe1988 (big blind) collected ($15)
Seat 5: matiko09 folded before Flop (didn't bet)
Seat 6: rmanjkeee folded before Flop (didn't bet)
Seat 7: ersevi6 folded before Flop (didn't bet)
Seat 8: di0d80 folded before Flop (didn't bet)
Seat 9: prominente folded before Flop





PokerStars Hand #152560048489:  Hold'em No Limit ($0.50/$1.00 USD) - 2016/04/28 15:26:29 CET [2016/04/28 9:26:29 ET]
Table 'Erynia' 9-max Seat #8 is the button
Seat 1: I The King I ($100 in chips) 
Seat 2: matiko09 ($149.80 in chips) 
Seat 3: vilo1070 ($100 in chips) 
Seat 4: omorfadramou ($119.68 in chips) 
Seat 5: RMilPoker ($100 in chips) 
Seat 6: peevoajax ($100 in chips) 
Seat 7: vrnMike ($112.24 in chips) 
Seat 8: YourKicker78 ($90.59 in chips) 
Seat 9: ruslik_by ($49.61 in chips) 
ruslik_by: posts small blind $0.50
I The King I: posts big blind $1
*** HOLE CARDS ***
Dealt to matiko09 [6s 7c]
matiko09: folds 
vilo1070: folds 
omorfadramou: folds 
RMilPoker: raises $2 to $3
peevoajax: folds 
vrnMike: folds 
YourKicker78: folds 
ruslik_by: folds 
I The King I: folds 
Uncalled bet ($2) returned to RMilPoker
RMilPoker collected $2.50 from pot
RMilPoker: doesn't show hand 
*** SUMMARY ***
Total pot $2.50 | Rake $0 
Seat 1: I The King I (big blind) folded before Flop
Seat 2: matiko09 folded before Flop (didn't bet)
Seat 3: vilo1070 folded before Flop (didn't bet)
Seat 4: omorfadramou folded before Flop (didn't bet)
Seat 5: RMilPoker collected ($2.50)
Seat 6: peevoajax folded before Flop (didn't bet)
Seat 7: vrnMike folded before Flop (didn't bet)
Seat 8: YourKicker78 (button) folded before Flop (didn't bet)
Seat 9: ruslik_by (small blind) folded before Flop





PokerStars Hand #152560050460:  Hold'em No Limit ($0.50/$1.00 USD) - 2016/04/28 15:26:32 CET [2016/04/28 9:26:32 ET]
Table 'Musa II' 9-max Seat #1 is the button
Seat 1: matiko09 ($102.20 in chips) 
Seat 2: ozone2003 ($100.50 in chips) 
Seat 3: vrnMike ($103.22 in chips) 
Seat 5: Painkiller72 ($107.51 in chips) 
Seat 6: skolombi77 ($82.47 in chips) 
Seat 7: ka100pka527 ($78.50 in chips) 
Seat 8: darren1031 ($80 in chips) 
Seat 9: Moszes360 ($141.58 in chips) 
ozone2003: posts small blind $0.50
vrnMike: posts big blind $1
ipashutapkom: sits out 
*** HOLE CARDS ***
Dealt to matiko09 [9h Kh]
Painkiller72: folds 
skolombi77: folds 
ka100pka527: folds 
darren1031: folds 
Moszes360: folds 
matiko09: raises $1.27 to $2.27
ozone2003: folds 
vrnMike: folds 
Uncalled bet ($1.27) returned to matiko09
matiko09 collected $2.50 from pot
matiko09: doesn't show hand 
*** SUMMARY ***
Total pot $2.50 | Rake $0 
Seat 1: matiko09 (button) collected ($2.50)
Seat 2: ozone2003 (small blind) folded before Flop
Seat 3: vrnMike (big blind) folded before Flop
Seat 5: Painkiller72 folded before Flop (didn't bet)
Seat 6: skolombi77 folded before Flop (didn't bet)
Seat 7: ka100pka527 folded before Flop (didn't bet)
Seat 8: darren1031 folded before Flop (didn't bet)
Seat 9: Moszes360 folded before Flop (didn't bet)





PokerStars Hand #152560051397:  Hold'em No Limit ($0.50/$1.00 USD) - 2016/04/28 15:26:34 CET [2016/04/28 9:26:34 ET]
Table 'Agapenor III' 9-max Seat #3 is the button
Seat 1: I The King I ($103.67 in chips) 
Seat 2: cerbisor1 ($37 in chips) 
Seat 3: sanpidk ($145.41 in chips) 
Seat 4: matiko09 ($100 in chips) 
Seat 6: azzad2007 ($116.43 in chips) 
Seat 7: tylerz71 ($121.48 in chips) 
Seat 8: Ceanucs ($55.51 in chips) 
Seat 9: DYO1000 ($52.32 in chips) 
matiko09: posts small blind $0.50
Painkiller72: is sitting out 
Painkiller72 leaves the table
azzad2007: posts big blind $1
*** HOLE CARDS ***
Dealt to matiko09 [Jd 2h]
tylerz71: folds 
Ceanucs: calls $1
DYO1000: raises $2 to $3
I The King I: folds 
maxxmeister joins the table at seat #5 
cerbisor1: calls $3
sanpidk: folds 
matiko09: folds 
azzad2007: folds 
Ceanucs: calls $2
*** FLOP *** [4d Ts Td]
Ceanucs: checks 
DYO1000: bets $4.99
cerbisor1: raises $5.99 to $10.98
Ceanucs: folds 
DYO1000: folds 
Uncalled bet ($5.99) returned to cerbisor1
cerbisor1 collected $19.46 from pot
cerbisor1: doesn't show hand 
*** SUMMARY ***
Total pot $20.48 | Rake $1.02 
Board [4d Ts Td]
Seat 1: I The King I folded before Flop (didn't bet)
Seat 2: cerbisor1 collected ($19.46)
Seat 3: sanpidk (button) folded before Flop (didn't bet)
Seat 4: matiko09 (small blind) folded before Flop
Seat 6: azzad2007 (big blind) folded before Flop
Seat 7: tylerz71 folded before Flop (didn't bet)
Seat 8: Ceanucs folded on the Flop
Seat 9: DYO1000 folded on the Flop





PokerStars Hand #152560051708:  Hold'em No Limit (€0.50/€1.00 EUR) - 2016/04/28 15:26:34 CET [2016/04/28 9:26:34 ET]
Table 'Lumiere II' 9-max Seat #7 is the button
Seat 1: vrnMike (€168.86 in chips) 
Seat 2: Racushniak (€110.90 in chips) 
Seat 4: ruslik_by (€55.70 in chips) 
Seat 5: Schmidy7 (€53.70 in chips) 
Seat 6: azzad2007 (€97 in chips) 
Seat 7: hammerwife (€106.68 in chips) 
Seat 8: sanpidk (€104.62 in chips) 
Seat 9: matiko09 (€100 in chips) 
sanpidk: posts small blind €0.50
matiko09: posts big blind €1
*** HOLE CARDS ***
Dealt to matiko09 [4d Jh]
vrnMike: folds 
Racushniak: folds 
ruslik_by: folds 
Schmidy7: folds 
azzad2007: folds 
hammerwife: raises €1.01 to €2.01
sanpidk: folds 
matiko09: folds 
Uncalled bet (€1.01) returned to hammerwife
hammerwife collected €2.50 from pot
hammerwife: doesn't show hand 
*** SUMMARY ***
Total pot €2.50 | Rake €0 
Seat 1: vrnMike folded before Flop (didn't bet)
Seat 2: Racushniak folded before Flop (didn't bet)
Seat 4: ruslik_by folded before Flop (didn't bet)
Seat 5: Schmidy7 folded before Flop (didn't bet)
Seat 6: azzad2007 folded before Flop (didn't bet)
Seat 7: hammerwife (button) collected (€2.50)
Seat 8: sanpidk (small blind) folded before Flop
Seat 9: matiko09 (big blind) folded before Flop





PokerStars Hand #152560052258:  Hold'em No Limit ($0.50/$1.00 USD) - 2016/04/28 15:26:35 CET [2016/04/28 9:26:35 ET]
Table 'Halleria' 9-max Seat #5 is the button
Seat 1: vrnMike ($100 in chips) 
Seat 4: ka100pka527 ($40 in chips) 
Seat 5: gcz_1886_1 ($113.45 in chips) 
Seat 7: I The King I ($100 in chips) 
Seat 8: sanpidk ($105.12 in chips) 
Seat 9: matiko09 ($100 in chips) 
cl.trind will be allowed to play after the button
I The King I: posts small blind $0.50
sanpidk: posts big blind $1
R1aki: sits out 
maxxmeister: sits out 
*** HOLE CARDS ***
Dealt to matiko09 [7d 4h]
matiko09: folds 
vrnMike: raises $1 to $2
ka100pka527: folds 
gcz_1886_1: calls $2
I The King I: folds 
sanpidk: calls $1
*** FLOP *** [Kh Qd Js]
sanpidk: checks 
vrnMike: checks 
gcz_1886_1: checks 
*** TURN *** [Kh Qd Js] [Ts]
sanpidk: checks 
vrnMike: bets $4
gcz_1886_1: folds 
sanpidk: folds 
Uncalled bet ($4) returned to vrnMike
vrnMike collected $6.18 from pot
*** SUMMARY ***
Total pot $6.50 | Rake $0.32 
Board [Kh Qd Js Ts]
Seat 1: vrnMike collected ($6.18)
Seat 4: ka100pka527 folded before Flop (didn't bet)
Seat 5: gcz_1886_1 (button) folded on the Turn
Seat 7: I The King I (small blind) folded before Flop
Seat 8: sanpidk (big blind) folded on the Turn
Seat 9: matiko09 folded before Flop (didn't bet)





PokerStars Hand #152560058392:  Hold'em No Limit ($0.50/$1.00 USD) - 2016/04/28 15:26:45 CET [2016/04/28 9:26:45 ET]
Table 'Bruwer' 9-max Seat #6 is the button
Seat 2: ruslik_by ($42.85 in chips) 
Seat 3: koksskrt ($143.01 in chips) 
Seat 4: matiko09 ($136.54 in chips) 
Seat 5: Carloszhang ($105.96 in chips) 
Seat 6: I The King I ($107.52 in chips) 
Seat 7: R1aki ($221.16 in chips) 
Seat 8: ozone2003 ($100 in chips) 
Seat 9: Dantist1122 ($127.15 in chips) 
R1aki: posts small blind $0.50
ozone2003: posts big blind $1
peevoajax: sits out 
*** HOLE CARDS ***
Dealt to matiko09 [4s 6h]
Dantist1122: folds 
ruslik_by: folds 
koksskrt: folds 
matiko09: folds 
Carloszhang: raises $1 to $2
I The King I: folds 
R1aki: folds 
ozone2003: folds 
Uncalled bet ($1) returned to Carloszhang
Carloszhang collected $2.50 from pot
*** SUMMARY ***
Total pot $2.50 | Rake $0 
Seat 2: ruslik_by folded before Flop (didn't bet)
Seat 3: koksskrt folded before Flop (didn't bet)
Seat 4: matiko09 folded before Flop (didn't bet)
Seat 5: Carloszhang collected ($2.50)
Seat 6: I The King I (button) folded before Flop (didn't bet)
Seat 7: R1aki (small blind) folded before Flop
Seat 8: ozone2003 (big blind) folded before Flop
Seat 9: Dantist1122 folded before Flop (didn't bet)





PokerStars Hand #152560064813:  Hold'em No Limit ($1/$2 USD) - 2016/04/28 15:26:56 CET [2016/04/28 9:26:56 ET]
Table 'Idomeneus II' 9-max Seat #3 is the button
Seat 1: 13Ghosts ($255.36 in chips) 
Seat 2: libbyyww ($385.78 in chips) 
Seat 3: adrenalin333 ($149.15 in chips) 
Seat 4: SoNe1988 ($90 in chips) 
Seat 5: matiko09 ($209.11 in chips) 
Seat 6: rmanjkeee ($101 in chips) 
Seat 7: ersevi6 ($232.03 in chips) 
Seat 8: di0d80 ($222.50 in chips) 
Seat 9: prominente ($200 in chips) 
SoNe1988: posts small blind $1
matiko09: posts big blind $2
*** HOLE CARDS ***
Dealt to matiko09 [4s 2s]
rmanjkeee: folds 
ersevi6: folds 
di0d80: folds 
prominente: folds 
13Ghosts: folds 
libbyyww: raises $2.24 to $4.24
adrenalin333 said, "stupid"
adrenalin333: calls $4.24
SoNe1988: folds 
matiko09: folds 
*** FLOP *** [7c Ac Jh]
libbyyww: bets $8.18
adrenalin333: calls $8.18
*** TURN *** [7c Ac Jh] [7d]
libbyyww: checks 
adrenalin333: checks 
*** RIVER *** [7c Ac Jh 7d] [3s]
libbyyww: bets $12
adrenalin333: calls $12
*** SHOW DOWN ***
libbyyww: shows [Ah 7h] (a full house, Sevens full of Aces)
adrenalin333: mucks hand 
libbyyww collected $49.25 from pot
*** SUMMARY ***
Total pot $51.84 | Rake $2.59 
Board [7c Ac Jh 7d 3s]
Seat 1: 13Ghosts folded before Flop (didn't bet)
Seat 2: libbyyww showed [Ah 7h] and won ($49.25) with a full house, Sevens full of Aces
Seat 3: adrenalin333 (button) mucked [As 6s]
Seat 4: SoNe1988 (small blind) folded before Flop
Seat 5: matiko09 (big blind) folded before Flop
Seat 6: rmanjkeee folded before Flop (didn't bet)
Seat 7: ersevi6 folded before Flop (didn't bet)
Seat 8: di0d80 folded before Flop (didn't bet)
Seat 9: prominente folded before Flop (didn't bet)





PokerStars Hand #152560065351:  Hold'em No Limit (€0.50/€1.00 EUR) - 2016/04/28 15:26:57 CET [2016/04/28 9:26:57 ET]
Table 'Lumiere II' 9-max Seat #8 is the button
Seat 2: Racushniak (€110.90 in chips) 
Seat 4: ruslik_by (€55.70 in chips) 
Seat 5: Schmidy7 (€53.70 in chips) 
Seat 6: azzad2007 (€97 in chips) 
Seat 7: hammerwife (€108.18 in chips) 
Seat 8: sanpidk (€104.12 in chips) 
Seat 9: matiko09 (€100 in chips) 
matiko09: posts small blind €0.50
vrnMike: is sitting out 
Racushniak: posts big blind €1
*** HOLE CARDS ***
Dealt to matiko09 [Td 7h]
ruslik_by: raises €2 to €3
Schmidy7: folds 
azzad2007: folds 
hammerwife: folds 
sanpidk: folds 
matiko09: folds 
vrnMike leaves the table
Racushniak: folds 
Uncalled bet (€2) returned to ruslik_by
ruslik_by collected €2.50 from pot
ruslik_by: doesn't show hand 
*** SUMMARY ***
Total pot €2.50 | Rake €0 
Seat 2: Racushniak (big blind) folded before Flop
Seat 4: ruslik_by collected (€2.50)
Seat 5: Schmidy7 folded before Flop (didn't bet)
Seat 6: azzad2007 folded before Flop (didn't bet)
Seat 7: hammerwife folded before Flop (didn't bet)
Seat 8: sanpidk (button) folded before Flop (didn't bet)
Seat 9: matiko09 (small blind) folded before Flop





PokerStars Hand #152560069828:  Hold'em No Limit ($0.50/$1.00 USD) - 2016/04/28 15:27:04 CET [2016/04/28 9:27:04 ET]
Table 'Musa II' 9-max Seat #2 is the button
Seat 1: matiko09 ($103.70 in chips) 
Seat 2: ozone2003 ($100 in chips) 
Seat 3: vrnMike ($102.22 in chips) 
Seat 4: ipashutapkom ($40 in chips) 
Seat 5: Painkiller72 ($107.51 in chips) 
Seat 6: skolombi77 ($82.47 in chips) 
Seat 7: ka100pka527 ($78.50 in chips) 
Seat 8: darren1031 ($80 in chips) 
Seat 9: Moszes360 ($141.58 in chips) 
vrnMike: posts small blind $0.50
ipashutapkom: posts big blind $1
*** HOLE CARDS ***
Dealt to matiko09 [9h Ts]
Painkiller72: folds 
skolombi77: folds 
ka100pka527: folds 
darren1031: folds 
Moszes360: folds 
matiko09: folds 
ozone2003: folds 
vrnMike: folds 
Uncalled bet ($0.50) returned to ipashutapkom
ipashutapkom collected $1 from pot
ipashutapkom: doesn't show hand 
*** SUMMARY ***
Total pot $1 | Rake $0 
Seat 1: matiko09 folded before Flop (didn't bet)
Seat 2: ozone2003 (button) folded before Flop (didn't bet)
Seat 3: vrnMike (small blind) folded before Flop
Seat 4: ipashutapkom (big blind) collected ($1)
Seat 5: Painkiller72 folded before Flop (didn't bet)
Seat 6: skolombi77 folded before Flop (didn't bet)
Seat 7: ka100pka527 folded before Flop (didn't bet)
Seat 8: darren1031 folded before Flop (didn't bet)
Seat 9: Moszes360 folded before Flop (didn't bet)





PokerStars Hand #152560071502:  Hold'em No Limit ($0.50/$1.00 USD) - 2016/04/28 15:27:07 CET [2016/04/28 9:27:07 ET]
Table 'Ciurlionis' 9-max Seat #4 is the button
Seat 1: sanpidk ($109.08 in chips) 
Seat 2: liuzhi14 ($99.97 in chips) 
Seat 3: I The King I ($126 in chips) 
Seat 4: ruslik_by ($204 in chips) 
Seat 5: matiko09 ($182.28 in chips) 
Seat 6: vrnMike ($100 in chips) 
Seat 7: Stopton ($97.85 in chips) 
Seat 8: omorfadramou ($100 in chips) 
Seat 9: Painkiller72 ($104.52 in chips) 
matiko09: posts small blind $0.50
vrnMike: posts big blind $1
*** HOLE CARDS ***
Dealt to matiko09 [8d 3c]
Stopton: folds 
omorfadramou: folds 
Painkiller72: folds 
sanpidk: folds 
liuzhi14: folds 
I The King I: folds 
ruslik_by: raises $1 to $2
matiko09: folds 
vrnMike: folds 
Uncalled bet ($1) returned to ruslik_by
ruslik_by collected $2.50 from pot
ruslik_by: doesn't show hand 
*** SUMMARY ***
Total pot $2.50 | Rake $0 
Seat 1: sanpidk folded before Flop (didn't bet)
Seat 2: liuzhi14 folded before Flop (didn't bet)
Seat 3: I The King I folded before Flop (didn't bet)
Seat 4: ruslik_by (button) collected ($2.50)
Seat 5: matiko09 (small blind) folded before Flop
Seat 6: vrnMike (big blind) folded before Flop
Seat 7: Stopton folded before Flop (didn't bet)
Seat 8: omorfadramou folded before Flop (didn't bet)
Seat 9: Painkiller72 folded before Flop (didn't bet)





PokerStars Hand #152560074699:  Hold'em No Limit ($0.50/$1.00 USD) - 2016/04/28 15:27:13 CET [2016/04/28 9:27:13 ET]
Table 'Erynia' 9-max Seat #9 is the button
Seat 1: I The King I ($100 in chips) 
Seat 2: matiko09 ($149.80 in chips) 
Seat 3: vilo1070 ($100 in chips) 
Seat 4: omorfadramou ($119.68 in chips) 
Seat 5: RMilPoker ($101.50 in chips) 
Seat 6: peevoajax ($100 in chips) 
Seat 7: vrnMike ($112.24 in chips) 
Seat 8: YourKicker78 ($90.59 in chips) 
Seat 9: ruslik_by ($49.11 in chips) 
I The King I: posts small blind $0.50
matiko09: posts big blind $1
*** HOLE CARDS ***
Dealt to matiko09 [Tc Qc]
vilo1070 has timed out
vilo1070: folds 
omorfadramou: folds 
RMilPoker: folds 
peevoajax: folds 
vrnMike: folds 
YourKicker78: folds 
ruslik_by: raises $1 to $2
I The King I: folds 
matiko09: calls $1
*** FLOP *** [7c 6h Jh]
matiko09: checks 
ruslik_by: bets $2
matiko09: raises $5 to $7
ruslik_by: calls $5
*** TURN *** [7c 6h Jh] [3h]
matiko09: bets $10
ruslik_by: folds 
Uncalled bet ($10) returned to matiko09
matiko09 collected $17.58 from pot
matiko09: doesn't show hand 
*** SUMMARY ***
Total pot $18.50 | Rake $0.92 
Board [7c 6h Jh 3h]
Seat 1: I The King I (small blind) folded before Flop
Seat 2: matiko09 (big blind) collected ($17.58)
Seat 3: vilo1070 folded before Flop (didn't bet)
Seat 4: omorfadramou folded before Flop (didn't bet)
Seat 5: RMilPoker folded before Flop (didn't bet)
Seat 6: peevoajax folded before Flop (didn't bet)
Seat 7: vrnMike folded before Flop (didn't bet)
Seat 8: YourKicker78 folded before Flop (didn't bet)
Seat 9: ruslik_by (button) folded on the Turn





PokerStars Hand #152560076281:  Hold'em No Limit (€0.50/€1.00 EUR) - 2016/04/28 15:27:15 CET [2016/04/28 9:27:15 ET]
Table 'Lumiere II' 9-max Seat #9 is the button
Seat 2: Racushniak (€109.90 in chips) 
Seat 4: ruslik_by (€57.20 in chips) 
Seat 5: Schmidy7 (€53.70 in chips) 
Seat 6: azzad2007 (€97 in chips) 
Seat 7: hammerwife (€108.18 in chips) 
Seat 8: sanpidk (€104.12 in chips) 
Seat 9: matiko09 (€100 in chips) 
Racushniak: posts small blind €0.50
ruslik_by: posts big blind €1
*** HOLE CARDS ***
Dealt to matiko09 [Ac 7h]
Schmidy7: calls €1
azzad2007: folds 
hammerwife: folds 
sanpidk: folds 
matiko09: raises €3 to €4
Racushniak: folds 
maxxmeister joins the table at seat #1 
ruslik_by: folds 
Schmidy7: folds 
Uncalled bet (€3) returned to matiko09
matiko09 collected €3.50 from pot
matiko09: doesn't show hand 
*** SUMMARY ***
Total pot €3.50 | Rake €0 
Seat 2: Racushniak (small blind) folded before Flop
Seat 4: ruslik_by (big blind) folded before Flop
Seat 5: Schmidy7 folded before Flop
Seat 6: azzad2007 folded before Flop (didn't bet)
Seat 7: hammerwife folded before Flop (didn't bet)
Seat 8: sanpidk folded before Flop (didn't bet)
Seat 9: matiko09 (button) collected (€3.50)





PokerStars Hand #152560077884:  Hold'em No Limit ($0.50/$1.00 USD) - 2016/04/28 15:27:18 CET [2016/04/28 9:27:18 ET]
Table 'Bruwer' 9-max Seat #7 is the button
Seat 2: ruslik_by ($42.85 in chips) 
Seat 3: koksskrt ($143.01 in chips) 
Seat 4: matiko09 ($136.54 in chips) 
Seat 5: Carloszhang ($107.46 in chips) 
Seat 6: I The King I ($107.52 in chips) 
Seat 7: R1aki ($220.66 in chips) 
Seat 8: ozone2003 ($100 in chips) 
Seat 9: Dantist1122 ($127.15 in chips) 
ozone2003: posts small blind $0.50
Dantist1122: posts big blind $1
peevoajax: sits out 
*** HOLE CARDS ***
Dealt to matiko09 [4h 5d]
ruslik_by: folds 
koksskrt: folds 
matiko09: folds 
Carloszhang: raises $1 to $2
I The King I: folds 
R1aki: folds 
ozone2003: folds 
Dantist1122: calls $1
*** FLOP *** [9d 7d Ac]
Dantist1122: checks 
Carloszhang: bets $3
Dantist1122: calls $3
*** TURN *** [9d 7d Ac] [Tc]
Dantist1122: checks 
Carloszhang: checks 
*** RIVER *** [9d 7d Ac Tc] [2s]
Dantist1122: checks 
Carloszhang: bets $10
Dantist1122: folds 
Uncalled bet ($10) returned to Carloszhang
Carloszhang collected $9.98 from pot
*** SUMMARY ***
Total pot $10.50 | Rake $0.52 
Board [9d 7d Ac Tc 2s]
Seat 2: ruslik_by folded before Flop (didn't bet)
Seat 3: koksskrt folded before Flop (didn't bet)
Seat 4: matiko09 folded before Flop (didn't bet)
Seat 5: Carloszhang collected ($9.98)
Seat 6: I The King I folded before Flop (didn't bet)
Seat 7: R1aki (button) folded before Flop (didn't bet)
Seat 8: ozone2003 (small blind) folded before Flop
Seat 9: Dantist1122 (big blind) folded on the River





PokerStars Hand #152560083602:  Hold'em No Limit ($0.50/$1.00 USD) - 2016/04/28 15:27:27 CET [2016/04/28 9:27:27 ET]
Table 'Musa II' 9-max Seat #3 is the button
Seat 1: matiko09 ($103.70 in chips) 
Seat 2: ozone2003 ($100 in chips) 
Seat 3: vrnMike ($101.72 in chips) 
Seat 4: ipashutapkom ($40.50 in chips) 
Seat 6: skolombi77 ($82.47 in chips) 
Seat 7: ka100pka527 ($78.50 in chips) 
Seat 8: darren1031 ($80 in chips) 
Seat 9: Moszes360 ($141.58 in chips) 
ipashutapkom: posts small blind $0.50
Painkiller72: is sitting out 
skolombi77: posts big blind $1
*** HOLE CARDS ***
Dealt to matiko09 [As 8s]
Painkiller72 leaves the table
ka100pka527: folds 
darren1031: folds 
Moszes360: folds 
matiko09: raises $2 to $3
ozone2003: folds 
vrnMike: folds 
ipashutapkom: folds 
skolombi77: folds 
Uncalled bet ($2) returned to matiko09
matiko09 collected $2.50 from pot
matiko09: doesn't show hand 
*** SUMMARY ***
Total pot $2.50 | Rake $0 
Seat 1: matiko09 collected ($2.50)
Seat 2: ozone2003 folded before Flop (didn't bet)
Seat 3: vrnMike (button) folded before Flop (didn't bet)
Seat 4: ipashutapkom (small blind) folded before Flop
Seat 6: skolombi77 (big blind) folded before Flop
Seat 7: ka100pka527 folded before Flop (didn't bet)
Seat 8: darren1031 folded before Flop (didn't bet)
Seat 9: Moszes360 folded before Flop (didn't bet)





PokerStars Hand #152560089963:  Hold'em No Limit ($0.50/$1.00 USD) - 2016/04/28 15:27:38 CET [2016/04/28 9:27:38 ET]
Table 'Zachia II' 9-max Seat #5 is the button
Seat 1: greyman571 ($176.55 in chips) 
Seat 2: sanpidk ($159.26 in chips) 
Seat 3: matiko09 ($100 in chips) 
Seat 4: omorfadramou ($105.15 in chips) 
Seat 5: vrnMike ($101.50 in chips) 
Seat 6: koksskrt ($108.04 in chips) 
Seat 7: ozone2003 ($100 in chips) 
Seat 9: Painkiller72 ($103.28 in chips) 
koksskrt: posts small blind $0.50
ozone2003: posts big blind $1
CI58: sits out 
*** HOLE CARDS ***
Dealt to matiko09 [9d 2h]
Painkiller72: folds 
greyman571: folds 
sanpidk: folds 
matiko09: folds 
omorfadramou: folds 
vrnMike: folds 
koksskrt: raises $2 to $3
ozone2003: folds 
Uncalled bet ($2) returned to koksskrt
koksskrt collected $2 from pot
koksskrt: doesn't show hand 
*** SUMMARY ***
Total pot $2 | Rake $0 
Seat 1: greyman571 folded before Flop (didn't bet)
Seat 2: sanpidk folded before Flop (didn't bet)
Seat 3: matiko09 folded before Flop (didn't bet)
Seat 4: omorfadramou folded before Flop (didn't bet)
Seat 5: vrnMike (button) folded before Flop (didn't bet)
Seat 6: koksskrt (small blind) collected ($2)
Seat 7: ozone2003 (big blind) folded before Flop
Seat 9: Painkiller72 folded before Flop (didn't bet)





PokerStars Hand #152560093940:  Hold'em No Limit ($0.50/$1.00 USD) - 2016/04/28 15:27:45 CET [2016/04/28 9:27:45 ET]
Table 'Halleria' 9-max Seat #7 is the button
Seat 1: vrnMike ($104.18 in chips) 
Seat 4: ka100pka527 ($40 in chips) 
Seat 5: gcz_1886_1 ($111.45 in chips) 
Seat 7: I The King I ($100 in chips) 
Seat 8: sanpidk ($103.12 in chips) 
Seat 9: matiko09 ($100 in chips) 
sanpidk: posts small blind $0.50
matiko09: posts big blind $1
R1aki: sits out 
maxxmeister: sits out 
cl.trind: sits out 
*** HOLE CARDS ***
Dealt to matiko09 [5c As]
vrnMike: folds 
ka100pka527: raises $2 to $3
gcz_1886_1: folds 
I The King I: folds 
sanpidk: folds 
matiko09: raises $6 to $9
ka100pka527: folds 
Uncalled bet ($6) returned to matiko09
matiko09 collected $6.50 from pot
matiko09: doesn't show hand 
*** SUMMARY ***
Total pot $6.50 | Rake $0 
Seat 1: vrnMike folded before Flop (didn't bet)
Seat 4: ka100pka527 folded before Flop
Seat 5: gcz_1886_1 folded before Flop (didn't bet)
Seat 7: I The King I (button) folded before Flop (didn't bet)
Seat 8: sanpidk (small blind) folded before Flop
Seat 9: matiko09 (big blind) collected ($6.50)





PokerStars Hand #152560099564:  Hold'em No Limit ($1/$2 USD) - 2016/04/28 15:27:54 CET [2016/04/28 9:27:54 ET]
Table 'Idomeneus II' 9-max Seat #4 is the button
Seat 1: 13Ghosts ($255.36 in chips) 
Seat 2: libbyyww ($410.61 in chips) 
Seat 3: adrenalin333 ($124.73 in chips) 
Seat 4: SoNe1988 ($89 in chips) 
Seat 5: matiko09 ($207.11 in chips) 
Seat 6: rmanjkeee ($101 in chips) 
Seat 7: ersevi6 ($232.03 in chips) 
Seat 8: di0d80 ($222.50 in chips) 
Seat 9: prominente ($200 in chips) 
matiko09: posts small blind $1
rmanjkeee: posts big blind $2
*** HOLE CARDS ***
Dealt to matiko09 [8d 4c]
ersevi6: folds 
di0d80: raises $3 to $5
prominente: folds 
13Ghosts: folds 
libbyyww: folds 
adrenalin333: calls $5
SoNe1988: folds 
matiko09: folds 
rmanjkeee: folds 
*** FLOP *** [7d 3d 2c]
di0d80: bets $8
adrenalin333: folds 
Uncalled bet ($8) returned to di0d80
di0d80 collected $12.35 from pot
di0d80: doesn't show hand 
*** SUMMARY ***
Total pot $13 | Rake $0.65 
Board [7d 3d 2c]
Seat 1: 13Ghosts folded before Flop (didn't bet)
Seat 2: libbyyww folded before Flop (didn't bet)
Seat 3: adrenalin333 folded on the Flop
Seat 4: SoNe1988 (button) folded before Flop (didn't bet)
Seat 5: matiko09 (small blind) folded before Flop
Seat 6: rmanjkeee (big blind) folded before Flop
Seat 7: ersevi6 folded before Flop (didn't bet)
Seat 8: di0d80 collected ($12.35)
Seat 9: prominente folded before Flop (didn't bet)





PokerStars Hand #152560099799:  Hold'em No Limit ($0.50/$1.00 USD) - 2016/04/28 15:27:54 CET [2016/04/28 9:27:54 ET]
Table 'Agapenor III' 9-max Seat #4 is the button
Seat 1: I The King I ($103.67 in chips) 
Seat 2: cerbisor1 ($48.47 in chips) 
Seat 3: sanpidk ($145.41 in chips) 
Seat 4: matiko09 ($100 in chips) 
Seat 6: azzad2007 ($115.43 in chips) 
Seat 7: tylerz71 ($121.48 in chips) 
Seat 8: Ceanucs ($52.51 in chips) 
Seat 9: DYO1000 ($44.33 in chips) 
maxxmeister will be allowed to play after the button
azzad2007: posts small blind $0.50
tylerz71: posts big blind $1
*** HOLE CARDS ***
Dealt to matiko09 [2d 8d]
Ceanucs: folds 
DYO1000: raises $1 to $2
I The King I: folds 
cerbisor1: folds 
sanpidk: calls $2
matiko09: folds 
azzad2007: folds 
tylerz71: folds 
*** FLOP *** [6s 5s Qs]
DYO1000: checks 
sanpidk: checks 
*** TURN *** [6s 5s Qs] [8h]
DYO1000: checks 
sanpidk: checks 
*** RIVER *** [6s 5s Qs 8h] [Kc]
DYO1000: checks 
sanpidk: checks 
*** SHOW DOWN ***
DYO1000: shows [Jd Td] (high card King)
sanpidk: shows [Ac 4c] (high card Ace)
sanpidk collected $5.22 from pot
*** SUMMARY ***
Total pot $5.50 | Rake $0.28 
Board [6s 5s Qs 8h Kc]
Seat 1: I The King I folded before Flop (didn't bet)
Seat 2: cerbisor1 folded before Flop (didn't bet)
Seat 3: sanpidk showed [Ac 4c] and won ($5.22) with high card Ace
Seat 4: matiko09 (button) folded before Flop (didn't bet)
Seat 6: azzad2007 (small blind) folded before Flop
Seat 7: tylerz71 (big blind) folded before Flop
Seat 8: Ceanucs folded before Flop (didn't bet)
Seat 9: DYO1000 showed [Jd Td] and lost with high card King





PokerStars Hand #152560099800:  Hold'em No Limit (€0.50/€1.00 EUR) - 2016/04/28 15:27:54 CET [2016/04/28 9:27:54 ET]
Table 'Lumiere II' 9-max Seat #2 is the button
Seat 2: Racushniak (€109.40 in chips) 
Seat 4: ruslik_by (€56.20 in chips) 
Seat 5: Schmidy7 (€52.70 in chips) 
Seat 6: azzad2007 (€97 in chips) 
Seat 7: hammerwife (€108.18 in chips) 
Seat 8: sanpidk (€104.12 in chips) 
Seat 9: matiko09 (€102.50 in chips) 
ruslik_by: posts small blind €0.50
Schmidy7: posts big blind €1
maxxmeister: sits out 
*** HOLE CARDS ***
Dealt to matiko09 [3c Jc]
azzad2007: folds 
hammerwife: folds 
sanpidk: raises €2 to €3
matiko09: folds 
Racushniak: folds 
ruslik_by: folds 
Schmidy7: calls €2
*** FLOP *** [2c Js Qc]
Schmidy7: checks 
sanpidk: bets €4
Schmidy7: folds 
Uncalled bet (€4) returned to sanpidk
sanpidk collected €6.18 from pot
sanpidk: doesn't show hand 
*** SUMMARY ***
Total pot €6.50 | Rake €0.32 
Board [2c Js Qc]
Seat 2: Racushniak (button) folded before Flop (didn't bet)
Seat 4: ruslik_by (small blind) folded before Flop
Seat 5: Schmidy7 (big blind) folded on the Flop
Seat 6: azzad2007 folded before Flop (didn't bet)
Seat 7: hammerwife folded before Flop (didn't bet)
Seat 8: sanpidk collected (€6.18)
Seat 9: matiko09 folded before Flop (didn't bet)





PokerStars Hand #152560101581:  Hold'em No Limit ($0.50/$1.00 USD) - 2016/04/28 15:27:57 CET [2016/04/28 9:27:57 ET]
Table 'Ciurlionis' 9-max Seat #5 is the button
Seat 1: sanpidk ($109.08 in chips) 
Seat 2: liuzhi14 ($99.97 in chips) 
Seat 3: I The King I ($126 in chips) 
Seat 4: ruslik_by ($205.50 in chips) 
Seat 5: matiko09 ($181.78 in chips) 
Seat 6: vrnMike ($100 in chips) 
Seat 7: Stopton ($97.85 in chips) 
Seat 8: omorfadramou ($100 in chips) 
Seat 9: Painkiller72 ($104.52 in chips) 
vrnMike: posts small blind $0.50
Stopton: posts big blind $1
*** HOLE CARDS ***
Dealt to matiko09 [5c 4s]
omorfadramou: folds 
Painkiller72: folds 
sanpidk: folds 
liuzhi14: folds 
I The King I: folds 
ruslik_by: folds 
matiko09: folds 
vrnMike: folds 
Uncalled bet ($0.50) returned to Stopton
Stopton collected $1 from pot
Stopton: doesn't show hand 
*** SUMMARY ***
Total pot $1 | Rake $0 
Seat 1: sanpidk folded before Flop (didn't bet)
Seat 2: liuzhi14 folded before Flop (didn't bet)
Seat 3: I The King I folded before Flop (didn't bet)
Seat 4: ruslik_by folded before Flop (didn't bet)
Seat 5: matiko09 (button) folded before Flop (didn't bet)
Seat 6: vrnMike (small blind) folded before Flop
Seat 7: Stopton (big blind) collected ($1)
Seat 8: omorfadramou folded before Flop (didn't bet)
Seat 9: Painkiller72 folded before Flop (didn't bet)





PokerStars Hand #152560102271:  Hold'em No Limit ($0.50/$1.00 USD) - 2016/04/28 15:27:58 CET [2016/04/28 9:27:58 ET]
Table 'Musa II' 9-max Seat #4 is the button
Seat 1: matiko09 ($105.20 in chips) 
Seat 2: ozone2003 ($100 in chips) 
Seat 3: vrnMike ($101.72 in chips) 
Seat 4: ipashutapkom ($40 in chips) 
Seat 6: skolombi77 ($81.47 in chips) 
Seat 7: ka100pka527 ($78.50 in chips) 
Seat 8: darren1031 ($80 in chips) 
Seat 9: Moszes360 ($141.58 in chips) 
skolombi77: posts small blind $0.50
ka100pka527: posts big blind $1
*** HOLE CARDS ***
Dealt to matiko09 [Tc Ad]
darren1031 has timed out
darren1031: folds 
Moszes360: folds 
matiko09: raises $2 to $3
ozone2003: folds 
vrnMike: calls $3
ipashutapkom: folds 
sanpidk joins the table at seat #5 
sanpidk leaves the table
skolombi77: folds 
ka100pka527: folds 
*** FLOP *** [Jh 6h Ac]
matiko09: checks 
vrnMike: bets $3
matiko09: calls $3
*** TURN *** [Jh 6h Ac] [Qd]
matiko09: checks 
thecurv joins the table at seat #5 
vrnMike: checks 
*** RIVER *** [Jh 6h Ac Qd] [8c]
matiko09: bets $6.66
vrnMike: folds 
Uncalled bet ($6.66) returned to matiko09
matiko09 collected $12.82 from pot
matiko09: doesn't show hand 
*** SUMMARY ***
Total pot $13.50 | Rake $0.68 
Board [Jh 6h Ac Qd 8c]
Seat 1: matiko09 collected ($12.82)
Seat 2: ozone2003 folded before Flop (didn't bet)
Seat 3: vrnMike folded on the River
Seat 4: ipashutapkom (button) folded before Flop (didn't bet)
Seat 6: skolombi77 (small blind) folded before Flop
Seat 7: ka100pka527 (big blind) folded before Flop
Seat 8: darren1031 folded before Flop (didn't bet)
Seat 9: Moszes360 folded before Flop (didn't bet)





PokerStars Hand #152560112596:  Hold'em No Limit ($0.50/$1.00 USD) - 2016/04/28 15:28:16 CET [2016/04/28 9:28:16 ET]
Table 'Halleria' 9-max Seat #8 is the button
Seat 2: R1aki ($110.28 in chips) 
Seat 4: ka100pka527 ($37 in chips) 
Seat 5: gcz_1886_1 ($111.45 in chips) 
Seat 7: I The King I ($100 in chips) 
Seat 8: sanpidk ($102.62 in chips) 
Seat 9: matiko09 ($103.50 in chips) 
matiko09: posts small blind $0.50
vrnMike: is sitting out 
R1aki: posts big blind $1
maxxmeister: sits out 
*** HOLE CARDS ***
Dealt to matiko09 [7h 9s]
ka100pka527: folds 
vrnMike leaves the table
gcz_1886_1: folds 
JediGaGa joins the table at seat #1 
I The King I: folds 
sanpidk: raises $1.24 to $2.24
matiko09: folds 
R1aki: calls $1.24
*** FLOP *** [6h 6s 7d]
R1aki: checks 
sanpidk: bets $3
R1aki: folds 
Uncalled bet ($3) returned to sanpidk
sanpidk collected $4.73 from pot
sanpidk: doesn't show hand 
*** SUMMARY ***
Total pot $4.98 | Rake $0.25 
Board [6h 6s 7d]
Seat 2: R1aki (big blind) folded on the Flop
Seat 4: ka100pka527 folded before Flop (didn't bet)
Seat 5: gcz_1886_1 folded before Flop (didn't bet)
Seat 7: I The King I folded before Flop (didn't bet)
Seat 8: sanpidk (button) collected ($4.73)
Seat 9: matiko09 (small blind) folded before Flop





PokerStars Hand #152560121975:  Hold'em No Limit ($0.50/$1.00 USD) - 2016/04/28 15:28:31 CET [2016/04/28 9:28:31 ET]
Table 'Ciurlionis' 9-max Seat #6 is the button
Seat 1: sanpidk ($109.08 in chips) 
Seat 2: liuzhi14 ($99.97 in chips) 
Seat 3: I The King I ($126 in chips) 
Seat 4: ruslik_by ($205.50 in chips) 
Seat 5: matiko09 ($181.78 in chips) 
Seat 6: vrnMike ($100 in chips) 
Seat 7: Stopton ($98.35 in chips) 
Seat 8: omorfadramou ($100 in chips) 
Seat 9: Painkiller72 ($104.52 in chips) 
Stopton: posts small blind $0.50
omorfadramou: posts big blind $1
*** HOLE CARDS ***
Dealt to matiko09 [9s 8d]
Painkiller72: folds 
sanpidk: folds 
liuzhi14: folds 
I The King I: folds 
ruslik_by: folds 
matiko09: folds 
vrnMike: raises $2 to $3
Stopton: folds 
omorfadramou: folds 
Uncalled bet ($2) returned to vrnMike
vrnMike collected $2.50 from pot
*** SUMMARY ***
Total pot $2.50 | Rake $0 
Seat 1: sanpidk folded before Flop (didn't bet)
Seat 2: liuzhi14 folded before Flop (didn't bet)
Seat 3: I The King I folded before Flop (didn't bet)
Seat 4: ruslik_by folded before Flop (didn't bet)
Seat 5: matiko09 folded before Flop (didn't bet)
Seat 6: vrnMike (button) collected ($2.50)
Seat 7: Stopton (small blind) folded before Flop
Seat 8: omorfadramou (big blind) folded before Flop
Seat 9: Painkiller72 folded before Flop (didn't bet)





PokerStars Hand #152560125063:  Hold'em No Limit ($0.50/$1.00 USD) - 2016/04/28 15:28:36 CET [2016/04/28 9:28:36 ET]
Table 'Zachia II' 9-max Seat #6 is the button
Seat 1: greyman571 ($176.55 in chips) 
Seat 2: sanpidk ($159.26 in chips) 
Seat 3: matiko09 ($100 in chips) 
Seat 4: omorfadramou ($105.15 in chips) 
Seat 5: vrnMike ($101.50 in chips) 
Seat 6: koksskrt ($109.04 in chips) 
Seat 7: ozone2003 ($100 in chips) 
Seat 8: CI58 ($100 in chips) 
Seat 9: Painkiller72 ($103.28 in chips) 
ozone2003: posts small blind $0.50
CI58: posts big blind $1
*** HOLE CARDS ***
Dealt to matiko09 [5h Tc]
Painkiller72: folds 
greyman571: folds 
sanpidk: folds 
matiko09: folds 
omorfadramou: folds 
vrnMike: folds 
koksskrt: raises $1 to $2
ozone2003: folds 
CI58: calls $1
*** FLOP *** [Qh Qd 6h]
CI58: checks 
koksskrt: checks 
*** TURN *** [Qh Qd 6h] [4h]
CI58: bets $2.14
koksskrt: folds 
Uncalled bet ($2.14) returned to CI58
CI58 collected $4.28 from pot
CI58: doesn't show hand 
*** SUMMARY ***
Total pot $4.50 | Rake $0.22 
Board [Qh Qd 6h 4h]
Seat 1: greyman571 folded before Flop (didn't bet)
Seat 2: sanpidk folded before Flop (didn't bet)
Seat 3: matiko09 folded before Flop (didn't bet)
Seat 4: omorfadramou folded before Flop (didn't bet)
Seat 5: vrnMike folded before Flop (didn't bet)
Seat 6: koksskrt (button) folded on the Turn
Seat 7: ozone2003 (small blind) folded before Flop
Seat 8: CI58 (big blind) collected ($4.28)
Seat 9: Painkiller72 folded before Flop (didn't bet)





PokerStars Hand #152560127371:  Hold'em No Limit ($0.50/$1.00 USD) - 2016/04/28 15:28:40 CET [2016/04/28 9:28:40 ET]
Table 'Erynia' 9-max Seat #1 is the button
Seat 1: I The King I ($100 in chips) 
Seat 2: matiko09 ($158.38 in chips) 
Seat 3: vilo1070 ($100 in chips) 
Seat 4: omorfadramou ($119.68 in chips) 
Seat 5: RMilPoker ($101.50 in chips) 
Seat 6: peevoajax ($100 in chips) 
Seat 7: vrnMike ($112.24 in chips) 
Seat 8: YourKicker78 ($90.59 in chips) 
Seat 9: ruslik_by ($40.11 in chips) 
matiko09: posts small blind $0.50
vilo1070: posts big blind $1
*** HOLE CARDS ***
Dealt to matiko09 [5c 4c]
omorfadramou: folds 
RMilPoker: folds 
peevoajax: folds 
vrnMike: folds 
YourKicker78: folds 
ruslik_by: folds 
I The King I: folds 
matiko09: raises $2 to $3
vilo1070: raises $6 to $9
matiko09: folds 
Uncalled bet ($6) returned to vilo1070
vilo1070 collected $6 from pot
vilo1070: doesn't show hand 
*** SUMMARY ***
Total pot $6 | Rake $0 
Seat 1: I The King I (button) folded before Flop (didn't bet)
Seat 2: matiko09 (small blind) folded before Flop
Seat 3: vilo1070 (big blind) collected ($6)
Seat 4: omorfadramou folded before Flop (didn't bet)
Seat 5: RMilPoker folded before Flop (didn't bet)
Seat 6: peevoajax folded before Flop (didn't bet)
Seat 7: vrnMike folded before Flop (didn't bet)
Seat 8: YourKicker78 folded before Flop (didn't bet)
Seat 9: ruslik_by folded before Flop (didn't bet)





PokerStars Hand #152560127471:  Hold'em No Limit ($0.50/$1.00 USD) - 2016/04/28 15:28:40 CET [2016/04/28 9:28:40 ET]
Table 'Bruwer' 9-max Seat #8 is the button
Seat 1: peevoajax ($100 in chips) 
Seat 2: ruslik_by ($42.85 in chips) 
Seat 3: koksskrt ($143.01 in chips) 
Seat 4: matiko09 ($136.54 in chips) 
Seat 5: Carloszhang ($112.44 in chips) 
Seat 6: I The King I ($107.52 in chips) 
Seat 7: R1aki ($220.66 in chips) 
Seat 8: ozone2003 ($100 in chips) 
Seat 9: Dantist1122 ($122.15 in chips) 
Dantist1122: posts small blind $0.50
peevoajax: posts big blind $1
*** HOLE CARDS ***
Dealt to matiko09 [Qh 2h]
ruslik_by: folds 
koksskrt: folds 
matiko09: folds 
Carloszhang: raises $1 to $2
I The King I: folds 
R1aki: folds 
ozone2003: raises $10 to $12
Dantist1122: folds 
peevoajax: folds 
Carloszhang: folds 
Uncalled bet ($10) returned to ozone2003
ozone2003 collected $5.50 from pot
ozone2003: doesn't show hand 
*** SUMMARY ***
Total pot $5.50 | Rake $0 
Seat 1: peevoajax (big blind) folded before Flop
Seat 2: ruslik_by folded before Flop (didn't bet)
Seat 3: koksskrt folded before Flop (didn't bet)
Seat 4: matiko09 folded before Flop (didn't bet)
Seat 5: Carloszhang folded before Flop
Seat 6: I The King I folded before Flop (didn't bet)
Seat 7: R1aki folded before Flop (didn't bet)
Seat 8: ozone2003 (button) collected ($5.50)
Seat 9: Dantist1122 (small blind) folded before Flop





PokerStars Hand #152560129992:  Hold'em No Limit (€0.50/€1.00 EUR) - 2016/04/28 15:28:44 CET [2016/04/28 9:28:44 ET]
Table 'Lumiere II' 9-max Seat #4 is the button
Seat 2: Racushniak (€109.40 in chips) 
Seat 4: ruslik_by (€55.70 in chips) 
Seat 5: Schmidy7 (€49.70 in chips) 
Seat 6: azzad2007 (€97 in chips) 
Seat 7: hammerwife (€108.18 in chips) 
Seat 8: sanpidk (€107.30 in chips) 
Seat 9: matiko09 (€102.50 in chips) 
Schmidy7: posts small blind €0.50
azzad2007: posts big blind €1
maxxmeister: sits out 
*** HOLE CARDS ***
Dealt to matiko09 [Ad Tc]
hammerwife: folds 
sanpidk: folds 
matiko09: raises €2 to €3
Racushniak: folds 
ruslik_by: folds 
Schmidy7: folds 
azzad2007: folds 
Uncalled bet (€2) returned to matiko09
matiko09 collected €2.50 from pot
matiko09: doesn't show hand 
*** SUMMARY ***
Total pot €2.50 | Rake €0 
Seat 2: Racushniak folded before Flop (didn't bet)
Seat 4: ruslik_by (button) folded before Flop (didn't bet)
Seat 5: Schmidy7 (small blind) folded before Flop
Seat 6: azzad2007 (big blind) folded before Flop
Seat 7: hammerwife folded before Flop (didn't bet)
Seat 8: sanpidk folded before Flop (didn't bet)
Seat 9: matiko09 collected (€2.50)





PokerStars Hand #152560131030:  Hold'em No Limit ($1/$2 USD) - 2016/04/28 15:28:46 CET [2016/04/28 9:28:46 ET]
Table 'Idomeneus II' 9-max Seat #5 is the button
Seat 1: 13Ghosts ($255.36 in chips) 
Seat 2: libbyyww ($410.61 in chips) 
Seat 3: adrenalin333 ($119.73 in chips) 
Seat 4: SoNe1988 ($89 in chips) 
Seat 5: matiko09 ($206.11 in chips) 
Seat 6: rmanjkeee ($99 in chips) 
Seat 7: ersevi6 ($232.03 in chips) 
Seat 8: di0d80 ($229.85 in chips) 
Seat 9: prominente ($200 in chips) 
rmanjkeee: posts small blind $1
ersevi6: posts big blind $2
*** HOLE CARDS ***
Dealt to matiko09 [Qc 6h]
di0d80: folds 
prominente: folds 
13Ghosts: folds 
libbyyww: folds 
adrenalin333: raises $4 to $6
SoNe1988: folds 
matiko09: folds 
rmanjkeee: folds 
ersevi6: folds 
Uncalled bet ($4) returned to adrenalin333
adrenalin333 collected $5 from pot
adrenalin333: doesn't show hand 
*** SUMMARY ***
Total pot $5 | Rake $0 
Seat 1: 13Ghosts folded before Flop (didn't bet)
Seat 2: libbyyww folded before Flop (didn't bet)
Seat 3: adrenalin333 collected ($5)
Seat 4: SoNe1988 folded before Flop (didn't bet)
Seat 5: matiko09 (button) folded before Flop (didn't bet)
Seat 6: rmanjkeee (small blind) folded before Flop
Seat 7: ersevi6 (big blind) folded before Flop
Seat 8: di0d80 folded before Flop (didn't bet)
Seat 9: prominente folded before Flop (didn't bet)





PokerStars Hand #152560133687:  Hold'em No Limit ($1/$2 USD) - 2016/04/28 15:28:51 CET [2016/04/28 9:28:51 ET]
Table 'Sequoia II' 9-max Seat #3 is the button
Seat 3: Teddygram902 ($200 in chips) 
Seat 4: wiseyoyo ($210.13 in chips) 
Seat 5: matiko09 ($200 in chips) 
Seat 6: YOU-MAD-BR0 ($200 in chips) 
Seat 7: libbyyww ($200 in chips) 
wiseyoyo: posts small blind $1
matiko09: posts big blind $2
CI58: sits out 
gudridornot: sits out 
Teddygram902: posts the ante $0.40
wiseyoyo: posts the ante $0.40
matiko09: posts the ante $0.40
YOU-MAD-BR0: posts the ante $0.40
libbyyww: posts the ante $0.40
*** HOLE CARDS ***
Dealt to matiko09 [Qs Js]
YOU-MAD-BR0: folds 
libbyyww: raises $2.24 to $4.24
Teddygram902: calls $4.24
wiseyoyo: raises $16.76 to $21
matiko09: folds 
libbyyww: folds 
Teddygram902: folds 
Uncalled bet ($16.76) returned to wiseyoyo
wiseyoyo collected $16.72 from pot
wiseyoyo: doesn't show hand 
*** SUMMARY ***
Total pot $16.72 | Rake $0 
Seat 3: Teddygram902 (button) folded before Flop
Seat 4: wiseyoyo (small blind) collected ($16.72)
Seat 5: matiko09 (big blind) folded before Flop
Seat 6: YOU-MAD-BR0 folded before Flop (didn't bet)
Seat 7: libbyyww folded before Flop





PokerStars Hand #152560137548:  Hold'em No Limit ($0.50/$1.00 USD) - 2016/04/28 15:28:57 CET [2016/04/28 9:28:57 ET]
Table 'Halleria' 9-max Seat #9 is the button
Seat 2: R1aki ($108.04 in chips) 
Seat 3: maxxmeister ($106.08 in chips) 
Seat 4: ka100pka527 ($37 in chips) 
Seat 5: gcz_1886_1 ($111.45 in chips) 
Seat 7: I The King I ($100 in chips) 
Seat 8: sanpidk ($105.11 in chips) 
Seat 9: matiko09 ($103 in chips) 
JediGaGa will be allowed to play after the button
R1aki: posts small blind $0.50
maxxmeister: posts big blind $1
*** HOLE CARDS ***
Dealt to matiko09 [Kh As]
ka100pka527: folds 
gcz_1886_1: folds 
I The King I: raises $2 to $3
sanpidk: folds 
matiko09: raises $6 to $9
R1aki: folds 
maxxmeister: folds 
I The King I: folds 
Uncalled bet ($6) returned to matiko09
matiko09 collected $7.50 from pot
matiko09: doesn't show hand 
*** SUMMARY ***
Total pot $7.50 | Rake $0 
Seat 2: R1aki (small blind) folded before Flop
Seat 3: maxxmeister (big blind) folded before Flop
Seat 4: ka100pka527 folded before Flop (didn't bet)
Seat 5: gcz_1886_1 folded before Flop (didn't bet)
Seat 7: I The King I folded before Flop
Seat 8: sanpidk folded before Flop (didn't bet)
Seat 9: matiko09 (button) collected ($7.50)





PokerStars Hand #152560141133:  Hold'em No Limit (€0.50/€1.00 EUR) - 2016/04/28 15:29:03 CET [2016/04/28 9:29:03 ET]
Table 'Lumiere II' 9-max Seat #5 is the button
Seat 2: Racushniak (€109.40 in chips) 
Seat 4: ruslik_by (€55.70 in chips) 
Seat 5: Schmidy7 (€49.20 in chips) 
Seat 6: azzad2007 (€96 in chips) 
Seat 7: hammerwife (€108.18 in chips) 
Seat 8: sanpidk (€107.30 in chips) 
Seat 9: matiko09 (€104 in chips) 
azzad2007: posts small blind €0.50
hammerwife: posts big blind €1
maxxmeister: sits out 
*** HOLE CARDS ***
Dealt to matiko09 [3h Jd]
sanpidk: folds 
matiko09: folds 
Racushniak: folds 
ruslik_by: raises €1.50 to €2.50
Schmidy7: calls €2.50
azzad2007: folds 
hammerwife: calls €1.50
*** FLOP *** [9d 3s 3c]
hammerwife: checks 
ruslik_by: bets €2.50
Schmidy7: calls €2.50
hammerwife: folds 
*** TURN *** [9d 3s 3c] [4h]
ruslik_by: checks 
Schmidy7: checks 
*** RIVER *** [9d 3s 3c 4h] [Qc]
ruslik_by: checks 
Schmidy7: checks 
*** SHOW DOWN ***
ruslik_by: shows [Ks Js] (a pair of Threes)
Schmidy7: shows [2d Ad] (a pair of Threes - Ace kicker)
Schmidy7 collected €12.35 from pot
*** SUMMARY ***
Total pot €13 | Rake €0.65 
Board [9d 3s 3c 4h Qc]
Seat 2: Racushniak folded before Flop (didn't bet)
Seat 4: ruslik_by showed [Ks Js] and lost with a pair of Threes
Seat 5: Schmidy7 (button) showed [2d Ad] and won (€12.35) with a pair of Threes
Seat 6: azzad2007 (small blind) folded before Flop
Seat 7: hammerwife (big blind) folded on the Flop
Seat 8: sanpidk folded before Flop (didn't bet)
Seat 9: matiko09 folded before Flop (didn't bet)





PokerStars Hand #152560146512:  Hold'em No Limit ($0.50/$1.00 USD) - 2016/04/28 15:29:12 CET [2016/04/28 9:29:12 ET]
Table 'Agapenor III' 9-max Seat #6 is the button
Seat 1: I The King I ($103.67 in chips) 
Seat 2: cerbisor1 ($48.47 in chips) 
Seat 3: sanpidk ($148.63 in chips) 
Seat 4: matiko09 ($100 in chips) 
Seat 6: azzad2007 ($114.93 in chips) 
Seat 7: tylerz71 ($120.48 in chips) 
Seat 8: Ceanucs ($52.51 in chips) 
Seat 9: DYO1000 ($42.33 in chips) 
tylerz71: posts small blind $0.50
Ceanucs: posts big blind $1
maxxmeister: sits out 
*** HOLE CARDS ***
Dealt to matiko09 [Ts 8c]
DYO1000: calls $1
I The King I: folds 
cerbisor1: folds 
sanpidk: raises $3 to $4
matiko09: folds 
azzad2007: folds 
tylerz71: folds 
Ceanucs: folds 
DYO1000: calls $3
*** FLOP *** [7d Td 5d]
DYO1000: bets $4.51
sanpidk: folds 
Uncalled bet ($4.51) returned to DYO1000
DYO1000 collected $9.02 from pot
DYO1000: doesn't show hand 
*** SUMMARY ***
Total pot $9.50 | Rake $0.48 
Board [7d Td 5d]
Seat 1: I The King I folded before Flop (didn't bet)
Seat 2: cerbisor1 folded before Flop (didn't bet)
Seat 3: sanpidk folded on the Flop
Seat 4: matiko09 folded before Flop (didn't bet)
Seat 6: azzad2007 (button) folded before Flop (didn't bet)
Seat 7: tylerz71 (small blind) folded before Flop
Seat 8: Ceanucs (big blind) folded before Flop
Seat 9: DYO1000 collected ($9.02)





PokerStars Hand #152560150462:  Hold'em No Limit ($0.50/$1.00 USD) - 2016/04/28 15:29:19 CET [2016/04/28 9:29:19 ET]
Table 'Musa II' 9-max Seat #6 is the button
Seat 1: matiko09 ($112.02 in chips) 
Seat 2: ozone2003 ($100 in chips) 
Seat 3: vrnMike ($100 in chips) 
Seat 4: ipashutapkom ($40 in chips) 
Seat 6: skolombi77 ($80.97 in chips) 
Seat 7: ka100pka527 ($77.50 in chips) 
Seat 8: darren1031 ($80 in chips) 
Seat 9: Moszes360 ($141.58 in chips) 
ka100pka527: posts small blind $0.50
darren1031: posts big blind $1
thecurv: sits out 
*** HOLE CARDS ***
Dealt to matiko09 [Tc 3h]
Moszes360: folds 
matiko09: folds 
ozone2003: folds 
vrnMike: folds 
ipashutapkom: folds 
skolombi77: raises $1 to $2
ka100pka527: folds 
darren1031: calls $1
*** FLOP *** [4d 4c 7s]
darren1031: checks 
skolombi77: bets $2
darren1031: folds 
Uncalled bet ($2) returned to skolombi77
skolombi77 collected $4.28 from pot
skolombi77: doesn't show hand 
*** SUMMARY ***
Total pot $4.50 | Rake $0.22 
Board [4d 4c 7s]
Seat 1: matiko09 folded before Flop (didn't bet)
Seat 2: ozone2003 folded before Flop (didn't bet)
Seat 3: vrnMike folded before Flop (didn't bet)
Seat 4: ipashutapkom folded before Flop (didn't bet)
Seat 6: skolombi77 (button) collected ($4.28)
Seat 7: ka100pka527 (small blind) folded before Flop
Seat 8: darren1031 (big blind) folded on the Flop
Seat 9: Moszes360 folded before Flop (didn't bet)





PokerStars Hand #152560151360:  Hold'em No Limit ($1/$2 USD) - 2016/04/28 15:29:20 CET [2016/04/28 9:29:20 ET]
Table 'Idomeneus II' 9-max Seat #6 is the button
Seat 1: 13Ghosts ($255.36 in chips) 
Seat 2: libbyyww ($410.61 in chips) 
Seat 3: adrenalin333 ($122.73 in chips) 
Seat 4: SoNe1988 ($89 in chips) 
Seat 5: matiko09 ($206.11 in chips) 
Seat 6: rmanjkeee ($98 in chips) 
Seat 7: ersevi6 ($230.03 in chips) 
Seat 8: di0d80 ($229.85 in chips) 
Seat 9: prominente ($200 in chips) 
ersevi6: posts small blind $1
di0d80: posts big blind $2
*** HOLE CARDS ***
Dealt to matiko09 [2d Tc]
prominente: folds 
13Ghosts: folds 
libbyyww: folds 
adrenalin333: folds 
SoNe1988: folds 
matiko09: folds 
rmanjkeee: folds 
ersevi6: raises $3 to $5
di0d80: raises $10 to $15
ersevi6: folds 
Uncalled bet ($10) returned to di0d80
di0d80 collected $10 from pot
di0d80: doesn't show hand 
*** SUMMARY ***
Total pot $10 | Rake $0 
Seat 1: 13Ghosts folded before Flop (didn't bet)
Seat 2: libbyyww folded before Flop (didn't bet)
Seat 3: adrenalin333 folded before Flop (didn't bet)
Seat 4: SoNe1988 folded before Flop (didn't bet)
Seat 5: matiko09 folded before Flop (didn't bet)
Seat 6: rmanjkeee (button) folded before Flop (didn't bet)
Seat 7: ersevi6 (small blind) folded before Flop
Seat 8: di0d80 (big blind) collected ($10)
Seat 9: prominente folded before Flop (didn't bet)





PokerStars Hand #152560153302:  Hold'em No Limit ($0.50/$1.00 USD) - 2016/04/28 15:29:23 CET [2016/04/28 9:29:23 ET]
Table 'Ciurlionis' 9-max Seat #7 is the button
Seat 1: sanpidk ($109.08 in chips) 
Seat 2: liuzhi14 ($99.97 in chips) 
Seat 3: I The King I ($126 in chips) 
Seat 4: ruslik_by ($205.50 in chips) 
Seat 5: matiko09 ($181.78 in chips) 
Seat 6: vrnMike ($101.50 in chips) 
Seat 7: Stopton ($97.85 in chips) 
Seat 8: omorfadramou ($100 in chips) 
Seat 9: Painkiller72 ($104.52 in chips) 
omorfadramou: posts small blind $0.50
Painkiller72: posts big blind $1
*** HOLE CARDS ***
Dealt to matiko09 [9c 5c]
sanpidk: folds 
liuzhi14: folds 
I The King I: folds 
ruslik_by: folds 
matiko09: folds 
vrnMike: folds 
Stopton: folds 
omorfadramou: folds 
Uncalled bet ($0.50) returned to Painkiller72
Painkiller72 collected $1 from pot
Painkiller72: doesn't show hand 
*** SUMMARY ***
Total pot $1 | Rake $0 
Seat 1: sanpidk folded before Flop (didn't bet)
Seat 2: liuzhi14 folded before Flop (didn't bet)
Seat 3: I The King I folded before Flop (didn't bet)
Seat 4: ruslik_by folded before Flop (didn't bet)
Seat 5: matiko09 folded before Flop (didn't bet)
Seat 6: vrnMike folded before Flop (didn't bet)
Seat 7: Stopton (button) folded before Flop (didn't bet)
Seat 8: omorfadramou (small blind) folded before Flop
Seat 9: Painkiller72 (big blind) collected ($1)





PokerStars Hand #152560155581:  Hold'em No Limit ($0.50/$1.00 USD) - 2016/04/28 15:29:27 CET [2016/04/28 9:29:27 ET]
Table 'Zachia II' 9-max Seat #7 is the button
Seat 1: greyman571 ($176.55 in chips) 
Seat 2: sanpidk ($159.26 in chips) 
Seat 3: matiko09 ($100 in chips) 
Seat 4: omorfadramou ($105.15 in chips) 
Seat 5: vrnMike ($101.50 in chips) 
Seat 6: koksskrt ($107.04 in chips) 
Seat 7: ozone2003 ($100 in chips) 
Seat 8: CI58 ($102.28 in chips) 
Seat 9: Painkiller72 ($103.28 in chips) 
CI58: posts small blind $0.50
Painkiller72: posts big blind $1
*** HOLE CARDS ***
Dealt to matiko09 [3d 8h]
greyman571: raises $2 to $3
sanpidk: calls $3
matiko09: folds 
omorfadramou: folds 
vrnMike: folds 
koksskrt: folds 
ozone2003: folds 
CI58: calls $2.50
Painkiller72: folds 
*** FLOP *** [Kd 9h Ks]
CI58: checks 
greyman571: checks 
sanpidk: checks 
*** TURN *** [Kd 9h Ks] [2d]
CI58: bets $4.75
greyman571: folds 
sanpidk: calls $4.75
*** RIVER *** [Kd 9h Ks 2d] [9d]
CI58: checks 
sanpidk: checks 
*** SHOW DOWN ***
CI58: shows [Jd Jc] (two pair, Kings and Jacks)
sanpidk: mucks hand 
CI58 collected $18.52 from pot
*** SUMMARY ***
Total pot $19.50 | Rake $0.98 
Board [Kd 9h Ks 2d 9d]
Seat 1: greyman571 folded on the Turn
Seat 2: sanpidk mucked [Td Th]
Seat 3: matiko09 folded before Flop (didn't bet)
Seat 4: omorfadramou folded before Flop (didn't bet)
Seat 5: vrnMike folded before Flop (didn't bet)
Seat 6: koksskrt folded before Flop (didn't bet)
Seat 7: ozone2003 (button) folded before Flop (didn't bet)
Seat 8: CI58 (small blind) showed [Jd Jc] and won ($18.52) with two pair, Kings and Jacks
Seat 9: Painkiller72 (big blind) folded before Flop





PokerStars Hand #152560161124:  Hold'em No Limit ($0.50/$1.00 USD) - 2016/04/28 15:29:36 CET [2016/04/28 9:29:36 ET]
Table 'Erynia' 9-max Seat #2 is the button
Seat 1: I The King I ($100 in chips) 
Seat 2: matiko09 ($155.38 in chips) 
Seat 3: vilo1070 ($103 in chips) 
Seat 4: omorfadramou ($119.68 in chips) 
Seat 5: RMilPoker ($101.50 in chips) 
Seat 6: peevoajax ($100 in chips) 
Seat 7: vrnMike ($112.24 in chips) 
Seat 8: YourKicker78 ($90.59 in chips) 
Seat 9: ruslik_by ($40.11 in chips) 
vilo1070: posts small blind $0.50
omorfadramou: posts big blind $1
*** HOLE CARDS ***
Dealt to matiko09 [2s Kh]
RMilPoker: folds 
peevoajax: folds 
vrnMike: folds 
YourKicker78: folds 
ruslik_by: folds 
I The King I: folds 
matiko09: folds 
vilo1070: folds 
Uncalled bet ($0.50) returned to omorfadramou
omorfadramou collected $1 from pot
omorfadramou: doesn't show hand 
*** SUMMARY ***
Total pot $1 | Rake $0 
Seat 1: I The King I folded before Flop (didn't bet)
Seat 2: matiko09 (button) folded before Flop (didn't bet)
Seat 3: vilo1070 (small blind) folded before Flop
Seat 4: omorfadramou (big blind) collected ($1)
Seat 5: RMilPoker folded before Flop (didn't bet)
Seat 6: peevoajax folded before Flop (didn't bet)
Seat 7: vrnMike folded before Flop (didn't bet)
Seat 8: YourKicker78 folded before Flop (didn't bet)
Seat 9: ruslik_by folded before Flop (didn't bet)





PokerStars Hand #152560167846:  Hold'em No Limit ($1/$2 USD) - 2016/04/28 15:29:47 CET [2016/04/28 9:29:47 ET]
Table 'Sequoia II' 9-max Seat #4 is the button
Seat 2: gudridornot ($200 in chips) 
Seat 3: Teddygram902 ($195.36 in chips) 
Seat 4: wiseyoyo ($222.21 in chips) 
Seat 5: matiko09 ($200 in chips) 
Seat 6: YOU-MAD-BR0 ($200 in chips) 
Seat 7: libbyyww ($200 in chips) 
matiko09: posts small blind $1
YOU-MAD-BR0: posts big blind $2
CI58: sits out 
gudridornot: posts big blind $2
gudridornot: posts the ante $0.40
Teddygram902: posts the ante $0.40
wiseyoyo: posts the ante $0.40
matiko09: posts the ante $0.40
YOU-MAD-BR0: posts the ante $0.40
libbyyww: posts the ante $0.40
*** HOLE CARDS ***
Dealt to matiko09 [5h Ah]
libbyyww: raises $6 to $8
gudridornot: calls $6
Teddygram902: folds 
wiseyoyo: folds 
matiko09: folds 
YOU-MAD-BR0: folds 
*** FLOP *** [3s 8s Ad]
libbyyww: bets $14
gudridornot: calls $14
*** TURN *** [3s 8s Ad] [Qd]
libbyyww: checks 
gudridornot: bets $30
libbyyww: calls $30
*** RIVER *** [3s 8s Ad Qd] [7s]
libbyyww: checks 
gudridornot: checks 
*** SHOW DOWN ***
libbyyww: shows [7c As] (two pair, Aces and Sevens)
gudridornot: mucks hand 
libbyyww collected $106.65 from pot
*** SUMMARY ***
Total pot $109.40 | Rake $2.75 
Board [3s 8s Ad Qd 7s]
Seat 2: gudridornot mucked [Jd 5s]
Seat 3: Teddygram902 folded before Flop (didn't bet)
Seat 4: wiseyoyo (button) folded before Flop (didn't bet)
Seat 5: matiko09 (small blind) folded before Flop
Seat 6: YOU-MAD-BR0 (big blind) folded before Flop
Seat 7: libbyyww showed [7c As] and won ($106.65) with two pair, Aces and Sevens





PokerStars Hand #152560167489:  Hold'em No Limit ($0.50/$1.00 USD) - 2016/04/28 15:29:47 CET [2016/04/28 9:29:47 ET]
Table 'Halleria' 9-max Seat #2 is the button
Seat 2: R1aki ($107.54 in chips) 
Seat 3: maxxmeister ($105.08 in chips) 
Seat 4: ka100pka527 ($37 in chips) 
Seat 5: gcz_1886_1 ($111.45 in chips) 
Seat 7: I The King I ($100 in chips) 
Seat 8: sanpidk ($105.11 in chips) 
Seat 9: matiko09 ($107.50 in chips) 
maxxmeister: posts small blind $0.50
ka100pka527: posts big blind $1
JediGaGa: sits out 
*** HOLE CARDS ***
Dealt to matiko09 [Kc 3d]
gcz_1886_1: folds 
I The King I: folds 
sanpidk: folds 
matiko09: folds 
R1aki: raises $1.50 to $2.50
maxxmeister: folds 
ka100pka527: folds 
Uncalled bet ($1.50) returned to R1aki
R1aki collected $2.50 from pot
R1aki: doesn't show hand 
*** SUMMARY ***
Total pot $2.50 | Rake $0 
Seat 2: R1aki (button) collected ($2.50)
Seat 3: maxxmeister (small blind) folded before Flop
Seat 4: ka100pka527 (big blind) folded before Flop
Seat 5: gcz_1886_1 folded before Flop (didn't bet)
Seat 7: I The King I folded before Flop (didn't bet)
Seat 8: sanpidk folded before Flop (didn't bet)
Seat 9: matiko09 folded before Flop (didn't bet)





PokerStars Hand #152560172140:  Hold'em No Limit ($0.50/$1.00 USD) - 2016/04/28 15:29:54 CET [2016/04/28 9:29:54 ET]
Table 'Bruwer' 9-max Seat #9 is the button
Seat 1: peevoajax ($100 in chips) 
Seat 2: ruslik_by ($42.85 in chips) 
Seat 3: koksskrt ($143.01 in chips) 
Seat 4: matiko09 ($136.54 in chips) 
Seat 5: Carloszhang ($110.44 in chips) 
Seat 6: I The King I ($107.52 in chips) 
Seat 7: R1aki ($220.66 in chips) 
Seat 8: ozone2003 ($103.50 in chips) 
Seat 9: Dantist1122 ($121.65 in chips) 
peevoajax: posts small blind $0.50
ruslik_by: posts big blind $1
*** HOLE CARDS ***
Dealt to matiko09 [4c Kc]
koksskrt: folds 
matiko09: folds 
Carloszhang: folds 
I The King I: folds 
R1aki: folds 
ozone2003: folds 
Dantist1122: raises $1.05 to $2.05
peevoajax: folds 
ruslik_by: raises $4.95 to $7
Dantist1122: folds 
Uncalled bet ($4.95) returned to ruslik_by
ruslik_by collected $4.60 from pot
ruslik_by: doesn't show hand 
*** SUMMARY ***
Total pot $4.60 | Rake $0 
Seat 1: peevoajax (small blind) folded before Flop
Seat 2: ruslik_by (big blind) collected ($4.60)
Seat 3: koksskrt folded before Flop (didn't bet)
Seat 4: matiko09 folded before Flop (didn't bet)
Seat 5: Carloszhang folded before Flop (didn't bet)
Seat 6: I The King I folded before Flop (didn't bet)
Seat 7: R1aki folded before Flop (didn't bet)
Seat 8: ozone2003 folded before Flop (didn't bet)
Seat 9: Dantist1122 (button) folded before Flop





PokerStars Hand #152560174536:  Hold'em No Limit ($0.50/$1.00 USD) - 2016/04/28 15:29:58 CET [2016/04/28 9:29:58 ET]
Table 'Musa II' 9-max Seat #7 is the button
Seat 1: matiko09 ($112.02 in chips) 
Seat 2: ozone2003 ($100 in chips) 
Seat 3: vrnMike ($100 in chips) 
Seat 4: ipashutapkom ($40 in chips) 
Seat 6: skolombi77 ($83.25 in chips) 
Seat 7: ka100pka527 ($77 in chips) 
Seat 8: darren1031 ($80 in chips) 
Seat 9: Moszes360 ($141.58 in chips) 
darren1031: posts small blind $0.50
Moszes360: posts big blind $1
thecurv: sits out 
*** HOLE CARDS ***
Dealt to matiko09 [7h Ac]
matiko09: folds 
ozone2003: folds 
vrnMike: folds 
ipashutapkom: folds 
skolombi77: folds 
ka100pka527: raises $1 to $2
darren1031: folds 
Moszes360: folds 
Uncalled bet ($1) returned to ka100pka527
ka100pka527 collected $2.50 from pot
ka100pka527: doesn't show hand 
*** SUMMARY ***
Total pot $2.50 | Rake $0 
Seat 1: matiko09 folded before Flop (didn't bet)
Seat 2: ozone2003 folded before Flop (didn't bet)
Seat 3: vrnMike folded before Flop (didn't bet)
Seat 4: ipashutapkom folded before Flop (didn't bet)
Seat 6: skolombi77 folded before Flop (didn't bet)
Seat 7: ka100pka527 (button) collected ($2.50)
Seat 8: darren1031 (small blind) folded before Flop
Seat 9: Moszes360 (big blind) folded before Flop





PokerStars Hand #152560181955:  Hold'em No Limit ($0.50/$1.00 USD) - 2016/04/28 15:30:10 CET [2016/04/28 9:30:10 ET]
Table 'Agapenor III' 9-max Seat #7 is the button
Seat 1: I The King I ($103.67 in chips) 
Seat 2: cerbisor1 ($48.47 in chips) 
Seat 3: sanpidk ($144.63 in chips) 
Seat 4: matiko09 ($100 in chips) 
Seat 6: azzad2007 ($114.93 in chips) 
Seat 7: tylerz71 ($119.98 in chips) 
Seat 8: Ceanucs ($51.51 in chips) 
Seat 9: DYO1000 ($47.35 in chips) 
Ceanucs: posts small blind $0.50
DYO1000: posts big blind $1
maxxmeister: sits out 
*** HOLE CARDS ***
Dealt to matiko09 [5d 3h]
I The King I: folds 
cerbisor1: folds 
sanpidk: folds 
matiko09: folds 
azzad2007: folds 
tylerz71: folds 
Ceanucs: calls $0.50
DYO1000: checks 
*** FLOP *** [4c Qh 6s]
Ceanucs: checks 
DYO1000: checks 
*** TURN *** [4c Qh 6s] [9s]
Ceanucs: checks 
DYO1000: checks 
*** RIVER *** [4c Qh 6s 9s] [3s]
Ceanucs: bets $1
DYO1000: folds 
Uncalled bet ($1) returned to Ceanucs
Ceanucs collected $1.90 from pot
*** SUMMARY ***
Total pot $2 | Rake $0.10 
Board [4c Qh 6s 9s 3s]
Seat 1: I The King I folded before Flop (didn't bet)
Seat 2: cerbisor1 folded before Flop (didn't bet)
Seat 3: sanpidk folded before Flop (didn't bet)
Seat 4: matiko09 folded before Flop (didn't bet)
Seat 6: azzad2007 folded before Flop (didn't bet)
Seat 7: tylerz71 (button) folded before Flop (didn't bet)
Seat 8: Ceanucs (small blind) collected ($1.90)
Seat 9: DYO1000 (big blind) folded on the River





PokerStars Hand #152560183072:  Hold'em No Limit ($0.50/$1.00 USD) - 2016/04/28 15:30:12 CET [2016/04/28 9:30:12 ET]
Table 'Erynia' 9-max Seat #3 is the button
Seat 1: I The King I ($100 in chips) 
Seat 2: matiko09 ($155.38 in chips) 
Seat 3: vilo1070 ($102.50 in chips) 
Seat 4: omorfadramou ($120.18 in chips) 
Seat 5: RMilPoker ($101.50 in chips) 
Seat 6: peevoajax ($100 in chips) 
Seat 7: vrnMike ($112.24 in chips) 
Seat 8: YourKicker78 ($90.59 in chips) 
Seat 9: ruslik_by ($40.11 in chips) 
omorfadramou: posts small blind $0.50
RMilPoker: posts big blind $1
*** HOLE CARDS ***
Dealt to matiko09 [8d 7d]
peevoajax: folds 
vrnMike: folds 
YourKicker78: folds 
ruslik_by: folds 
I The King I: folds 
matiko09: raises $1.50 to $2.50
vilo1070: calls $2.50
omorfadramou: folds 
RMilPoker: folds 
*** FLOP *** [2s 9d 4h]
matiko09: bets $4.02
vilo1070: calls $4.02
*** TURN *** [2s 9d 4h] [2h]
matiko09: checks 
vilo1070: checks 
*** RIVER *** [2s 9d 4h 2h] [Qh]
matiko09: checks 
vilo1070: bets $6.90
matiko09: folds 
Uncalled bet ($6.90) returned to vilo1070
vilo1070 collected $13.81 from pot
vilo1070: doesn't show hand 
*** SUMMARY ***
Total pot $14.54 | Rake $0.73 
Board [2s 9d 4h 2h Qh]
Seat 1: I The King I folded before Flop (didn't bet)
Seat 2: matiko09 folded on the River
Seat 3: vilo1070 (button) collected ($13.81)
Seat 4: omorfadramou (small blind) folded before Flop
Seat 5: RMilPoker (big blind) folded before Flop
Seat 6: peevoajax folded before Flop (didn't bet)
Seat 7: vrnMike folded before Flop (didn't bet)
Seat 8: YourKicker78 folded before Flop (didn't bet)
Seat 9: ruslik_by folded before Flop (didn't bet)





PokerStars Hand #152560183865:  Hold'em No Limit ($0.50/$1.00 USD) - 2016/04/28 15:30:14 CET [2016/04/28 9:30:14 ET]
Table 'Ciurlionis' 9-max Seat #8 is the button
Seat 1: sanpidk ($109.08 in chips) 
Seat 2: liuzhi14 ($99.97 in chips) 
Seat 3: I The King I ($126 in chips) 
Seat 4: ruslik_by ($205.50 in chips) 
Seat 5: matiko09 ($181.78 in chips) 
Seat 6: vrnMike ($101.50 in chips) 
Seat 7: Stopton ($97.85 in chips) 
Seat 8: omorfadramou ($100 in chips) 
Seat 9: Painkiller72 ($105.02 in chips) 
Painkiller72: posts small blind $0.50
sanpidk: posts big blind $1
*** HOLE CARDS ***
Dealt to matiko09 [5h 7c]
liuzhi14: raises $2 to $3
I The King I: folds 
ruslik_by: calls $3
matiko09: folds 
vrnMike: folds 
Stopton: calls $3
omorfadramou: folds 
Painkiller72: calls $2.50
sanpidk: folds 
*** FLOP *** [Ts Ks 3h]
Painkiller72: checks 
liuzhi14: bets $7
ruslik_by: calls $7
Stopton: folds 
Painkiller72: raises $16.67 to $23.67
liuzhi14: calls $16.67
ruslik_by: folds 
*** TURN *** [Ts Ks 3h] [8c]
Painkiller72: bets $25
liuzhi14: calls $25
*** RIVER *** [Ts Ks 3h 8c] [Jc]
Painkiller72: bets $53.35 and is all-in
liuzhi14: calls $48.30 and is all-in
Uncalled bet ($5.05) returned to Painkiller72
*** SHOW DOWN ***
Painkiller72: shows [3c 3d] (three of a kind, Threes)
liuzhi14: shows [Ac Kh] (a pair of Kings)
Painkiller72 collected $211.44 from pot
*** SUMMARY ***
Total pot $213.94 | Rake $2.50 
Board [Ts Ks 3h 8c Jc]
Seat 1: sanpidk (big blind) folded before Flop
Seat 2: liuzhi14 showed [Ac Kh] and lost with a pair of Kings
Seat 3: I The King I folded before Flop (didn't bet)
Seat 4: ruslik_by folded on the Flop
Seat 5: matiko09 folded before Flop (didn't bet)
Seat 6: vrnMike folded before Flop (didn't bet)
Seat 7: Stopton folded on the Flop
Seat 8: omorfadramou (button) folded before Flop (didn't bet)
Seat 9: Painkiller72 (small blind) showed [3c 3d] and won ($211.44) with three of a kind, Threes





PokerStars Hand #152560186506:  Hold'em No Limit ($0.50/$1.00 USD) - 2016/04/28 15:30:18 CET [2016/04/28 9:30:18 ET]
Table 'Musa II' 9-max Seat #8 is the button
Seat 1: matiko09 ($112.02 in chips) 
Seat 2: ozone2003 ($100 in chips) 
Seat 3: vrnMike ($100 in chips) 
Seat 4: ipashutapkom ($40 in chips) 
Seat 6: skolombi77 ($83.25 in chips) 
Seat 7: ka100pka527 ($78.50 in chips) 
Seat 8: darren1031 ($80 in chips) 
Seat 9: Moszes360 ($140.58 in chips) 
Moszes360: posts small blind $0.50
matiko09: posts big blind $1
thecurv: sits out 
*** HOLE CARDS ***
Dealt to matiko09 [Qh 3c]
ozone2003: folds 
vrnMike: folds 
ipashutapkom: folds 
skolombi77: folds 
ka100pka527: raises $2 to $3
darren1031: raises $4 to $7
Moszes360: folds 
matiko09: folds 
ka100pka527: calls $4
*** FLOP *** [2c 5c 9c]
ka100pka527: checks 
darren1031: bets $7.36
ka100pka527: folds 
Uncalled bet ($7.36) returned to darren1031
darren1031 collected $14.72 from pot
darren1031: doesn't show hand 
*** SUMMARY ***
Total pot $15.50 | Rake $0.78 
Board [2c 5c 9c]
Seat 1: matiko09 (big blind) folded before Flop
Seat 2: ozone2003 folded before Flop (didn't bet)
Seat 3: vrnMike folded before Flop (didn't bet)
Seat 4: ipashutapkom folded before Flop (didn't bet)
Seat 6: skolombi77 folded before Flop (didn't bet)
Seat 7: ka100pka527 folded on the Flop
Seat 8: darren1031 (button) collected ($14.72)
Seat 9: Moszes360 (small blind) folded before Flop





PokerStars Hand #152560194146:  Hold'em No Limit ($1/$2 USD) - 2016/04/28 15:30:31 CET [2016/04/28 9:30:31 ET]
Table 'Idomeneus II' 9-max Seat #7 is the button
Seat 1: 13Ghosts ($255.36 in chips) 
Seat 2: libbyyww ($410.61 in chips) 
Seat 3: adrenalin333 ($122.73 in chips) 
Seat 4: SoNe1988 ($89 in chips) 
Seat 5: matiko09 ($206.11 in chips) 
Seat 6: rmanjkeee ($98 in chips) 
Seat 7: ersevi6 ($225.03 in chips) 
Seat 8: di0d80 ($234.85 in chips) 
Seat 9: prominente ($200 in chips) 
di0d80: posts small blind $1
prominente: posts big blind $2
*** HOLE CARDS ***
Dealt to matiko09 [2d Jd]
13Ghosts: folds 
libbyyww: raises $4 to $6
adrenalin333: folds 
SoNe1988: folds 
matiko09: folds 
rmanjkeee: folds 
ersevi6: folds 
di0d80: folds 
prominente: folds 
Uncalled bet ($4) returned to libbyyww
libbyyww collected $5 from pot
libbyyww: doesn't show hand 
*** SUMMARY ***
Total pot $5 | Rake $0 
Seat 1: 13Ghosts folded before Flop (didn't bet)
Seat 2: libbyyww collected ($5)
Seat 3: adrenalin333 folded before Flop (didn't bet)
Seat 4: SoNe1988 folded before Flop (didn't bet)
Seat 5: matiko09 folded before Flop (didn't bet)
Seat 6: rmanjkeee folded before Flop (didn't bet)
Seat 7: ersevi6 (button) folded before Flop (didn't bet)
Seat 8: di0d80 (small blind) folded before Flop
Seat 9: prominente (big blind) folded before Flop





PokerStars Hand #152560195303:  Hold'em No Limit (€0.50/€1.00 EUR) - 2016/04/28 15:30:32 CET [2016/04/28 9:30:32 ET]
Table 'Lumiere II' 9-max Seat #6 is the button
Seat 2: Racushniak (€109.40 in chips) 
Seat 4: ruslik_by (€50.70 in chips) 
Seat 5: Schmidy7 (€56.55 in chips) 
Seat 6: azzad2007 (€95.50 in chips) 
Seat 7: hammerwife (€105.68 in chips) 
Seat 8: sanpidk (€107.30 in chips) 
Seat 9: matiko09 (€104 in chips) 
hammerwife: posts small blind €0.50
sanpidk: posts big blind €1
maxxmeister: sits out 
*** HOLE CARDS ***
Dealt to matiko09 [Jc 7d]
matiko09: folds 
Racushniak: folds 
ruslik_by: folds 
Schmidy7: folds 
azzad2007: raises €1.40 to €2.40
9lKBXKTT6 joins the table at seat #3 
hammerwife: folds 
sanpidk: folds 
Uncalled bet (€1.40) returned to azzad2007
azzad2007 collected €2.50 from pot
azzad2007: doesn't show hand 
*** SUMMARY ***
Total pot €2.50 | Rake €0 
Seat 2: Racushniak folded before Flop (didn't bet)
Seat 4: ruslik_by folded before Flop (didn't bet)
Seat 5: Schmidy7 folded before Flop (didn't bet)
Seat 6: azzad2007 (button) collected (€2.50)
Seat 7: hammerwife (small blind) folded before Flop
Seat 8: sanpidk (big blind) folded before Flop
Seat 9: matiko09 folded before Flop (didn't bet)





PokerStars Hand #152560198973:  Hold'em No Limit ($0.50/$1.00 USD) - 2016/04/28 15:30:38 CET [2016/04/28 9:30:38 ET]
Table 'Zachia II' 9-max Seat #8 is the button
Seat 1: greyman571 ($173.55 in chips) 
Seat 2: sanpidk ($151.51 in chips) 
Seat 3: matiko09 ($100 in chips) 
Seat 4: omorfadramou ($105.15 in chips) 
Seat 5: vrnMike ($101.50 in chips) 
Seat 6: koksskrt ($107.04 in chips) 
Seat 7: ozone2003 ($100 in chips) 
Seat 8: CI58 ($113.05 in chips) 
Seat 9: Painkiller72 ($102.28 in chips) 
Painkiller72: posts small blind $0.50
greyman571: posts big blind $1
*** HOLE CARDS ***
Dealt to matiko09 [Qh 9s]
sanpidk: folds 
matiko09: folds 
omorfadramou: folds 
vrnMike: raises $1 to $2
koksskrt: folds 
ozone2003: folds 
CI58: folds 
Painkiller72: folds 
greyman571: calls $1
*** FLOP *** [5h Ah Jc]
greyman571: checks 
vrnMike: bets $2
greyman571: calls $2
*** TURN *** [5h Ah Jc] [6h]
greyman571: checks 
vrnMike: checks 
*** RIVER *** [5h Ah Jc 6h] [7c]
greyman571: bets $3
vrnMike: folds 
Uncalled bet ($3) returned to greyman571
greyman571 collected $8.08 from pot
greyman571: doesn't show hand 
*** SUMMARY ***
Total pot $8.50 | Rake $0.42 
Board [5h Ah Jc 6h 7c]
Seat 1: greyman571 (big blind) collected ($8.08)
Seat 2: sanpidk folded before Flop (didn't bet)
Seat 3: matiko09 folded before Flop (didn't bet)
Seat 4: omorfadramou folded before Flop (didn't bet)
Seat 5: vrnMike folded on the River
Seat 6: koksskrt folded before Flop (didn't bet)
Seat 7: ozone2003 folded before Flop (didn't bet)
Seat 8: CI58 (button) folded before Flop (didn't bet)
Seat 9: Painkiller72 (small blind) folded before Flop





PokerStars Hand #152560201653:  Hold'em No Limit ($0.50/$1.00 USD) - 2016/04/28 15:30:43 CET [2016/04/28 9:30:43 ET]
Table 'Bruwer' 9-max Seat #1 is the button
Seat 1: peevoajax ($100 in chips) 
Seat 2: ruslik_by ($45.40 in chips) 
Seat 3: koksskrt ($143.01 in chips) 
Seat 4: matiko09 ($136.54 in chips) 
Seat 5: Carloszhang ($110.44 in chips) 
Seat 6: I The King I ($107.52 in chips) 
Seat 7: R1aki ($220.66 in chips) 
Seat 8: ozone2003 ($103.50 in chips) 
Seat 9: Dantist1122 ($119.60 in chips) 
ruslik_by: posts small blind $0.50
koksskrt: posts big blind $1
*** HOLE CARDS ***
Dealt to matiko09 [Js 4h]
matiko09: folds 
Carloszhang: folds 
I The King I: folds 
R1aki: folds 
ozone2003: folds 
Dantist1122: folds 
peevoajax: folds 
ruslik_by: raises $2 to $3
koksskrt: folds 
Uncalled bet ($2) returned to ruslik_by
ruslik_by collected $2 from pot
ruslik_by: doesn't show hand 
*** SUMMARY ***
Total pot $2 | Rake $0 
Seat 1: peevoajax (button) folded before Flop (didn't bet)
Seat 2: ruslik_by (small blind) collected ($2)
Seat 3: koksskrt (big blind) folded before Flop
Seat 4: matiko09 folded before Flop (didn't bet)
Seat 5: Carloszhang folded before Flop (didn't bet)
Seat 6: I The King I folded before Flop (didn't bet)
Seat 7: R1aki folded before Flop (didn't bet)
Seat 8: ozone2003 folded before Flop (didn't bet)
Seat 9: Dantist1122 folded before Flop (didn't bet)





PokerStars Hand #152560203850:  Hold'em No Limit ($1/$2 USD) - 2016/04/28 15:30:46 CET [2016/04/28 9:30:46 ET]
Table 'Sequoia II' 9-max Seat #5 is the button
Seat 2: gudridornot ($147.60 in chips) 
Seat 3: Teddygram902 ($194.96 in chips) 
Seat 4: wiseyoyo ($221.81 in chips) 
Seat 5: matiko09 ($200 in chips) 
Seat 6: YOU-MAD-BR0 ($200 in chips) 
Seat 7: libbyyww ($254.25 in chips) 
YOU-MAD-BR0: posts small blind $1
libbyyww: posts big blind $2
CI58: sits out 
gudridornot: posts the ante $0.40
Teddygram902: posts the ante $0.40
wiseyoyo: posts the ante $0.40
matiko09: posts the ante $0.40
YOU-MAD-BR0: posts the ante $0.40
libbyyww: posts the ante $0.40
*** HOLE CARDS ***
Dealt to matiko09 [2c 3d]
gudridornot: folds 
Teddygram902: raises $3 to $5
wiseyoyo: raises $15 to $20
matiko09: folds 
YOU-MAD-BR0: folds 
libbyyww: folds 
Teddygram902: calls $15
*** FLOP *** [5d 9s 7d]
Teddygram902: checks 
wiseyoyo: bets $35
Teddygram902: raises $139.56 to $174.56 and is all-in
JustinRuth88 joins the table at seat #9 
wiseyoyo: folds 
Uncalled bet ($139.56) returned to Teddygram902
Teddygram902 collected $112.65 from pot
*** SUMMARY ***
Total pot $115.40 | Rake $2.75 
Board [5d 9s 7d]
Seat 2: gudridornot folded before Flop (didn't bet)
Seat 3: Teddygram902 collected ($112.65)
Seat 4: wiseyoyo folded on the Flop
Seat 5: matiko09 (button) folded before Flop (didn't bet)
Seat 6: YOU-MAD-BR0 (small blind) folded before Flop
Seat 7: libbyyww (big blind) folded before Flop





PokerStars Hand #152560205921:  Hold'em No Limit ($0.50/$1.00 USD) - 2016/04/28 15:30:50 CET [2016/04/28 9:30:50 ET]
Table 'Halleria' 9-max Seat #3 is the button
Seat 2: R1aki ($109.04 in chips) 
Seat 3: maxxmeister ($104.58 in chips) 
Seat 4: ka100pka527 ($36 in chips) 
Seat 5: gcz_1886_1 ($111.45 in chips) 
Seat 7: I The King I ($100 in chips) 
Seat 8: sanpidk ($105.11 in chips) 
Seat 9: matiko09 ($107.50 in chips) 
ka100pka527: posts small blind $0.50
gcz_1886_1: posts big blind $1
JediGaGa: sits out 
*** HOLE CARDS ***
Dealt to matiko09 [6c Th]
I The King I: raises $2 to $3
sanpidk: folds 
matiko09: folds 
R1aki: folds 
maxxmeister: raises $7.50 to $10.50
ka100pka527: folds 
gcz_1886_1: folds 
I The King I: folds 
Uncalled bet ($7.50) returned to maxxmeister
maxxmeister collected $7.50 from pot
maxxmeister: doesn't show hand 
*** SUMMARY ***
Total pot $7.50 | Rake $0 
Seat 2: R1aki folded before Flop (didn't bet)
Seat 3: maxxmeister (button) collected ($7.50)
Seat 4: ka100pka527 (small blind) folded before Flop
Seat 5: gcz_1886_1 (big blind) folded before Flop
Seat 7: I The King I folded before Flop
Seat 8: sanpidk folded before Flop (didn't bet)
Seat 9: matiko09 folded before Flop (didn't bet)





PokerStars Hand #152560212464:  Hold'em No Limit ($1/$2 USD) - 2016/04/28 15:31:01 CET [2016/04/28 9:31:01 ET]
Table 'Idomeneus II' 9-max Seat #8 is the button
Seat 1: 13Ghosts ($255.36 in chips) 
Seat 2: libbyyww ($413.61 in chips) 
Seat 3: adrenalin333 ($122.73 in chips) 
Seat 4: SoNe1988 ($89 in chips) 
Seat 5: matiko09 ($206.11 in chips) 
Seat 6: rmanjkeee ($98 in chips) 
Seat 7: ersevi6 ($225.03 in chips) 
Seat 8: di0d80 ($233.85 in chips) 
Seat 9: prominente ($200 in chips) 
prominente: posts small blind $1
13Ghosts: posts big blind $2
*** HOLE CARDS ***
Dealt to matiko09 [2c 6d]
libbyyww: folds 
adrenalin333: calls $2
SoNe1988: folds 
matiko09: folds 
rmanjkeee: folds 
ersevi6: folds 
di0d80: folds 
prominente: folds 
13Ghosts: checks 
*** FLOP *** [3c 9d Ts]
13Ghosts: bets $2.89
adrenalin333: raises $3.11 to $6
13Ghosts: folds 
Uncalled bet ($3.11) returned to adrenalin333
adrenalin333 collected $10.24 from pot
adrenalin333: doesn't show hand 
*** SUMMARY ***
Total pot $10.78 | Rake $0.54 
Board [3c 9d Ts]
Seat 1: 13Ghosts (big blind) folded on the Flop
Seat 2: libbyyww folded before Flop (didn't bet)
Seat 3: adrenalin333 collected ($10.24)
Seat 4: SoNe1988 folded before Flop (didn't bet)
Seat 5: matiko09 folded before Flop (didn't bet)
Seat 6: rmanjkeee folded before Flop (didn't bet)
Seat 7: ersevi6 folded before Flop (didn't bet)
Seat 8: di0d80 (button) folded before Flop (didn't bet)
Seat 9: prominente (small blind) folded before Flop





PokerStars Hand #152560214246:  Hold'em No Limit (€0.50/€1.00 EUR) - 2016/04/28 15:31:03 CET [2016/04/28 9:31:03 ET]
Table 'Lumiere II' 9-max Seat #7 is the button
Seat 2: Racushniak (€109.40 in chips) 
Seat 4: ruslik_by (€50.70 in chips) 
Seat 5: Schmidy7 (€56.55 in chips) 
Seat 6: azzad2007 (€97 in chips) 
Seat 7: hammerwife (€105.18 in chips) 
Seat 8: sanpidk (€106.30 in chips) 
Seat 9: matiko09 (€104 in chips) 
sanpidk: posts small blind €0.50
matiko09: posts big blind €1
maxxmeister: sits out 
*** HOLE CARDS ***
Dealt to matiko09 [9d As]
Racushniak: folds 
ruslik_by: raises €2 to €3
Schmidy7: folds 
azzad2007: folds 
hammerwife: folds 
sanpidk: folds 
matiko09: folds 
Uncalled bet (€2) returned to ruslik_by
ruslik_by collected €2.50 from pot
ruslik_by: doesn't show hand 
*** SUMMARY ***
Total pot €2.50 | Rake €0 
Seat 2: Racushniak folded before Flop (didn't bet)
Seat 4: ruslik_by collected (€2.50)
Seat 5: Schmidy7 folded before Flop (didn't bet)
Seat 6: azzad2007 folded before Flop (didn't bet)
Seat 7: hammerwife (button) folded before Flop (didn't bet)
Seat 8: sanpidk (small blind) folded before Flop
Seat 9: matiko09 (big blind) folded before Flop





PokerStars Hand #152560221466:  Hold'em No Limit ($0.50/$1.00 USD) - 2016/04/28 15:31:16 CET [2016/04/28 9:31:16 ET]
Table 'Erynia' 9-max Seat #4 is the button
Seat 1: I The King I ($100 in chips) 
Seat 2: matiko09 ($148.86 in chips) 
Seat 3: vilo1070 ($109.79 in chips) 
Seat 4: omorfadramou ($119.68 in chips) 
Seat 5: RMilPoker ($100.50 in chips) 
Seat 6: peevoajax ($100 in chips) 
Seat 7: vrnMike ($112.24 in chips) 
Seat 8: YourKicker78 ($90.59 in chips) 
Seat 9: ruslik_by ($40.11 in chips) 
RMilPoker: posts small blind $0.50
peevoajax: posts big blind $1
*** HOLE CARDS ***
Dealt to matiko09 [Kc 3h]
vrnMike: folds 
YourKicker78: folds 
ruslik_by: folds 
I The King I: folds 
matiko09: folds 
vilo1070: folds 
omorfadramou: raises $1.16 to $2.16
RMilPoker: folds 
peevoajax: calls $1.16
*** FLOP *** [Kh 8h Tc]
peevoajax: checks 
omorfadramou: bets $2.88
peevoajax: folds 
Uncalled bet ($2.88) returned to omorfadramou
omorfadramou collected $4.58 from pot
omorfadramou: doesn't show hand 
*** SUMMARY ***
Total pot $4.82 | Rake $0.24 
Board [Kh 8h Tc]
Seat 1: I The King I folded before Flop (didn't bet)
Seat 2: matiko09 folded before Flop (didn't bet)
Seat 3: vilo1070 folded before Flop (didn't bet)
Seat 4: omorfadramou (button) collected ($4.58)
Seat 5: RMilPoker (small blind) folded before Flop
Seat 6: peevoajax (big blind) folded on the Flop
Seat 7: vrnMike folded before Flop (didn't bet)
Seat 8: YourKicker78 folded before Flop (didn't bet)
Seat 9: ruslik_by folded before Flop (didn't bet)





PokerStars Hand #152560223031:  Hold'em No Limit ($0.50/$1.00 USD) - 2016/04/28 15:31:18 CET [2016/04/28 9:31:18 ET]
Table 'Agapenor III' 9-max Seat #8 is the button
Seat 1: I The King I ($103.67 in chips) 
Seat 2: cerbisor1 ($48.47 in chips) 
Seat 3: sanpidk ($144.63 in chips) 
Seat 4: matiko09 ($100 in chips) 
Seat 6: azzad2007 ($114.93 in chips) 
Seat 7: tylerz71 ($119.98 in chips) 
Seat 8: Ceanucs ($52.41 in chips) 
Seat 9: DYO1000 ($46.35 in chips) 
DYO1000: posts small blind $0.50
I The King I: posts big blind $1
maxxmeister: sits out 
*** HOLE CARDS ***
Dealt to matiko09 [Kd Td]
cerbisor1: folds 
sanpidk: folds 
matiko09: raises $2 to $3
azzad2007: folds 
tylerz71: folds 
Ceanucs: folds 
DYO1000: folds 
I The King I: folds 
Uncalled bet ($2) returned to matiko09
matiko09 collected $2.50 from pot
matiko09: doesn't show hand 
*** SUMMARY ***
Total pot $2.50 | Rake $0 
Seat 1: I The King I (big blind) folded before Flop
Seat 2: cerbisor1 folded before Flop (didn't bet)
Seat 3: sanpidk folded before Flop (didn't bet)
Seat 4: matiko09 collected ($2.50)
Seat 6: azzad2007 folded before Flop (didn't bet)
Seat 7: tylerz71 folded before Flop (didn't bet)
Seat 8: Ceanucs (button) folded before Flop (didn't bet)
Seat 9: DYO1000 (small blind) folded before Flop





PokerStars Hand #152560228656:  Hold'em No Limit ($0.50/$1.00 USD) - 2016/04/28 15:31:28 CET [2016/04/28 9:31:28 ET]
Table 'Bruwer' 9-max Seat #2 is the button
Seat 1: peevoajax ($100 in chips) 
Seat 2: ruslik_by ($46.40 in chips) 
Seat 3: koksskrt ($142.01 in chips) 
Seat 4: matiko09 ($136.54 in chips) 
Seat 5: Carloszhang ($110.44 in chips) 
Seat 6: I The King I ($107.52 in chips) 
Seat 7: R1aki ($220.66 in chips) 
Seat 8: ozone2003 ($103.50 in chips) 
Seat 9: Dantist1122 ($119.60 in chips) 
koksskrt: posts small blind $0.50
matiko09: posts big blind $1
*** HOLE CARDS ***
Dealt to matiko09 [Ad 6h]
Carloszhang: folds 
I The King I: folds 
R1aki: folds 
ozone2003: raises $2 to $3
Dantist1122: folds 
peevoajax: calls $3
ruslik_by: folds 
koksskrt: folds 
matiko09: folds 
*** FLOP *** [2d 9h Kc]
ozone2003: bets $5.50
peevoajax: calls $5.50
*** TURN *** [2d 9h Kc] [5d]
ozone2003: bets $12.08
peevoajax: calls $12.08
*** RIVER *** [2d 9h Kc 5d] [Jc]
ozone2003: bets $25.53
peevoajax: folds 
Uncalled bet ($25.53) returned to ozone2003
ozone2003 collected $40.53 from pot
ozone2003: doesn't show hand 
*** SUMMARY ***
Total pot $42.66 | Rake $2.13 
Board [2d 9h Kc 5d Jc]
Seat 1: peevoajax folded on the River
Seat 2: ruslik_by (button) folded before Flop (didn't bet)
Seat 3: koksskrt (small blind) folded before Flop
Seat 4: matiko09 (big blind) folded before Flop
Seat 5: Carloszhang folded before Flop (didn't bet)
Seat 6: I The King I folded before Flop (didn't bet)
Seat 7: R1aki folded before Flop (didn't bet)
Seat 8: ozone2003 collected ($40.53)
Seat 9: Dantist1122 folded before Flop (didn't bet)





PokerStars Hand #152560230338:  Hold'em No Limit (€0.50/€1.00 EUR) - 2016/04/28 15:31:30 CET [2016/04/28 9:31:30 ET]
Table 'Lumiere II' 9-max Seat #8 is the button
Seat 1: maxxmeister (€101.50 in chips) 
Seat 2: Racushniak (€109.40 in chips) 
Seat 4: ruslik_by (€52.20 in chips) 
Seat 5: Schmidy7 (€56.55 in chips) 
Seat 6: azzad2007 (€97 in chips) 
Seat 7: hammerwife (€105.18 in chips) 
Seat 8: sanpidk (€105.80 in chips) 
Seat 9: matiko09 (€103 in chips) 
matiko09: posts small blind €0.50
maxxmeister: posts big blind €1
*** HOLE CARDS ***
Dealt to matiko09 [2h 7c]
Racushniak: folds 
ruslik_by: folds 
Schmidy7: raises €2 to €3
azzad2007: folds 
hammerwife: folds 
sanpidk: folds 
matiko09: folds 
maxxmeister: folds 
Uncalled bet (€2) returned to Schmidy7
Schmidy7 collected €2.50 from pot
*** SUMMARY ***
Total pot €2.50 | Rake €0 
Seat 1: maxxmeister (big blind) folded before Flop
Seat 2: Racushniak folded before Flop (didn't bet)
Seat 4: ruslik_by folded before Flop (didn't bet)
Seat 5: Schmidy7 collected (€2.50)
Seat 6: azzad2007 folded before Flop (didn't bet)
Seat 7: hammerwife folded before Flop (didn't bet)
Seat 8: sanpidk (button) folded before Flop (didn't bet)
Seat 9: matiko09 (small blind) folded before Flop





PokerStars Hand #152560231414:  Hold'em No Limit ($0.50/$1.00 USD) - 2016/04/28 15:31:32 CET [2016/04/28 9:31:32 ET]
Table 'Halleria' 9-max Seat #4 is the button
Seat 2: R1aki ($109.04 in chips) 
Seat 3: maxxmeister ($109.08 in chips) 
Seat 4: ka100pka527 ($35.50 in chips) 
Seat 5: gcz_1886_1 ($110.45 in chips) 
Seat 6: cl.trind ($40 in chips) 
Seat 7: I The King I ($100 in chips) 
Seat 8: sanpidk ($105.11 in chips) 
Seat 9: matiko09 ($107.50 in chips) 
gcz_1886_1: posts small blind $0.50
cl.trind: posts big blind $1
JediGaGa: sits out 
*** HOLE CARDS ***
Dealt to matiko09 [7d 7h]
I The King I: raises $2 to $3
sanpidk: folds 
matiko09: calls $3
R1aki: folds 
maxxmeister: folds 
ka100pka527: folds 
gcz_1886_1: folds 
cl.trind: folds 
*** FLOP *** [3h 4s 9c]
I The King I: bets $4
matiko09: calls $4
*** TURN *** [3h 4s 9c] [Jd]
I The King I: bets $9
matiko09: calls $9
*** RIVER *** [3h 4s 9c Jd] [Qc]
I The King I: bets $23
matiko09: raises $30 to $53
I The King I: raises $31 to $84 and is all-in
matiko09: folds 
Uncalled bet ($31) returned to I The King I
I The King I collected $137 from pot
I The King I: doesn't show hand 
*** SUMMARY ***
Total pot $139.50 | Rake $2.50 
Board [3h 4s 9c Jd Qc]
Seat 2: R1aki folded before Flop (didn't bet)
Seat 3: maxxmeister folded before Flop (didn't bet)
Seat 4: ka100pka527 (button) folded before Flop (didn't bet)
Seat 5: gcz_1886_1 (small blind) folded before Flop
Seat 6: cl.trind (big blind) folded before Flop
Seat 7: I The King I collected ($137)
Seat 8: sanpidk folded before Flop (didn't bet)
Seat 9: matiko09 folded on the River





PokerStars Hand #152560238350:  Hold'em No Limit ($0.50/$1.00 USD) - 2016/04/28 15:31:43 CET [2016/04/28 9:31:43 ET]
Table 'Zachia II' 9-max Seat #9 is the button
Seat 1: greyman571 ($177.63 in chips) 
Seat 2: sanpidk ($151.51 in chips) 
Seat 3: matiko09 ($100 in chips) 
Seat 4: omorfadramou ($105.15 in chips) 
Seat 5: vrnMike ($100 in chips) 
Seat 6: koksskrt ($107.04 in chips) 
Seat 7: ozone2003 ($100 in chips) 
Seat 8: CI58 ($113.05 in chips) 
Seat 9: Painkiller72 ($101.78 in chips) 
greyman571: posts small blind $0.50
sanpidk: posts big blind $1
*** HOLE CARDS ***
Dealt to matiko09 [3h Jh]
matiko09: folds 
omorfadramou: folds 
vrnMike: folds 
koksskrt: folds 
ozone2003: folds 
CI58: folds 
Painkiller72 has timed out
Painkiller72: folds 
greyman571: calls $0.50
sanpidk: raises $3.50 to $4.50
greyman571: calls $3.50
*** FLOP *** [Js 4h 9s]
greyman571: checks 
sanpidk: bets $5.50
greyman571: calls $5.50
*** TURN *** [Js 4h 9s] [6s]
greyman571: checks 
sanpidk: checks 
*** RIVER *** [Js 4h 9s 6s] [6c]
greyman571: checks 
sanpidk: checks 
*** SHOW DOWN ***
greyman571: shows [9c Th] (two pair, Nines and Sixes)
sanpidk: mucks hand 
greyman571 collected $19 from pot
*** SUMMARY ***
Total pot $20 | Rake $1 
Board [Js 4h 9s 6s 6c]
Seat 1: greyman571 (small blind) showed [9c Th] and won ($19) with two pair, Nines and Sixes
Seat 2: sanpidk (big blind) mucked [Qc 2c]
Seat 3: matiko09 folded before Flop (didn't bet)
Seat 4: omorfadramou folded before Flop (didn't bet)
Seat 5: vrnMike folded before Flop (didn't bet)
Seat 6: koksskrt folded before Flop (didn't bet)
Seat 7: ozone2003 folded before Flop (didn't bet)
Seat 8: CI58 folded before Flop (didn't bet)
Seat 9: Painkiller72 (button) folded before Flop (didn't bet)





PokerStars Hand #152560240222:  Hold'em No Limit ($0.50/$1.00 USD) - 2016/04/28 15:31:47 CET [2016/04/28 9:31:47 ET]
Table 'Musa II' 9-max Seat #9 is the button
Seat 1: matiko09 ($111.02 in chips) 
Seat 2: ozone2003 ($100 in chips) 
Seat 3: vrnMike ($100 in chips) 
Seat 4: ipashutapkom ($40 in chips) 
Seat 6: skolombi77 ($83.25 in chips) 
Seat 7: ka100pka527 ($71.50 in chips) 
Seat 8: darren1031 ($87.72 in chips) 
Seat 9: Moszes360 ($140.08 in chips) 
matiko09: posts small blind $0.50
ozone2003: posts big blind $1
thecurv: sits out 
*** HOLE CARDS ***
Dealt to matiko09 [7h 2d]
vrnMike: folds 
ipashutapkom: raises $1.26 to $2.26
skolombi77: folds 
ka100pka527: folds 
darren1031: folds 
Moszes360: folds 
matiko09: folds 
ozone2003: folds 
Uncalled bet ($1.26) returned to ipashutapkom
ipashutapkom collected $2.50 from pot
ipashutapkom: doesn't show hand 
*** SUMMARY ***
Total pot $2.50 | Rake $0 
Seat 1: matiko09 (small blind) folded before Flop
Seat 2: ozone2003 (big blind) folded before Flop
Seat 3: vrnMike folded before Flop (didn't bet)
Seat 4: ipashutapkom collected ($2.50)
Seat 6: skolombi77 folded before Flop (didn't bet)
Seat 7: ka100pka527 folded before Flop (didn't bet)
Seat 8: darren1031 folded before Flop (didn't bet)
Seat 9: Moszes360 (button) folded before Flop (didn't bet)





PokerStars Hand #152560241168:  Hold'em No Limit ($1/$2 USD) - 2016/04/28 15:31:48 CET [2016/04/28 9:31:48 ET]
Table 'Idomeneus II' 9-max Seat #9 is the button
Seat 1: 13Ghosts ($250.47 in chips) 
Seat 2: libbyyww ($413.61 in chips) 
Seat 3: adrenalin333 ($128.08 in chips) 
Seat 4: SoNe1988 ($89 in chips) 
Seat 5: matiko09 ($206.11 in chips) 
Seat 6: rmanjkeee ($98 in chips) 
Seat 7: ersevi6 ($225.03 in chips) 
Seat 8: di0d80 ($233.85 in chips) 
Seat 9: prominente ($200 in chips) 
13Ghosts: posts small blind $1
libbyyww: posts big blind $2
*** HOLE CARDS ***
Dealt to matiko09 [Ad As]
adrenalin333: calls $2
SoNe1988: folds 
matiko09: raises $6 to $8
rmanjkeee: folds 
ersevi6: folds 
di0d80: folds 
prominente: folds 
13Ghosts: folds 
libbyyww: folds 
adrenalin333: calls $6
*** FLOP *** [2h Ah 9s]
adrenalin333: bets $20
matiko09: calls $20
*** TURN *** [2h Ah 9s] [2d]
adrenalin333: checks 
matiko09: checks 
*** RIVER *** [2h Ah 9s 2d] [Kc]
adrenalin333: checks 
matiko09: bets $36
adrenalin333: folds [Kd]
Uncalled bet ($36) returned to matiko09
matiko09 collected $56.25 from pot
matiko09: doesn't show hand 
*** SUMMARY ***
Total pot $59 | Rake $2.75 
Board [2h Ah 9s 2d Kc]
Seat 1: 13Ghosts (small blind) folded before Flop
Seat 2: libbyyww (big blind) folded before Flop
Seat 3: adrenalin333 folded on the River
Seat 4: SoNe1988 folded before Flop (didn't bet)
Seat 5: matiko09 collected ($56.25)
Seat 6: rmanjkeee folded before Flop (didn't bet)
Seat 7: ersevi6 folded before Flop (didn't bet)
Seat 8: di0d80 folded before Flop (didn't bet)
Seat 9: prominente (button) folded before Flop (didn't bet)





PokerStars Hand #152560242055:  Hold'em No Limit ($0.50/$1.00 USD) - 2016/04/28 15:31:50 CET [2016/04/28 9:31:50 ET]
Table 'Agapenor III' 9-max Seat #9 is the button
Seat 1: I The King I ($102.67 in chips) 
Seat 2: cerbisor1 ($48.47 in chips) 
Seat 3: sanpidk ($144.63 in chips) 
Seat 4: matiko09 ($101.50 in chips) 
Seat 6: azzad2007 ($114.93 in chips) 
Seat 7: tylerz71 ($119.98 in chips) 
Seat 8: Ceanucs ($52.41 in chips) 
Seat 9: DYO1000 ($45.85 in chips) 
I The King I: posts small blind $0.50
cerbisor1: posts big blind $1
maxxmeister: sits out 
*** HOLE CARDS ***
Dealt to matiko09 [7s Ac]
sanpidk: folds 
matiko09: folds 
azzad2007: folds 
tylerz71: folds 
Ceanucs has timed out
Ceanucs: folds 
DYO1000: folds 
I The King I: folds 
Uncalled bet ($0.50) returned to cerbisor1
cerbisor1 collected $1 from pot
cerbisor1: doesn't show hand 
*** SUMMARY ***
Total pot $1 | Rake $0 
Seat 1: I The King I (small blind) folded before Flop
Seat 2: cerbisor1 (big blind) collected ($1)
Seat 3: sanpidk folded before Flop (didn't bet)
Seat 4: matiko09 folded before Flop (didn't bet)
Seat 6: azzad2007 folded before Flop (didn't bet)
Seat 7: tylerz71 folded before Flop (didn't bet)
Seat 8: Ceanucs folded before Flop (didn't bet)
Seat 9: DYO1000 (button) folded before Flop (didn't bet)





PokerStars Hand #152560253200:  Hold'em No Limit ($1/$2 USD) - 2016/04/28 15:32:08 CET [2016/04/28 9:32:08 ET]
Table 'Sequoia II' 9-max Seat #6 is the button
Seat 2: gudridornot ($200 in chips) 
Seat 3: Teddygram902 ($252.21 in chips) 
Seat 4: wiseyoyo ($200 in chips) 
Seat 5: matiko09 ($200 in chips) 
Seat 6: YOU-MAD-BR0 ($200 in chips) 
Seat 7: libbyyww ($251.85 in chips) 
Seat 8: CI58 ($200 in chips) 
Seat 9: JustinRuth88 ($160 in chips) 
libbyyww: posts small blind $1
CI58: posts big blind $2
JustinRuth88: posts big blind $2
gudridornot: posts the ante $0.40
Teddygram902: posts the ante $0.40
wiseyoyo: posts the ante $0.40
matiko09: posts the ante $0.40
YOU-MAD-BR0: posts the ante $0.40
libbyyww: posts the ante $0.40
CI58: posts the ante $0.40
JustinRuth88: posts the ante $0.40
*** HOLE CARDS ***
Dealt to matiko09 [3h 6d]
ersevi6 joins the table at seat #1 
JustinRuth88: checks 
gudridornot: raises $10 to $12
Teddygram902: folds 
wiseyoyo: folds 
matiko09: folds 
YOU-MAD-BR0: folds 
libbyyww: folds 
CI58: folds 
JustinRuth88: folds 
Uncalled bet ($10) returned to gudridornot
gudridornot collected $10.20 from pot
gudridornot: doesn't show hand 
*** SUMMARY ***
Total pot $10.20 | Rake $0 
Seat 2: gudridornot collected ($10.20)
Seat 3: Teddygram902 folded before Flop (didn't bet)
Seat 4: wiseyoyo folded before Flop (didn't bet)
Seat 5: matiko09 folded before Flop (didn't bet)
Seat 6: YOU-MAD-BR0 (button) folded before Flop (didn't bet)
Seat 7: libbyyww (small blind) folded before Flop
Seat 8: CI58 (big blind) folded before Flop
Seat 9: JustinRuth88 folded before Flop





PokerStars Hand #152560258887:  Hold'em No Limit (€0.50/€1.00 EUR) - 2016/04/28 15:32:17 CET [2016/04/28 9:32:17 ET]
Table 'Lumiere II' 9-max Seat #9 is the button
Seat 1: maxxmeister (€100.50 in chips) 
Seat 2: Racushniak (€109.40 in chips) 
Seat 4: ruslik_by (€52.20 in chips) 
Seat 5: Schmidy7 (€58.05 in chips) 
Seat 6: azzad2007 (€97 in chips) 
Seat 7: hammerwife (€105.18 in chips) 
Seat 8: sanpidk (€105.80 in chips) 
Seat 9: matiko09 (€102.50 in chips) 
maxxmeister: posts small blind €0.50
Racushniak: posts big blind €1
*** HOLE CARDS ***
Dealt to matiko09 [4d 2d]
ruslik_by: folds 
Schmidy7: folds 
azzad2007: folds 
hammerwife: folds 
sanpidk: raises €1.50 to €2.50
matiko09: folds 
maxxmeister: folds 
Racushniak: calls €1.50
*** FLOP *** [9d Kd Ks]
Racushniak: checks 
sanpidk: bets €3.50
Racushniak: folds 
Uncalled bet (€3.50) returned to sanpidk
sanpidk collected €5.22 from pot
sanpidk: doesn't show hand 
*** SUMMARY ***
Total pot €5.50 | Rake €0.28 
Board [9d Kd Ks]
Seat 1: maxxmeister (small blind) folded before Flop
Seat 2: Racushniak (big blind) folded on the Flop
Seat 4: ruslik_by folded before Flop (didn't bet)
Seat 5: Schmidy7 folded before Flop (didn't bet)
Seat 6: azzad2007 folded before Flop (didn't bet)
Seat 7: hammerwife folded before Flop (didn't bet)
Seat 8: sanpidk collected (€5.22)
Seat 9: matiko09 (button) folded before Flop (didn't bet)





PokerStars Hand #152560264167:  Hold'em No Limit ($0.50/$1.00 USD) - 2016/04/28 15:32:26 CET [2016/04/28 9:32:26 ET]
Table 'Agapenor III' 9-max Seat #1 is the button
Seat 1: I The King I ($102.17 in chips) 
Seat 2: cerbisor1 ($48.97 in chips) 
Seat 3: sanpidk ($144.63 in chips) 
Seat 4: matiko09 ($101.50 in chips) 
Seat 6: azzad2007 ($114.93 in chips) 
Seat 7: tylerz71 ($119.98 in chips) 
Seat 9: DYO1000 ($45.85 in chips) 
cerbisor1: posts small blind $0.50
sanpidk: posts big blind $1
maxxmeister: sits out 
*** HOLE CARDS ***
Dealt to matiko09 [8d 4h]
matiko09: folds 
azzad2007: folds 
tylerz71: folds 
DYO1000: calls $1
I The King I: raises $3 to $4
cerbisor1: folds 
sanpidk: folds 
DYO1000: calls $3
*** FLOP *** [9d 3s Ad]
DYO1000: bets $4.51
I The King I: calls $4.51
*** TURN *** [9d 3s Ad] [4d]
DYO1000: checks 
I The King I: bets $10
DYO1000: calls $10
*** RIVER *** [9d 3s Ad 4d] [9h]
DYO1000: checks 
I The King I: bets $28
DYO1000: calls $27.34 and is all-in
Uncalled bet ($0.66) returned to I The King I
*** SHOW DOWN ***
I The King I: shows [Kd Ac] (two pair, Aces and Nines)
DYO1000: shows [Js Ah] (two pair, Aces and Nines - lower kicker)
I The King I collected $90.70 from pot
*** SUMMARY ***
Total pot $93.20 | Rake $2.50 
Board [9d 3s Ad 4d 9h]
Seat 1: I The King I (button) showed [Kd Ac] and won ($90.70) with two pair, Aces and Nines
Seat 2: cerbisor1 (small blind) folded before Flop
Seat 3: sanpidk (big blind) folded before Flop
Seat 4: matiko09 folded before Flop (didn't bet)
Seat 6: azzad2007 folded before Flop (didn't bet)
Seat 7: tylerz71 folded before Flop (didn't bet)
Seat 9: DYO1000 showed [Js Ah] and lost with two pair, Aces and Nines





PokerStars Hand #152560267680:  Hold'em No Limit ($0.50/$1.00 USD) - 2016/04/28 15:32:32 CET [2016/04/28 9:32:32 ET]
Table 'Erynia' 9-max Seat #5 is the button
Seat 1: I The King I ($100 in chips) 
Seat 2: matiko09 ($148.86 in chips) 
Seat 3: vilo1070 ($109.79 in chips) 
Seat 4: omorfadramou ($122.10 in chips) 
Seat 5: RMilPoker ($100 in chips) 
Seat 6: peevoajax ($100 in chips) 
Seat 7: vrnMike ($112.24 in chips) 
Seat 8: YourKicker78 ($90.59 in chips) 
Seat 9: ruslik_by ($40.11 in chips) 
peevoajax: posts small blind $0.50
vrnMike: posts big blind $1
*** HOLE CARDS ***
Dealt to matiko09 [Ah 2h]
YourKicker78: folds 
ruslik_by: folds 
I The King I: folds 
matiko09: raises $2 to $3
vilo1070: calls $3
omorfadramou: calls $3
RMilPoker: folds 
peevoajax: folds 
vrnMike: folds 
*** FLOP *** [5h As Jd]
matiko09: checks 
vilo1070: checks 
omorfadramou: checks 
*** TURN *** [5h As Jd] [Jc]
matiko09: checks 
vilo1070: checks 
omorfadramou: checks 
*** RIVER *** [5h As Jd Jc] [Tc]
matiko09: checks 
vilo1070: bets $3
omorfadramou: folds 
matiko09: calls $3
*** SHOW DOWN ***
vilo1070: shows [Ad 6d] (two pair, Aces and Jacks)
matiko09: shows [Ah 2h] (two pair, Aces and Jacks)
matiko09 collected $7.84 from pot
vilo1070 collected $7.84 from pot
*** SUMMARY ***
Total pot $16.50 | Rake $0.82 
Board [5h As Jd Jc Tc]
Seat 1: I The King I folded before Flop (didn't bet)
Seat 2: matiko09 showed [Ah 2h] and won ($7.84) with two pair, Aces and Jacks
Seat 3: vilo1070 showed [Ad 6d] and won ($7.84) with two pair, Aces and Jacks
Seat 4: omorfadramou folded on the River
Seat 5: RMilPoker (button) folded before Flop (didn't bet)
Seat 6: peevoajax (small blind) folded before Flop
Seat 7: vrnMike (big blind) folded before Flop
Seat 8: YourKicker78 folded before Flop (didn't bet)
Seat 9: ruslik_by folded before Flop (didn't bet)





PokerStars Hand #152560269135:  Hold'em No Limit ($0.50/$1.00 USD) - 2016/04/28 15:32:34 CET [2016/04/28 9:32:34 ET]
Table 'Musa II' 9-max Seat #1 is the button
Seat 1: matiko09 ($110.52 in chips) 
Seat 2: ozone2003 ($100 in chips) 
Seat 3: vrnMike ($100 in chips) 
Seat 4: ipashutapkom ($41.50 in chips) 
Seat 6: skolombi77 ($83.25 in chips) 
Seat 7: ka100pka527 ($71.50 in chips) 
Seat 8: darren1031 ($87.72 in chips) 
Seat 9: Moszes360 ($140.08 in chips) 
ozone2003: posts small blind $0.50
vrnMike: posts big blind $1
thecurv: sits out 
*** HOLE CARDS ***
Dealt to matiko09 [3s 7h]
ipashutapkom: folds 
skolombi77: folds 
ka100pka527: folds 
darren1031: folds 
Moszes360: folds 
matiko09: folds 
ozone2003: raises $1.95 to $2.95
vrnMike: calls $1.95
*** FLOP *** [4s Qd Ts]
ozone2003: checks 
vrnMike: checks 
*** TURN *** [4s Qd Ts] [4d]
ozone2003: bets $4
vrnMike: folds 
Uncalled bet ($4) returned to ozone2003
ozone2003 collected $5.60 from pot
ozone2003: doesn't show hand 
*** SUMMARY ***
Total pot $5.90 | Rake $0.30 
Board [4s Qd Ts 4d]
Seat 1: matiko09 (button) folded before Flop (didn't bet)
Seat 2: ozone2003 (small blind) collected ($5.60)
Seat 3: vrnMike (big blind) folded on the Turn
Seat 4: ipashutapkom folded before Flop (didn't bet)
Seat 6: skolombi77 folded before Flop (didn't bet)
Seat 7: ka100pka527 folded before Flop (didn't bet)
Seat 8: darren1031 folded before Flop (didn't bet)
Seat 9: Moszes360 folded before Flop (didn't bet)





PokerStars Hand #152560272832:  Hold'em No Limit ($1/$2 USD) - 2016/04/28 15:32:40 CET [2016/04/28 9:32:40 ET]
Table 'Sequoia II' 9-max Seat #7 is the button
Seat 2: gudridornot ($207.80 in chips) 
Seat 3: Teddygram902 ($251.81 in chips) 
Seat 4: wiseyoyo ($200 in chips) 
Seat 5: matiko09 ($200 in chips) 
Seat 6: YOU-MAD-BR0 ($200 in chips) 
Seat 7: libbyyww ($250.45 in chips) 
Seat 8: CI58 ($200 in chips) 
Seat 9: JustinRuth88 ($157.60 in chips) 
CI58: posts small blind $1
JustinRuth88: posts big blind $2
ersevi6: sits out 
gudridornot: posts the ante $0.40
Teddygram902: posts the ante $0.40
wiseyoyo: posts the ante $0.40
matiko09: posts the ante $0.40
YOU-MAD-BR0: posts the ante $0.40
libbyyww: posts the ante $0.40
CI58: posts the ante $0.40
JustinRuth88: posts the ante $0.40
*** HOLE CARDS ***
Dealt to matiko09 [Jc 6c]
gudridornot: raises $6 to $8
Teddygram902: folds 
wiseyoyo: folds 
matiko09: folds 
YOU-MAD-BR0: calls $8
libbyyww: folds 
CI58: folds 
JustinRuth88: folds 
*** FLOP *** [2c 5s 4c]
gudridornot: bets $18
YOU-MAD-BR0: calls $18
*** TURN *** [2c 5s 4c] [Jd]
gudridornot: bets $30
YOU-MAD-BR0: calls $30
*** RIVER *** [2c 5s 4c Jd] [8c]
gudridornot: checks 
YOU-MAD-BR0: bets $71
gudridornot: calls $71
*** SHOW DOWN ***
YOU-MAD-BR0: shows [Qc Tc] (a flush, Queen high)
gudridornot: mucks hand 
YOU-MAD-BR0 collected $257.45 from pot
*** SUMMARY ***
Total pot $260.20 | Rake $2.75 
Board [2c 5s 4c Jd 8c]
Seat 2: gudridornot mucked [As Js]
Seat 3: Teddygram902 folded before Flop (didn't bet)
Seat 4: wiseyoyo folded before Flop (didn't bet)
Seat 5: matiko09 folded before Flop (didn't bet)
Seat 6: YOU-MAD-BR0 showed [Qc Tc] and won ($257.45) with a flush, Queen high
Seat 7: libbyyww (button) folded before Flop (didn't bet)
Seat 8: CI58 (small blind) folded before Flop
Seat 9: JustinRuth88 (big blind) folded before Flop





PokerStars Hand #152560287829:  Hold'em No Limit ($0.50/$1.00 USD) - 2016/04/28 15:33:05 CET [2016/04/28 9:33:05 ET]
Table 'Bruwer' 9-max Seat #3 is the button
Seat 1: peevoajax ($100 in chips) 
Seat 2: ruslik_by ($46.40 in chips) 
Seat 3: koksskrt ($141.51 in chips) 
Seat 4: matiko09 ($135.54 in chips) 
Seat 5: Carloszhang ($110.44 in chips) 
Seat 6: I The King I ($107.52 in chips) 
Seat 7: R1aki ($220.66 in chips) 
Seat 8: ozone2003 ($123.45 in chips) 
Seat 9: Dantist1122 ($119.60 in chips) 
matiko09: posts small blind $0.50
Carloszhang: posts big blind $1
*** HOLE CARDS ***
Dealt to matiko09 [As Tc]
I The King I: folds 
R1aki: folds 
ozone2003: folds 
Dantist1122: folds 
peevoajax: folds 
ruslik_by: raises $1.50 to $2.50
koksskrt: folds 
matiko09: calls $2
Carloszhang: calls $1.50
*** FLOP *** [4d 7s 5c]
matiko09: checks 
Carloszhang: bets $4
ruslik_by: calls $4
matiko09: folds 
*** TURN *** [4d 7s 5c] [3s]
Carloszhang: bets $10
ruslik_by: folds 
Uncalled bet ($10) returned to Carloszhang
Carloszhang collected $14.72 from pot
*** SUMMARY ***
Total pot $15.50 | Rake $0.78 
Board [4d 7s 5c 3s]
Seat 1: peevoajax folded before Flop (didn't bet)
Seat 2: ruslik_by folded on the Turn
Seat 3: koksskrt (button) folded before Flop (didn't bet)
Seat 4: matiko09 (small blind) folded on the Flop
Seat 5: Carloszhang (big blind) collected ($14.72)
Seat 6: I The King I folded before Flop (didn't bet)
Seat 7: R1aki folded before Flop (didn't bet)
Seat 8: ozone2003 folded before Flop (didn't bet)
Seat 9: Dantist1122 folded before Flop (didn't bet)





PokerStars Hand #152560292262:  Hold'em No Limit (€0.50/€1.00 EUR) - 2016/04/28 15:33:12 CET [2016/04/28 9:33:12 ET]
Table 'Lumiere II' 9-max Seat #1 is the button
Seat 1: maxxmeister (€100 in chips) 
Seat 2: Racushniak (€106.90 in chips) 
Seat 4: ruslik_by (€52.20 in chips) 
Seat 5: Schmidy7 (€58.05 in chips) 
Seat 6: azzad2007 (€97 in chips) 
Seat 7: hammerwife (€105.18 in chips) 
Seat 8: sanpidk (€108.52 in chips) 
Seat 9: matiko09 (€102.50 in chips) 
Racushniak: posts small blind €0.50
ruslik_by: posts big blind €1
*** HOLE CARDS ***
Dealt to matiko09 [6c 2d]
Schmidy7: folds 
azzad2007: folds 
hammerwife: folds 
sanpidk: folds 
matiko09: folds 
maxxmeister: raises €2 to €3
Racushniak: folds 
ruslik_by: folds 
Uncalled bet (€2) returned to maxxmeister
maxxmeister collected €2.50 from pot
maxxmeister: doesn't show hand 
*** SUMMARY ***
Total pot €2.50 | Rake €0 
Seat 1: maxxmeister (button) collected (€2.50)
Seat 2: Racushniak (small blind) folded before Flop
Seat 4: ruslik_by (big blind) folded before Flop
Seat 5: Schmidy7 folded before Flop (didn't bet)
Seat 6: azzad2007 folded before Flop (didn't bet)
Seat 7: hammerwife folded before Flop (didn't bet)
Seat 8: sanpidk folded before Flop (didn't bet)
Seat 9: matiko09 folded before Flop (didn't bet)





PokerStars Hand #152560294307:  Hold'em No Limit ($0.50/$1.00 USD) - 2016/04/28 15:33:16 CET [2016/04/28 9:33:16 ET]
Table 'Zachia II' 9-max Seat #1 is the button
Seat 1: greyman571 ($186.63 in chips) 
Seat 2: sanpidk ($141.51 in chips) 
Seat 3: matiko09 ($100 in chips) 
Seat 4: omorfadramou ($105.15 in chips) 
Seat 5: vrnMike ($100 in chips) 
Seat 6: koksskrt ($107.04 in chips) 
Seat 7: ozone2003 ($100 in chips) 
Seat 8: CI58 ($113.05 in chips) 
Seat 9: Painkiller72 ($101.78 in chips) 
sanpidk: posts small blind $0.50
matiko09: posts big blind $1
*** HOLE CARDS ***
Dealt to matiko09 [6d 5d]
omorfadramou: raises $2 to $3
vrnMike: folds 
koksskrt: folds 
ozone2003: folds 
CI58: folds 
Painkiller72: folds 
greyman571: folds 
sanpidk: folds 
matiko09: folds 
Uncalled bet ($2) returned to omorfadramou
omorfadramou collected $2.50 from pot
omorfadramou: doesn't show hand 
*** SUMMARY ***
Total pot $2.50 | Rake $0 
Seat 1: greyman571 (button) folded before Flop (didn't bet)
Seat 2: sanpidk (small blind) folded before Flop
Seat 3: matiko09 (big blind) folded before Flop
Seat 4: omorfadramou collected ($2.50)
Seat 5: vrnMike folded before Flop (didn't bet)
Seat 6: koksskrt folded before Flop (didn't bet)
Seat 7: ozone2003 folded before Flop (didn't bet)
Seat 8: CI58 folded before Flop (didn't bet)
Seat 9: Painkiller72 folded before Flop (didn't bet)





PokerStars Hand #152560295738:  Hold'em No Limit ($0.50/$1.00 USD) - 2016/04/28 15:33:18 CET [2016/04/28 9:33:18 ET]
Table 'Ciurlionis' 9-max Seat #9 is the button
Seat 1: sanpidk ($108.08 in chips) 
Seat 3: I The King I ($126 in chips) 
Seat 4: ruslik_by ($195.50 in chips) 
Seat 5: matiko09 ($181.78 in chips) 
Seat 6: vrnMike ($101.50 in chips) 
Seat 7: Stopton ($94.85 in chips) 
Seat 8: omorfadramou ($100 in chips) 
Seat 9: Painkiller72 ($216.49 in chips) 
sanpidk: posts small blind $0.50
I The King I: posts big blind $1
*** HOLE CARDS ***
Dealt to matiko09 [Qh 2c]
liuzhi14 leaves the table
ruslik_by: folds 
matiko09: folds 
vrnMike: folds 
Stopton: raises $2 to $3
maxxmeister joins the table at seat #2 
omorfadramou: folds 
Painkiller72: folds 
sanpidk: folds 
I The King I: folds 
Uncalled bet ($2) returned to Stopton
Stopton collected $2.50 from pot
Stopton: doesn't show hand 
*** SUMMARY ***
Total pot $2.50 | Rake $0 
Seat 1: sanpidk (small blind) folded before Flop
Seat 3: I The King I (big blind) folded before Flop
Seat 4: ruslik_by folded before Flop (didn't bet)
Seat 5: matiko09 folded before Flop (didn't bet)
Seat 6: vrnMike folded before Flop (didn't bet)
Seat 7: Stopton collected ($2.50)
Seat 8: omorfadramou folded before Flop (didn't bet)
Seat 9: Painkiller72 (button) folded before Flop (didn't bet)





PokerStars Hand #152560296870:  Hold'em No Limit ($0.50/$1.00 USD) - 2016/04/28 15:33:20 CET [2016/04/28 9:33:20 ET]
Table 'Musa II' 9-max Seat #2 is the button
Seat 1: matiko09 ($110.52 in chips) 
Seat 2: ozone2003 ($102.65 in chips) 
Seat 3: vrnMike ($100 in chips) 
Seat 4: ipashutapkom ($41.50 in chips) 
Seat 6: skolombi77 ($83.25 in chips) 
Seat 7: ka100pka527 ($71.50 in chips) 
Seat 8: darren1031 ($87.72 in chips) 
Seat 9: Moszes360 ($140.08 in chips) 
vrnMike: posts small blind $0.50
ipashutapkom: posts big blind $1
thecurv: sits out 
*** HOLE CARDS ***
Dealt to matiko09 [Kc 5s]
skolombi77: folds 
ka100pka527: folds 
darren1031: calls $1
Moszes360: folds 
matiko09: folds 
ozone2003: folds 
vrnMike: calls $0.50
ipashutapkom: checks 
*** FLOP *** [6s 3d 6d]
vrnMike: checks 
ipashutapkom: bets $1.99
darren1031: folds 
vrnMike: calls $1.99
*** TURN *** [6s 3d 6d] [8d]
vrnMike: checks 
ipashutapkom: checks 
*** RIVER *** [6s 3d 6d 8d] [As]
vrnMike: checks 
ipashutapkom: bets $6.44
vrnMike: folds 
Uncalled bet ($6.44) returned to ipashutapkom
ipashutapkom collected $6.63 from pot
ipashutapkom: doesn't show hand 
*** SUMMARY ***
Total pot $6.98 | Rake $0.35 
Board [6s 3d 6d 8d As]
Seat 1: matiko09 folded before Flop (didn't bet)
Seat 2: ozone2003 (button) folded before Flop (didn't bet)
Seat 3: vrnMike (small blind) folded on the River
Seat 4: ipashutapkom (big blind) collected ($6.63)
Seat 6: skolombi77 folded before Flop (didn't bet)
Seat 7: ka100pka527 folded before Flop (didn't bet)
Seat 8: darren1031 folded on the Flop
Seat 9: Moszes360 folded before Flop (didn't bet)





PokerStars Hand #152560304130:  Hold'em No Limit ($0.50/$1.00 USD) - 2016/04/28 15:33:32 CET [2016/04/28 9:33:32 ET]
Table 'Halleria' 9-max Seat #5 is the button
Seat 2: R1aki ($109.04 in chips) 
Seat 3: maxxmeister ($109.08 in chips) 
Seat 4: ka100pka527 ($35.50 in chips) 
Seat 5: gcz_1886_1 ($109.95 in chips) 
Seat 6: cl.trind ($39 in chips) 
Seat 7: I The King I ($168 in chips) 
Seat 8: sanpidk ($105.11 in chips) 
Seat 9: matiko09 ($100 in chips) 
cl.trind: posts small blind $0.50
I The King I: posts big blind $1
JediGaGa: sits out 
*** HOLE CARDS ***
Dealt to matiko09 [5d Kc]
sanpidk: folds 
matiko09: folds 
R1aki: folds 
maxxmeister: folds 
ka100pka527: raises $2 to $3
gcz_1886_1: folds 
cl.trind: calls $2.50
I The King I: calls $2
*** FLOP *** [2c 3h 4d]
cl.trind: bets $4.27
I The King I: calls $4.27
ka100pka527: folds 
*** TURN *** [2c 3h 4d] [Ah]
cl.trind: bets $31.73 and is all-in
I The King I: calls $31.73
*** RIVER *** [2c 3h 4d Ah] [Qc]
*** SHOW DOWN ***
cl.trind: shows [9d 7d] (high card Ace)
I The King I: shows [Ad Js] (a pair of Aces)
I The King I collected $78.50 from pot
*** SUMMARY ***
Total pot $81 | Rake $2.50 
Board [2c 3h 4d Ah Qc]
Seat 2: R1aki folded before Flop (didn't bet)
Seat 3: maxxmeister folded before Flop (didn't bet)
Seat 4: ka100pka527 folded on the Flop
Seat 5: gcz_1886_1 (button) folded before Flop (didn't bet)
Seat 6: cl.trind (small blind) showed [9d 7d] and lost with high card Ace
Seat 7: I The King I (big blind) showed [Ad Js] and won ($78.50) with a pair of Aces
Seat 8: sanpidk folded before Flop (didn't bet)
Seat 9: matiko09 folded before Flop (didn't bet)





PokerStars Hand #152560310418:  Hold'em No Limit (€0.50/€1.00 EUR) - 2016/04/28 15:33:42 CET [2016/04/28 9:33:42 ET]
Table 'Lumiere II' 9-max Seat #2 is the button
Seat 1: maxxmeister (€101.50 in chips) 
Seat 2: Racushniak (€106.40 in chips) 
Seat 4: ruslik_by (€51.20 in chips) 
Seat 5: Schmidy7 (€58.05 in chips) 
Seat 6: azzad2007 (€97 in chips) 
Seat 7: hammerwife (€105.18 in chips) 
Seat 8: sanpidk (€108.52 in chips) 
Seat 9: matiko09 (€102.50 in chips) 
ruslik_by: posts small blind €0.50
Schmidy7: posts big blind €1
*** HOLE CARDS ***
Dealt to matiko09 [2c Ts]
azzad2007: folds 
hammerwife: folds 
sanpidk: folds 
matiko09: folds 
maxxmeister: folds 
Racushniak: raises €1.40 to €2.40
ruslik_by: folds 
Schmidy7: folds 
Uncalled bet (€1.40) returned to Racushniak
Racushniak collected €2.50 from pot
Racushniak: doesn't show hand 
*** SUMMARY ***
Total pot €2.50 | Rake €0 
Seat 1: maxxmeister folded before Flop (didn't bet)
Seat 2: Racushniak (button) collected (€2.50)
Seat 4: ruslik_by (small blind) folded before Flop
Seat 5: Schmidy7 (big blind) folded before Flop
Seat 6: azzad2007 folded before Flop (didn't bet)
Seat 7: hammerwife folded before Flop (didn't bet)
Seat 8: sanpidk folded before Flop (didn't bet)
Seat 9: matiko09 folded before Flop (didn't bet)





PokerStars Hand #152560312288:  Hold'em No Limit ($1/$2 USD) - 2016/04/28 15:33:45 CET [2016/04/28 9:33:45 ET]
Table 'Idomeneus II' 9-max Seat #1 is the button
Seat 1: 13Ghosts ($249.47 in chips) 
Seat 2: libbyyww ($411.61 in chips) 
Seat 3: adrenalin333 ($100.08 in chips) 
Seat 4: SoNe1988 ($89 in chips) 
Seat 5: matiko09 ($234.36 in chips) 
Seat 6: rmanjkeee ($98 in chips) 
Seat 7: ersevi6 ($225.03 in chips) 
Seat 8: di0d80 ($233.85 in chips) 
Seat 9: prominente ($200 in chips) 
libbyyww: posts small blind $1
adrenalin333: posts big blind $2
*** HOLE CARDS ***
Dealt to matiko09 [Kc 3h]
SoNe1988: folds 
matiko09: folds 
rmanjkeee: folds 
ersevi6: folds 
di0d80: raises $3 to $5
prominente: folds 
13Ghosts: folds 
libbyyww: folds 
adrenalin333: calls $3
*** FLOP *** [8s 6c Kh]
adrenalin333: checks 
di0d80: bets $6
adrenalin333: raises $10 to $16
di0d80: folds 
Uncalled bet ($10) returned to adrenalin333
adrenalin333 collected $21.85 from pot
adrenalin333: doesn't show hand 
*** SUMMARY ***
Total pot $23 | Rake $1.15 
Board [8s 6c Kh]
Seat 1: 13Ghosts (button) folded before Flop (didn't bet)
Seat 2: libbyyww (small blind) folded before Flop
Seat 3: adrenalin333 (big blind) collected ($21.85)
Seat 4: SoNe1988 folded before Flop (didn't bet)
Seat 5: matiko09 folded before Flop (didn't bet)
Seat 6: rmanjkeee folded before Flop (didn't bet)
Seat 7: ersevi6 folded before Flop (didn't bet)
Seat 8: di0d80 folded on the Flop
Seat 9: prominente folded before Flop (didn't bet)





PokerStars Hand #152560315226:  Hold'em No Limit ($0.50/$1.00 USD) - 2016/04/28 15:33:50 CET [2016/04/28 9:33:50 ET]
Table 'Zachia II' 9-max Seat #2 is the button
Seat 1: greyman571 ($186.63 in chips) 
Seat 2: sanpidk ($141.01 in chips) 
Seat 3: matiko09 ($100 in chips) 
Seat 4: omorfadramou ($106.65 in chips) 
Seat 5: vrnMike ($100 in chips) 
Seat 6: koksskrt ($107.04 in chips) 
Seat 7: ozone2003 ($100 in chips) 
Seat 8: CI58 ($113.05 in chips) 
Seat 9: Painkiller72 ($101.78 in chips) 
matiko09: posts small blind $0.50
omorfadramou: posts big blind $1
*** HOLE CARDS ***
Dealt to matiko09 [4d 8c]
vrnMike: folds 
koksskrt: folds 
ozone2003: folds 
CI58: folds 
Painkiller72: folds 
greyman571: folds 
sanpidk: folds 
matiko09: folds 
Uncalled bet ($0.50) returned to omorfadramou
omorfadramou collected $1 from pot
omorfadramou: doesn't show hand 
*** SUMMARY ***
Total pot $1 | Rake $0 
Seat 1: greyman571 folded before Flop (didn't bet)
Seat 2: sanpidk (button) folded before Flop (didn't bet)
Seat 3: matiko09 (small blind) folded before Flop
Seat 4: omorfadramou (big blind) collected ($1)
Seat 5: vrnMike folded before Flop (didn't bet)
Seat 6: koksskrt folded before Flop (didn't bet)
Seat 7: ozone2003 folded before Flop (didn't bet)
Seat 8: CI58 folded before Flop (didn't bet)
Seat 9: Painkiller72 folded before Flop (didn't bet)





PokerStars Hand #152560322112:  Hold'em No Limit ($1/$2 USD) - 2016/04/28 15:34:02 CET [2016/04/28 9:34:02 ET]
Table 'Sequoia II' 9-max Seat #8 is the button
Seat 1: ersevi6 ($160 in chips) 
Seat 2: gudridornot ($80.40 in chips) 
Seat 3: Teddygram902 ($251.41 in chips) 
Seat 4: wiseyoyo ($200 in chips) 
Seat 5: matiko09 ($200 in chips) 
Seat 6: YOU-MAD-BR0 ($330.05 in chips) 
Seat 7: libbyyww ($250.05 in chips) 
Seat 8: CI58 ($200 in chips) 
Seat 9: JustinRuth88 ($155.20 in chips) 
JustinRuth88: posts small blind $1
ersevi6: posts big blind $2
ersevi6: posts the ante $0.40
gudridornot: posts the ante $0.40
Teddygram902: posts the ante $0.40
wiseyoyo: posts the ante $0.40
matiko09: posts the ante $0.40
YOU-MAD-BR0: posts the ante $0.40
libbyyww: posts the ante $0.40
CI58: posts the ante $0.40
JustinRuth88: posts the ante $0.40
*** HOLE CARDS ***
Dealt to matiko09 [9d 2s]
gudridornot: folds 
Teddygram902: folds 
wiseyoyo: folds 
matiko09: folds 
YOU-MAD-BR0: folds 
libbyyww: folds 
CI58: folds 
JustinRuth88: folds 
Uncalled bet ($1) returned to ersevi6
ersevi6 collected $5.60 from pot
ersevi6: doesn't show hand 
*** SUMMARY ***
Total pot $5.60 | Rake $0 
Seat 1: ersevi6 (big blind) collected ($5.60)
Seat 2: gudridornot folded before Flop (didn't bet)
Seat 3: Teddygram902 folded before Flop (didn't bet)
Seat 4: wiseyoyo folded before Flop (didn't bet)
Seat 5: matiko09 folded before Flop (didn't bet)
Seat 6: YOU-MAD-BR0 folded before Flop (didn't bet)
Seat 7: libbyyww folded before Flop (didn't bet)
Seat 8: CI58 (button) folded before Flop (didn't bet)
Seat 9: JustinRuth88 (small blind) folded before Flop





PokerStars Hand #152560326901:  Hold'em No Limit (€0.50/€1.00 EUR) - 2016/04/28 15:34:09 CET [2016/04/28 9:34:09 ET]
Table 'Lumiere II' 9-max Seat #4 is the button
Seat 1: maxxmeister (€101.50 in chips) 
Seat 2: Racushniak (€107.90 in chips) 
Seat 4: ruslik_by (€50.70 in chips) 
Seat 5: Schmidy7 (€57.05 in chips) 
Seat 6: azzad2007 (€97 in chips) 
Seat 7: hammerwife (€105.18 in chips) 
Seat 8: sanpidk (€108.52 in chips) 
Seat 9: matiko09 (€102.50 in chips) 
Schmidy7: posts small blind €0.50
azzad2007: posts big blind €1
*** HOLE CARDS ***
Dealt to matiko09 [3s Kc]
hammerwife: folds 
sanpidk: folds 
matiko09: folds 
maxxmeister: folds 
Racushniak: raises €2 to €3
ruslik_by: folds 
Schmidy7: folds 
azzad2007: folds 
Uncalled bet (€2) returned to Racushniak
Racushniak collected €2.50 from pot
Racushniak: doesn't show hand 
*** SUMMARY ***
Total pot €2.50 | Rake €0 
Seat 1: maxxmeister folded before Flop (didn't bet)
Seat 2: Racushniak collected (€2.50)
Seat 4: ruslik_by (button) folded before Flop (didn't bet)
Seat 5: Schmidy7 (small blind) folded before Flop
Seat 6: azzad2007 (big blind) folded before Flop
Seat 7: hammerwife folded before Flop (didn't bet)
Seat 8: sanpidk folded before Flop (didn't bet)
Seat 9: matiko09 folded before Flop (didn't bet)





PokerStars Hand #152560328785:  Hold'em No Limit ($0.50/$1.00 USD) - 2016/04/28 15:34:13 CET [2016/04/28 9:34:13 ET]
Table 'Zachia II' 9-max Seat #3 is the button
Seat 1: greyman571 ($186.63 in chips) 
Seat 2: sanpidk ($141.01 in chips) 
Seat 3: matiko09 ($100 in chips) 
Seat 4: omorfadramou ($107.15 in chips) 
Seat 5: vrnMike ($100 in chips) 
Seat 6: koksskrt ($107.04 in chips) 
Seat 7: ozone2003 ($100 in chips) 
Seat 8: CI58 ($113.05 in chips) 
Seat 9: Painkiller72 ($101.78 in chips) 
omorfadramou: posts small blind $0.50
vrnMike: posts big blind $1
*** HOLE CARDS ***
Dealt to matiko09 [Kh 3s]
koksskrt: folds 
ozone2003: folds 
CI58: folds 
Painkiller72: folds 
greyman571: folds 
greyman571 leaves the table
sanpidk: folds 
matiko09: folds 
omorfadramou: folds 
Uncalled bet ($0.50) returned to vrnMike
vrnMike collected $1 from pot
*** SUMMARY ***
Total pot $1 | Rake $0 
Seat 1: greyman571 folded before Flop (didn't bet)
Seat 2: sanpidk folded before Flop (didn't bet)
Seat 3: matiko09 (button) folded before Flop (didn't bet)
Seat 4: omorfadramou (small blind) folded before Flop
Seat 5: vrnMike (big blind) collected ($1)
Seat 6: koksskrt folded before Flop (didn't bet)
Seat 7: ozone2003 folded before Flop (didn't bet)
Seat 8: CI58 folded before Flop (didn't bet)
Seat 9: Painkiller72 folded before Flop (didn't bet)





PokerStars Hand #152560349332:  Hold'em No Limit ($0.50/$1.00 USD) - 2016/04/28 15:34:46 CET [2016/04/28 9:34:46 ET]
Table 'Zachia II' 9-max Seat #4 is the button
Seat 2: sanpidk ($141.01 in chips) 
Seat 3: matiko09 ($100 in chips) 
Seat 4: omorfadramou ($106.65 in chips) 
Seat 5: vrnMike ($100.50 in chips) 
Seat 6: koksskrt ($107.04 in chips) 
Seat 7: ozone2003 ($100 in chips) 
Seat 8: CI58 ($113.05 in chips) 
Seat 9: Painkiller72 ($101.78 in chips) 
vrnMike: posts small blind $0.50
koksskrt: posts big blind $1
*** HOLE CARDS ***
Dealt to matiko09 [3d Ah]
ka100pka527 joins the table at seat #1 
ozone2003: folds 
CI58: raises $2 to $3
Painkiller72: folds 
sanpidk: calls $3
matiko09: folds 
omorfadramou: folds 
vrnMike: folds 
koksskrt: folds 
*** FLOP *** [4h 4s 2c]
CI58: checks 
sanpidk: checks 
*** TURN *** [4h 4s 2c] [Qc]
CI58: checks 
sanpidk: bets $5
CI58: folds 
Uncalled bet ($5) returned to sanpidk
sanpidk collected $7.12 from pot
sanpidk: doesn't show hand 
*** SUMMARY ***
Total pot $7.50 | Rake $0.38 
Board [4h 4s 2c Qc]
Seat 2: sanpidk collected ($7.12)
Seat 3: matiko09 folded before Flop (didn't bet)
Seat 4: omorfadramou (button) folded before Flop (didn't bet)
Seat 5: vrnMike (small blind) folded before Flop
Seat 6: koksskrt (big blind) folded before Flop
Seat 7: ozone2003 folded before Flop (didn't bet)
Seat 8: CI58 folded on the Turn
Seat 9: Painkiller72 folded before Flop (didn't bet)





PokerStars Hand #152560352156:  Hold'em No Limit ($1/$2 USD) - 2016/04/28 15:34:51 CET [2016/04/28 9:34:51 ET]
Table 'Sequoia II' 9-max Seat #9 is the button
Seat 1: ersevi6 ($164.20 in chips) 
Seat 2: gudridornot ($198.80 in chips) 
Seat 3: Teddygram902 ($251.01 in chips) 
Seat 4: wiseyoyo ($200 in chips) 
Seat 5: matiko09 ($200 in chips) 
Seat 6: YOU-MAD-BR0 ($329.65 in chips) 
Seat 7: libbyyww ($249.65 in chips) 
Seat 8: CI58 ($200 in chips) 
Seat 9: JustinRuth88 ($153.80 in chips) 
ersevi6: posts small blind $1
gudridornot: posts big blind $2
ersevi6: posts the ante $0.40
gudridornot: posts the ante $0.40
Teddygram902: posts the ante $0.40
wiseyoyo: posts the ante $0.40
matiko09: posts the ante $0.40
YOU-MAD-BR0: posts the ante $0.40
libbyyww: posts the ante $0.40
CI58: posts the ante $0.40
JustinRuth88: posts the ante $0.40
*** HOLE CARDS ***
Dealt to matiko09 [2c 9h]
Teddygram902: folds 
wiseyoyo: folds 
matiko09: folds 
YOU-MAD-BR0: folds 
libbyyww: raises $4 to $6
CI58: calls $6
JustinRuth88: calls $6
ersevi6: folds 
gudridornot: raises $26 to $32
libbyyww: folds 
CI58: folds 
JustinRuth88: folds 
Uncalled bet ($26) returned to gudridornot
gudridornot collected $28.60 from pot
gudridornot: doesn't show hand 
*** SUMMARY ***
Total pot $28.60 | Rake $0 
Seat 1: ersevi6 (small blind) folded before Flop
Seat 2: gudridornot (big blind) collected ($28.60)
Seat 3: Teddygram902 folded before Flop (didn't bet)
Seat 4: wiseyoyo folded before Flop (didn't bet)
Seat 5: matiko09 folded before Flop (didn't bet)
Seat 6: YOU-MAD-BR0 folded before Flop (didn't bet)
Seat 7: libbyyww folded before Flop
Seat 8: CI58 folded before Flop
Seat 9: JustinRuth88 (button) folded before Flop





PokerStars Hand #152560352283:  Hold'em No Limit ($0.50/$1.00 USD) - 2016/04/28 15:34:51 CET [2016/04/28 9:34:51 ET]
Table 'Erynia' 9-max Seat #6 is the button
Seat 1: I The King I ($100 in chips) 
Seat 2: matiko09 ($150.70 in chips) 
Seat 3: vilo1070 ($111.63 in chips) 
Seat 4: omorfadramou ($119.10 in chips) 
Seat 5: RMilPoker ($100 in chips) 
Seat 6: peevoajax ($100 in chips) 
Seat 7: vrnMike ($111.24 in chips) 
Seat 8: YourKicker78 ($90.59 in chips) 
Seat 9: ruslik_by ($40.11 in chips) 
vrnMike: posts small blind $0.50
YourKicker78: posts big blind $1
*** HOLE CARDS ***
Dealt to matiko09 [Kd Qs]
ruslik_by: folds 
I The King I: folds 
matiko09: raises $2 to $3
vilo1070: folds 
omorfadramou: folds 
RMilPoker: raises $6.50 to $9.50
peevoajax: folds 
vrnMike: folds 
YourKicker78: folds 
matiko09: raises $11.50 to $21
RMilPoker: folds 
Uncalled bet ($11.50) returned to matiko09
matiko09 collected $20.50 from pot
matiko09: doesn't show hand 
*** SUMMARY ***
Total pot $20.50 | Rake $0 
Seat 1: I The King I folded before Flop (didn't bet)
Seat 2: matiko09 collected ($20.50)
Seat 3: vilo1070 folded before Flop (didn't bet)
Seat 4: omorfadramou folded before Flop (didn't bet)
Seat 5: RMilPoker folded before Flop
Seat 6: peevoajax (button) folded before Flop (didn't bet)
Seat 7: vrnMike (small blind) folded before Flop
Seat 8: YourKicker78 (big blind) folded before Flop
Seat 9: ruslik_by folded before Flop (didn't bet)





PokerStars Hand #152560352717:  Hold'em No Limit ($0.50/$1.00 USD) - 2016/04/28 15:34:52 CET [2016/04/28 9:34:52 ET]
Table 'Agapenor III' 9-max Seat #2 is the button
Seat 1: I The King I ($147.02 in chips) 
Seat 2: cerbisor1 ($48.47 in chips) 
Seat 3: sanpidk ($143.63 in chips) 
Seat 4: matiko09 ($101.50 in chips) 
Seat 6: azzad2007 ($114.93 in chips) 
Seat 7: tylerz71 ($119.98 in chips) 
sanpidk: posts small blind $0.50
matiko09: posts big blind $1
maxxmeister: sits out 
*** HOLE CARDS ***
Dealt to matiko09 [5c Jc]
azzad2007: raises $2 to $3
DYO1000 leaves the table
Moszes360 joins the table at seat #9 
tylerz71: folds 
I The King I: folds 
Moszes360 leaves the table
cerbisor1: folds 
Glushchenko joins the table at seat #9 
sanpidk: folds 
matiko09: folds 
Uncalled bet ($2) returned to azzad2007
azzad2007 collected $2.50 from pot
azzad2007: doesn't show hand 
*** SUMMARY ***
Total pot $2.50 | Rake $0 
Seat 1: I The King I folded before Flop (didn't bet)
Seat 2: cerbisor1 (button) folded before Flop (didn't bet)
Seat 3: sanpidk (small blind) folded before Flop
Seat 4: matiko09 (big blind) folded before Flop
Seat 6: azzad2007 collected ($2.50)
Seat 7: tylerz71 folded before Flop (didn't bet)





PokerStars Hand #152560354873:  Hold'em No Limit ($0.50/$1.00 USD) - 2016/04/28 15:34:55 CET [2016/04/28 9:34:55 ET]
Table 'Musa II' 9-max Seat #3 is the button
Seat 1: matiko09 ($110.52 in chips) 
Seat 2: ozone2003 ($102.65 in chips) 
Seat 3: vrnMike ($100 in chips) 
Seat 4: ipashutapkom ($45.14 in chips) 
Seat 5: thecurv ($100 in chips) 
Seat 6: skolombi77 ($83.25 in chips) 
Seat 7: ka100pka527 ($71.50 in chips) 
Seat 8: darren1031 ($86.72 in chips) 
Seat 9: Moszes360 ($140.08 in chips) 
ipashutapkom: posts small blind $0.50
thecurv: posts big blind $1
*** HOLE CARDS ***
Dealt to matiko09 [4s 2c]
skolombi77: folds 
ka100pka527: folds 
darren1031: folds 
Moszes360: folds 
matiko09: folds 
ozone2003: folds 
vrnMike: folds 
ipashutapkom: folds 
Uncalled bet ($0.50) returned to thecurv
thecurv collected $1 from pot
thecurv: doesn't show hand 
*** SUMMARY ***
Total pot $1 | Rake $0 
Seat 1: matiko09 folded before Flop (didn't bet)
Seat 2: ozone2003 folded before Flop (didn't bet)
Seat 3: vrnMike (button) folded before Flop (didn't bet)
Seat 4: ipashutapkom (small blind) folded before Flop
Seat 5: thecurv (big blind) collected ($1)
Seat 6: skolombi77 folded before Flop (didn't bet)
Seat 7: ka100pka527 folded before Flop (didn't bet)
Seat 8: darren1031 folded before Flop (didn't bet)
Seat 9: Moszes360 folded before Flop (didn't bet)





PokerStars Hand #152560361383:  Hold'em No Limit ($0.50/$1.00 USD) - 2016/04/28 15:35:06 CET [2016/04/28 9:35:06 ET]
Table 'Bruwer' 9-max Seat #4 is the button
Seat 1: peevoajax ($100 in chips) 
Seat 2: ruslik_by ($40 in chips) 
Seat 3: koksskrt ($141.51 in chips) 
Seat 4: matiko09 ($133.04 in chips) 
Seat 5: Carloszhang ($118.66 in chips) 
Seat 6: I The King I ($107.52 in chips) 
Seat 7: R1aki ($220.66 in chips) 
Seat 8: ozone2003 ($123.45 in chips) 
Seat 9: Dantist1122 ($119.60 in chips) 
Carloszhang: posts small blind $0.50
I The King I: posts big blind $1
*** HOLE CARDS ***
Dealt to matiko09 [6d 4s]
R1aki: folds 
ozone2003: raises $2 to $3
Dantist1122: folds 
peevoajax: folds 
ruslik_by: folds 
koksskrt: folds 
matiko09: folds 
Carloszhang: calls $2.50
I The King I: folds 
*** FLOP *** [Td Jh 6c]
Carloszhang: bets $4
ozone2003: folds 
Uncalled bet ($4) returned to Carloszhang
Carloszhang collected $6.65 from pot
*** SUMMARY ***
Total pot $7 | Rake $0.35 
Board [Td Jh 6c]
Seat 1: peevoajax folded before Flop (didn't bet)
Seat 2: ruslik_by folded before Flop (didn't bet)
Seat 3: koksskrt folded before Flop (didn't bet)
Seat 4: matiko09 (button) folded before Flop (didn't bet)
Seat 5: Carloszhang (small blind) collected ($6.65)
Seat 6: I The King I (big blind) folded before Flop
Seat 7: R1aki folded before Flop (didn't bet)
Seat 8: ozone2003 folded on the Flop
Seat 9: Dantist1122 folded before Flop (didn't bet)





PokerStars Hand #152560362121:  Hold'em No Limit ($1/$2 USD) - 2016/04/28 15:35:07 CET [2016/04/28 9:35:07 ET]
Table 'Idomeneus II' 9-max Seat #2 is the button
Seat 1: 13Ghosts ($249.47 in chips) 
Seat 2: libbyyww ($410.61 in chips) 
Seat 3: adrenalin333 ($110.93 in chips) 
Seat 4: SoNe1988 ($89 in chips) 
Seat 5: matiko09 ($234.36 in chips) 
Seat 6: rmanjkeee ($98 in chips) 
Seat 7: ersevi6 ($225.03 in chips) 
Seat 8: di0d80 ($222.85 in chips) 
Seat 9: prominente ($200 in chips) 
adrenalin333: posts small blind $1
SoNe1988: posts big blind $2
*** HOLE CARDS ***
Dealt to matiko09 [Jc 4h]
matiko09: folds 
rmanjkeee: folds 
ersevi6: folds 
di0d80: folds 
prominente: folds 
13Ghosts: folds 
libbyyww: folds 
adrenalin333: calls $1
SoNe1988: raises $6 to $8
adrenalin333: calls $6
*** FLOP *** [Ad Qd Ah]
adrenalin333: checks 
SoNe1988: bets $7.88
adrenalin333: calls $7.88
*** TURN *** [Ad Qd Ah] [2c]
adrenalin333: bets $12
SoNe1988: folds 
Uncalled bet ($12) returned to adrenalin333
adrenalin333 collected $30.17 from pot
adrenalin333: doesn't show hand 
*** SUMMARY ***
Total pot $31.76 | Rake $1.59 
Board [Ad Qd Ah 2c]
Seat 1: 13Ghosts folded before Flop (didn't bet)
Seat 2: libbyyww (button) folded before Flop (didn't bet)
Seat 3: adrenalin333 (small blind) collected ($30.17)
Seat 4: SoNe1988 (big blind) folded on the Turn
Seat 5: matiko09 folded before Flop (didn't bet)
Seat 6: rmanjkeee folded before Flop (didn't bet)
Seat 7: ersevi6 folded before Flop (didn't bet)
Seat 8: di0d80 folded before Flop (didn't bet)
Seat 9: prominente folded before Flop (didn't bet)





PokerStars Hand #152560362125:  Hold'em No Limit (€0.50/€1.00 EUR) - 2016/04/28 15:35:07 CET [2016/04/28 9:35:07 ET]
Table 'Lumiere II' 9-max Seat #5 is the button
Seat 1: maxxmeister (€101.50 in chips) 
Seat 2: Racushniak (€109.40 in chips) 
Seat 4: ruslik_by (€50.70 in chips) 
Seat 5: Schmidy7 (€56.55 in chips) 
Seat 6: azzad2007 (€100 in chips) 
Seat 7: hammerwife (€105.18 in chips) 
Seat 8: sanpidk (€108.52 in chips) 
Seat 9: matiko09 (€102.50 in chips) 
azzad2007: posts small blind €0.50
hammerwife: posts big blind €1
*** HOLE CARDS ***
Dealt to matiko09 [7h Qc]
sanpidk: folds 
matiko09: folds 
maxxmeister: raises €2 to €3
Racushniak: folds 
ruslik_by: folds 
Schmidy7: folds 
azzad2007: folds 
hammerwife: calls €2
*** FLOP *** [Ad 4h 2s]
hammerwife: checks 
maxxmeister: checks 
*** TURN *** [Ad 4h 2s] [3h]
9lKBXKTT6 leaves the table
Ouga Buga joins the table at seat #3 
hammerwife: checks 
maxxmeister: bets €5
hammerwife: folds 
Uncalled bet (€5) returned to maxxmeister
maxxmeister collected €6.18 from pot
maxxmeister: doesn't show hand 
*** SUMMARY ***
Total pot €6.50 | Rake €0.32 
Board [Ad 4h 2s 3h]
Seat 1: maxxmeister collected (€6.18)
Seat 2: Racushniak folded before Flop (didn't bet)
Seat 4: ruslik_by folded before Flop (didn't bet)
Seat 5: Schmidy7 (button) folded before Flop (didn't bet)
Seat 6: azzad2007 (small blind) folded before Flop
Seat 7: hammerwife (big blind) folded on the Turn
Seat 8: sanpidk folded before Flop (didn't bet)
Seat 9: matiko09 folded before Flop (didn't bet)





PokerStars Hand #152560363764:  Hold'em No Limit ($0.50/$1.00 USD) - 2016/04/28 15:35:10 CET [2016/04/28 9:35:10 ET]
Table 'Halleria' 9-max Seat #7 is the button
Seat 2: R1aki ($109.04 in chips) 
Seat 3: maxxmeister ($109.08 in chips) 
Seat 4: ka100pka527 ($40 in chips) 
Seat 5: gcz_1886_1 ($109.95 in chips) 
Seat 7: I The King I ($207.50 in chips) 
Seat 8: sanpidk ($105.11 in chips) 
Seat 9: matiko09 ($100 in chips) 
sanpidk: posts small blind $0.50
matiko09: posts big blind $1
JediGaGa: sits out 
*** HOLE CARDS ***
Dealt to matiko09 [Ac Qh]
R1aki: folds 
cl.trind leaves the table
St.LaCoste joins the table at seat #6 
maxxmeister: folds 
St.LaCoste leaves the table
Glushchenko joins the table at seat #6 
ka100pka527: raises $2 to $3
gcz_1886_1: folds 
Glushchenko leaves the table
I The King I: folds 
Dantist1122 joins the table at seat #6 
sanpidk: folds 
matiko09: calls $2
*** FLOP *** [Jh 4c 3h]
matiko09: checks 
ka100pka527: bets $4.11
matiko09: folds 
Uncalled bet ($4.11) returned to ka100pka527
ka100pka527 collected $6.18 from pot
ka100pka527: doesn't show hand 
*** SUMMARY ***
Total pot $6.50 | Rake $0.32 
Board [Jh 4c 3h]
Seat 2: R1aki folded before Flop (didn't bet)
Seat 3: maxxmeister folded before Flop (didn't bet)
Seat 4: ka100pka527 collected ($6.18)
Seat 5: gcz_1886_1 folded before Flop (didn't bet)
Seat 7: I The King I (button) folded before Flop (didn't bet)
Seat 8: sanpidk (small blind) folded before Flop
Seat 9: matiko09 (big blind) folded on the Flop





PokerStars Hand #152560380168:  Hold'em No Limit ($0.50/$1.00 USD) - 2016/04/28 15:35:37 CET [2016/04/28 9:35:37 ET]
Table 'Musa II' 9-max Seat #4 is the button
Seat 1: matiko09 ($110.52 in chips) 
Seat 2: ozone2003 ($102.65 in chips) 
Seat 3: vrnMike ($100 in chips) 
Seat 4: ipashutapkom ($44.64 in chips) 
Seat 5: thecurv ($100.50 in chips) 
Seat 6: skolombi77 ($83.25 in chips) 
Seat 7: ka100pka527 ($71.50 in chips) 
Seat 8: darren1031 ($86.72 in chips) 
Seat 9: Moszes360 ($140.08 in chips) 
thecurv: posts small blind $0.50
skolombi77: posts big blind $1
*** HOLE CARDS ***
Dealt to matiko09 [Tc 9h]
ka100pka527: folds 
darren1031: folds 
Moszes360: folds 
matiko09: folds 
ozone2003: folds 
vrnMike: folds 
ipashutapkom: folds 
thecurv: raises $1 to $2
skolombi77: calls $1
*** FLOP *** [3s 8c 5s]
thecurv: checks 
skolombi77: checks 
*** TURN *** [3s 8c 5s] [Ah]
thecurv: bets $2.85
skolombi77: folds 
Uncalled bet ($2.85) returned to thecurv
thecurv collected $3.80 from pot
thecurv: doesn't show hand 
*** SUMMARY ***
Total pot $4 | Rake $0.20 
Board [3s 8c 5s Ah]
Seat 1: matiko09 folded before Flop (didn't bet)
Seat 2: ozone2003 folded before Flop (didn't bet)
Seat 3: vrnMike folded before Flop (didn't bet)
Seat 4: ipashutapkom (button) folded before Flop (didn't bet)
Seat 5: thecurv (small blind) collected ($3.80)
Seat 6: skolombi77 (big blind) folded on the Turn
Seat 7: ka100pka527 folded before Flop (didn't bet)
Seat 8: darren1031 folded before Flop (didn't bet)
Seat 9: Moszes360 folded before Flop (didn't bet)





PokerStars Hand #152560395597:  Hold'em No Limit ($0.50/$1.00 USD) - 2016/04/28 15:35:49 CET [2016/04/28 9:35:49 ET]
Table 'Agapenor III' 9-max Seat #3 is the button
Seat 1: I The King I ($147.02 in chips) 
Seat 2: cerbisor1 ($48.47 in chips) 
Seat 3: sanpidk ($143.13 in chips) 
Seat 4: matiko09 ($100.50 in chips) 
Seat 5: maxxmeister ($100 in chips) 
Seat 6: azzad2007 ($116.43 in chips) 
Seat 7: tylerz71 ($119.98 in chips) 
matiko09: posts small blind $0.50
maxxmeister: posts big blind $1
Glushchenko: sits out 
*** HOLE CARDS ***
Dealt to matiko09 [4h Ac]
azzad2007: folds 
tylerz71: folds 
I The King I: folds 
cerbisor1: raises $1 to $2
sanpidk: folds 
matiko09: folds 
maxxmeister: folds 
Uncalled bet ($1) returned to cerbisor1
cerbisor1 collected $2.50 from pot
cerbisor1: doesn't show hand 
*** SUMMARY ***
Total pot $2.50 | Rake $0 
Seat 1: I The King I folded before Flop (didn't bet)
Seat 2: cerbisor1 collected ($2.50)
Seat 3: sanpidk (button) folded before Flop (didn't bet)
Seat 4: matiko09 (small blind) folded before Flop
Seat 5: maxxmeister (big blind) folded before Flop
Seat 6: azzad2007 folded before Flop (didn't bet)
Seat 7: tylerz71 folded before Flop (didn't bet)





PokerStars Hand #152560398984:  Hold'em No Limit ($0.50/$1.00 USD) - 2016/04/28 15:35:55 CET [2016/04/28 9:35:55 ET]
Table 'Erynia' 9-max Seat #7 is the button
Seat 1: I The King I ($100 in chips) 
Seat 2: matiko09 ($161.70 in chips) 
Seat 3: vilo1070 ($111.63 in chips) 
Seat 4: omorfadramou ($119.10 in chips) 
Seat 5: RMilPoker ($90.50 in chips) 
Seat 6: peevoajax ($100 in chips) 
Seat 7: vrnMike ($110.74 in chips) 
Seat 8: YourKicker78 ($89.59 in chips) 
Seat 9: ruslik_by ($40.11 in chips) 
YourKicker78: posts small blind $0.50
ruslik_by: posts big blind $1
*** HOLE CARDS ***
Dealt to matiko09 [3h 4s]
I The King I: folds 
matiko09: folds 
vilo1070: folds 
omorfadramou: folds 
RMilPoker: folds 
peevoajax: folds 
vrnMike: folds 
YourKicker78: raises $2 to $3
ruslik_by: calls $2
*** FLOP *** [Qs 6h As]
YourKicker78: bets $4
ruslik_by: folds 
Uncalled bet ($4) returned to YourKicker78
YourKicker78 collected $5.70 from pot
YourKicker78: doesn't show hand 
*** SUMMARY ***
Total pot $6 | Rake $0.30 
Board [Qs 6h As]
Seat 1: I The King I folded before Flop (didn't bet)
Seat 2: matiko09 folded before Flop (didn't bet)
Seat 3: vilo1070 folded before Flop (didn't bet)
Seat 4: omorfadramou folded before Flop (didn't bet)
Seat 5: RMilPoker folded before Flop (didn't bet)
Seat 6: peevoajax folded before Flop (didn't bet)
Seat 7: vrnMike (button) folded before Flop (didn't bet)
Seat 8: YourKicker78 (small blind) collected ($5.70)
Seat 9: ruslik_by (big blind) folded on the Flop





PokerStars Hand #152560400237:  Hold'em No Limit ($0.50/$1.00 USD) - 2016/04/28 15:35:57 CET [2016/04/28 9:35:57 ET]
Table 'Halleria' 9-max Seat #8 is the button
Seat 1: JediGaGa ($100 in chips) 
Seat 2: R1aki ($109.04 in chips) 
Seat 3: maxxmeister ($109.08 in chips) 
Seat 4: ka100pka527 ($43.18 in chips) 
Seat 5: gcz_1886_1 ($109.95 in chips) 
Seat 7: I The King I ($207.50 in chips) 
Seat 8: sanpidk ($104.61 in chips) 
Seat 9: matiko09 ($100 in chips) 
matiko09: posts small blind $0.50
JediGaGa: posts big blind $1
Dantist1122: sits out 
*** HOLE CARDS ***
Dealt to matiko09 [Th 2d]
R1aki: folds 
R1aki leaves the table
maxxmeister: folds 
ka100pka527: raises $2 to $3
gcz_1886_1: folds 
I The King I: folds 
sanpidk: folds 
matiko09: folds 
JediGaGa: folds 
Uncalled bet ($2) returned to ka100pka527
ka100pka527 collected $2.50 from pot
ka100pka527: doesn't show hand 
*** SUMMARY ***
Total pot $2.50 | Rake $0 
Seat 1: JediGaGa (big blind) folded before Flop
Seat 2: R1aki folded before Flop (didn't bet)
Seat 3: maxxmeister folded before Flop (didn't bet)
Seat 4: ka100pka527 collected ($2.50)
Seat 5: gcz_1886_1 folded before Flop (didn't bet)
Seat 7: I The King I folded before Flop (didn't bet)
Seat 8: sanpidk (button) folded before Flop (didn't bet)
Seat 9: matiko09 (small blind) folded before Flop





PokerStars Hand #152560404861:  Hold'em No Limit ($0.50/$1.00 USD) - 2016/04/28 15:36:05 CET [2016/04/28 9:36:05 ET]
Table 'Bruwer' 9-max Seat #5 is the button
Seat 1: peevoajax ($100 in chips) 
Seat 2: ruslik_by ($40 in chips) 
Seat 3: koksskrt ($141.51 in chips) 
Seat 4: matiko09 ($133.04 in chips) 
Seat 5: Carloszhang ($122.31 in chips) 
Seat 6: I The King I ($106.52 in chips) 
Seat 7: R1aki ($220.66 in chips) 
Seat 8: ozone2003 ($120.45 in chips) 
Seat 9: Dantist1122 ($119.60 in chips) 
I The King I: posts small blind $0.50
R1aki: posts big blind $1
*** HOLE CARDS ***
Dealt to matiko09 [3h 7h]
ozone2003: folds 
Dantist1122: raises $2 to $3
peevoajax: folds 
ruslik_by: folds 
koksskrt: folds 
matiko09: folds 
Carloszhang: folds 
I The King I: folds 
R1aki: folds 
Uncalled bet ($2) returned to Dantist1122
Dantist1122 collected $2.50 from pot
Dantist1122: doesn't show hand 
*** SUMMARY ***
Total pot $2.50 | Rake $0 
Seat 1: peevoajax folded before Flop (didn't bet)
Seat 2: ruslik_by folded before Flop (didn't bet)
Seat 3: koksskrt folded before Flop (didn't bet)
Seat 4: matiko09 folded before Flop (didn't bet)
Seat 5: Carloszhang (button) folded before Flop (didn't bet)
Seat 6: I The King I (small blind) folded before Flop
Seat 7: R1aki (big blind) folded before Flop
Seat 8: ozone2003 folded before Flop (didn't bet)
Seat 9: Dantist1122 collected ($2.50)





PokerStars Hand #152560408747:  Hold'em No Limit ($1/$2 USD) - 2016/04/28 15:36:11 CET [2016/04/28 9:36:11 ET]
Table 'Idomeneus II' 9-max Seat #3 is the button
Seat 1: 13Ghosts ($249.47 in chips) 
Seat 2: libbyyww ($410.61 in chips) 
Seat 3: adrenalin333 ($125.22 in chips) 
Seat 4: SoNe1988 ($80 in chips) 
Seat 5: matiko09 ($234.36 in chips) 
Seat 6: rmanjkeee ($98 in chips) 
Seat 7: ersevi6 ($225.03 in chips) 
Seat 8: di0d80 ($222.85 in chips) 
Seat 9: prominente ($200 in chips) 
SoNe1988: posts small blind $1
matiko09: posts big blind $2
*** HOLE CARDS ***
Dealt to matiko09 [Qd 2d]
rmanjkeee: folds 
ersevi6: folds 
di0d80: folds 
prominente: folds 
13Ghosts: folds 
libbyyww: folds 
adrenalin333: raises $2 to $4
SoNe1988: folds 
matiko09: folds 
Uncalled bet ($2) returned to adrenalin333
adrenalin333 collected $5 from pot
adrenalin333: doesn't show hand 
*** SUMMARY ***
Total pot $5 | Rake $0 
Seat 1: 13Ghosts folded before Flop (didn't bet)
Seat 2: libbyyww folded before Flop (didn't bet)
Seat 3: adrenalin333 (button) collected ($5)
Seat 4: SoNe1988 (small blind) folded before Flop
Seat 5: matiko09 (big blind) folded before Flop
Seat 6: rmanjkeee folded before Flop (didn't bet)
Seat 7: ersevi6 folded before Flop (didn't bet)
Seat 8: di0d80 folded before Flop (didn't bet)
Seat 9: prominente folded before Flop (didn't bet)





PokerStars Hand #152560414057:  Hold'em No Limit ($0.50/$1.00 USD) - 2016/04/28 15:36:20 CET [2016/04/28 9:36:20 ET]
Table 'Zachia II' 9-max Seat #5 is the button
Seat 2: sanpidk ($145.13 in chips) 
Seat 3: matiko09 ($100 in chips) 
Seat 4: omorfadramou ($106.65 in chips) 
Seat 5: vrnMike ($100 in chips) 
Seat 6: koksskrt ($106.04 in chips) 
Seat 7: ozone2003 ($100 in chips) 
Seat 8: CI58 ($110.05 in chips) 
Seat 9: Painkiller72 ($101.78 in chips) 
koksskrt: posts small blind $0.50
ozone2003: posts big blind $1
ka100pka527: sits out 
*** HOLE CARDS ***
Dealt to matiko09 [9s 4c]
CI58: folds 
Painkiller72: folds 
sanpidk: folds 
matiko09: folds 
omorfadramou: folds 
vrnMike: raises $2 to $3
koksskrt: folds 
ozone2003: folds 
Uncalled bet ($2) returned to vrnMike
vrnMike collected $2.50 from pot
*** SUMMARY ***
Total pot $2.50 | Rake $0 
Seat 2: sanpidk folded before Flop (didn't bet)
Seat 3: matiko09 folded before Flop (didn't bet)
Seat 4: omorfadramou folded before Flop (didn't bet)
Seat 5: vrnMike (button) collected ($2.50)
Seat 6: koksskrt (small blind) folded before Flop
Seat 7: ozone2003 (big blind) folded before Flop
Seat 8: CI58 folded before Flop (didn't bet)
Seat 9: Painkiller72 folded before Flop (didn't bet)





PokerStars Hand #152560415332:  Hold'em No Limit ($1/$2 USD) - 2016/04/28 15:36:22 CET [2016/04/28 9:36:22 ET]
Table 'Sequoia II' 9-max Seat #1 is the button
Seat 1: ersevi6 ($162.80 in chips) 
Seat 2: gudridornot ($221 in chips) 
Seat 3: Teddygram902 ($250.61 in chips) 
Seat 4: wiseyoyo ($200 in chips) 
Seat 5: matiko09 ($200 in chips) 
Seat 6: YOU-MAD-BR0 ($329.25 in chips) 
Seat 7: libbyyww ($243.25 in chips) 
Seat 8: CI58 ($200 in chips) 
Seat 9: JustinRuth88 ($147.40 in chips) 
gudridornot: posts small blind $1
Teddygram902: posts big blind $2
ersevi6: posts the ante $0.40
gudridornot: posts the ante $0.40
Teddygram902: posts the ante $0.40
wiseyoyo: posts the ante $0.40
matiko09: posts the ante $0.40
YOU-MAD-BR0: posts the ante $0.40
libbyyww: posts the ante $0.40
CI58: posts the ante $0.40
JustinRuth88: posts the ante $0.40
*** HOLE CARDS ***
Dealt to matiko09 [Jd 4h]
wiseyoyo: folds 
matiko09: folds 
YOU-MAD-BR0: folds 
libbyyww: folds 
CI58: folds 
JustinRuth88: folds 
ersevi6: raises $4 to $6
gudridornot: raises $30 to $36
Teddygram902: folds 
ersevi6: folds 
Uncalled bet ($30) returned to gudridornot
gudridornot collected $17.60 from pot
gudridornot: doesn't show hand 
*** SUMMARY ***
Total pot $17.60 | Rake $0 
Seat 1: ersevi6 (button) folded before Flop
Seat 2: gudridornot (small blind) collected ($17.60)
Seat 3: Teddygram902 (big blind) folded before Flop
Seat 4: wiseyoyo folded before Flop (didn't bet)
Seat 5: matiko09 folded before Flop (didn't bet)
Seat 6: YOU-MAD-BR0 folded before Flop (didn't bet)
Seat 7: libbyyww folded before Flop (didn't bet)
Seat 8: CI58 folded before Flop (didn't bet)
Seat 9: JustinRuth88 folded before Flop (didn't bet)





PokerStars Hand #152560418073:  Hold'em No Limit ($0.50/$1.00 USD) - 2016/04/28 15:36:27 CET [2016/04/28 9:36:27 ET]
Table 'Agapenor III' 9-max Seat #4 is the button
Seat 1: I The King I ($147.02 in chips) 
Seat 2: cerbisor1 ($49.97 in chips) 
Seat 3: sanpidk ($143.13 in chips) 
Seat 4: matiko09 ($100 in chips) 
Seat 5: maxxmeister ($100 in chips) 
Seat 6: azzad2007 ($116.43 in chips) 
Seat 7: tylerz71 ($119.98 in chips) 
Seat 8: Ceanucs ($52.41 in chips) 
maxxmeister: posts small blind $0.50
azzad2007: posts big blind $1
Glushchenko: sits out 
*** HOLE CARDS ***
Dealt to matiko09 [Qc Jh]
tylerz71: folds 
Ceanucs: folds 
I The King I: folds 
cerbisor1: folds 
sanpidk: folds 
matiko09: raises $1.27 to $2.27
maxxmeister: raises $5.67 to $7.94
azzad2007: folds 
matiko09: folds 
Uncalled bet ($5.67) returned to maxxmeister
maxxmeister collected $5.54 from pot
maxxmeister: doesn't show hand 
*** SUMMARY ***
Total pot $5.54 | Rake $0 
Seat 1: I The King I folded before Flop (didn't bet)
Seat 2: cerbisor1 folded before Flop (didn't bet)
Seat 3: sanpidk folded before Flop (didn't bet)
Seat 4: matiko09 (button) folded before Flop
Seat 5: maxxmeister (small blind) collected ($5.54)
Seat 6: azzad2007 (big blind) folded before Flop
Seat 7: tylerz71 folded before Flop (didn't bet)
Seat 8: Ceanucs folded before Flop (didn't bet)





PokerStars Hand #152560422643:  Hold'em No Limit ($0.50/$1.00 USD) - 2016/04/28 15:36:34 CET [2016/04/28 9:36:34 ET]
Table 'Erynia' 9-max Seat #8 is the button
Seat 1: I The King I ($100 in chips) 
Seat 2: matiko09 ($161.70 in chips) 
Seat 3: vilo1070 ($111.63 in chips) 
Seat 4: omorfadramou ($119.10 in chips) 
Seat 5: RMilPoker ($90.50 in chips) 
Seat 6: peevoajax ($100 in chips) 
Seat 7: vrnMike ($110.74 in chips) 
Seat 8: YourKicker78 ($92.29 in chips) 
Seat 9: ruslik_by ($40 in chips) 
ruslik_by: posts small blind $0.50
I The King I: posts big blind $1
*** HOLE CARDS ***
Dealt to matiko09 [Js Th]
matiko09: folds 
vilo1070: folds 
omorfadramou: folds 
RMilPoker: folds 
peevoajax: folds 
vrnMike: folds 
YourKicker78: raises $2 to $3
ruslik_by: folds 
I The King I: folds 
Uncalled bet ($2) returned to YourKicker78
YourKicker78 collected $2.50 from pot
YourKicker78: doesn't show hand 
*** SUMMARY ***
Total pot $2.50 | Rake $0 
Seat 1: I The King I (big blind) folded before Flop
Seat 2: matiko09 folded before Flop (didn't bet)
Seat 3: vilo1070 folded before Flop (didn't bet)
Seat 4: omorfadramou folded before Flop (didn't bet)
Seat 5: RMilPoker folded before Flop (didn't bet)
Seat 6: peevoajax folded before Flop (didn't bet)
Seat 7: vrnMike folded before Flop (didn't bet)
Seat 8: YourKicker78 (button) collected ($2.50)
Seat 9: ruslik_by (small blind) folded before Flop





PokerStars Hand #152560422949:  Hold'em No Limit ($0.50/$1.00 USD) - 2016/04/28 15:36:34 CET [2016/04/28 9:36:34 ET]
Table 'Musa II' 9-max Seat #5 is the button
Seat 1: matiko09 ($110.52 in chips) 
Seat 2: ozone2003 ($102.65 in chips) 
Seat 3: vrnMike ($100 in chips) 
Seat 4: ipashutapkom ($44.64 in chips) 
Seat 5: thecurv ($102.30 in chips) 
Seat 6: skolombi77 ($81.25 in chips) 
Seat 7: ka100pka527 ($71.50 in chips) 
Seat 8: darren1031 ($86.72 in chips) 
Seat 9: Moszes360 ($140.08 in chips) 
skolombi77: posts small blind $0.50
ka100pka527: posts big blind $1
*** HOLE CARDS ***
Dealt to matiko09 [5s 7h]
darren1031: folds 
Moszes360: folds 
matiko09: folds 
ozone2003: raises $2 to $3
vrnMike: folds 
ipashutapkom: raises $5 to $8
thecurv: folds 
skolombi77: folds 
ka100pka527: folds 
ozone2003: folds 
Uncalled bet ($5) returned to ipashutapkom
ipashutapkom collected $7.50 from pot
ipashutapkom: doesn't show hand 
*** SUMMARY ***
Total pot $7.50 | Rake $0 
Seat 1: matiko09 folded before Flop (didn't bet)
Seat 2: ozone2003 folded before Flop
Seat 3: vrnMike folded before Flop (didn't bet)
Seat 4: ipashutapkom collected ($7.50)
Seat 5: thecurv (button) folded before Flop (didn't bet)
Seat 6: skolombi77 (small blind) folded before Flop
Seat 7: ka100pka527 (big blind) folded before Flop
Seat 8: darren1031 folded before Flop (didn't bet)
Seat 9: Moszes360 folded before Flop (didn't bet)





PokerStars Hand #152560428737:  Hold'em No Limit ($0.50/$1.00 USD) - 2016/04/28 15:36:44 CET [2016/04/28 9:36:44 ET]
Table 'Bruwer' 9-max Seat #6 is the button
Seat 1: peevoajax ($100 in chips) 
Seat 2: ruslik_by ($40 in chips) 
Seat 3: koksskrt ($141.51 in chips) 
Seat 4: matiko09 ($133.04 in chips) 
Seat 5: Carloszhang ($122.31 in chips) 
Seat 6: I The King I ($106.02 in chips) 
Seat 7: R1aki ($219.66 in chips) 
Seat 8: ozone2003 ($120.45 in chips) 
Seat 9: Dantist1122 ($121.10 in chips) 
R1aki: posts small blind $0.50
ozone2003: posts big blind $1
*** HOLE CARDS ***
Dealt to matiko09 [3h 2c]
Dantist1122: folds 
peevoajax: folds 
ruslik_by: folds 
koksskrt: folds 
matiko09: folds 
Carloszhang: raises $1 to $2
I The King I: calls $2
R1aki: folds 
ozone2003: calls $1
*** FLOP *** [5c Kh 4c]
ozone2003: checks 
Carloszhang: bets $4
I The King I: calls $4
ozone2003: calls $4
*** TURN *** [5c Kh 4c] [Jc]
ozone2003: checks 
Carloszhang: bets $10
I The King I: folds 
ozone2003: raises $24 to $34
Carloszhang: folds 
Uncalled bet ($24) returned to ozone2003
ozone2003 collected $36.58 from pot
ozone2003: doesn't show hand 
*** SUMMARY ***
Total pot $38.50 | Rake $1.92 
Board [5c Kh 4c Jc]
Seat 1: peevoajax folded before Flop (didn't bet)
Seat 2: ruslik_by folded before Flop (didn't bet)
Seat 3: koksskrt folded before Flop (didn't bet)
Seat 4: matiko09 folded before Flop (didn't bet)
Seat 5: Carloszhang folded on the Turn
Seat 6: I The King I (button) folded on the Turn
Seat 7: R1aki (small blind) folded before Flop
Seat 8: ozone2003 (big blind) collected ($36.58)
Seat 9: Dantist1122 folded before Flop (didn't bet)





PokerStars Hand #152560429001:  Hold'em No Limit ($0.50/$1.00 USD) - 2016/04/28 15:36:44 CET [2016/04/28 9:36:44 ET]
Table 'Halleria' 9-max Seat #9 is the button
Seat 1: JediGaGa ($99 in chips) 
Seat 4: ka100pka527 ($44.68 in chips) 
Seat 5: gcz_1886_1 ($109.95 in chips) 
Seat 7: I The King I ($207.50 in chips) 
Seat 8: sanpidk ($104.61 in chips) 
Seat 9: matiko09 ($100 in chips) 
JediGaGa: posts small blind $0.50
maxxmeister: is sitting out 
ka100pka527: posts big blind $1
Dantist1122: sits out 
*** HOLE CARDS ***
Dealt to matiko09 [9h 4s]
gcz_1886_1: folds 
I The King I: folds 
sanpidk: folds 
matiko09: folds 
9lKBXKTT6 joins the table at seat #2 
JediGaGa: raises $1.05 to $2.05
maxxmeister leaves the table
ka100pka527: calls $1.05
*** FLOP *** [Jh 2s 7h]
koksskrt joins the table at seat #3 
JediGaGa: bets $2.92
ka100pka527: calls $2.92
*** TURN *** [Jh 2s 7h] [Ac]
9lKBXKTT6 leaves the table
JediGaGa: checks 
di0d80 joins the table at seat #2 
di0d80 leaves the table
ka100pka527: checks 
*** RIVER *** [Jh 2s 7h Ac] [6h]
JediGaGa: bets $6
ka100pka527: folds 
Uncalled bet ($6) returned to JediGaGa
JediGaGa collected $9.44 from pot
*** SUMMARY ***
Total pot $9.94 | Rake $0.50 
Board [Jh 2s 7h Ac 6h]
Seat 1: JediGaGa (small blind) collected ($9.44)
Seat 4: ka100pka527 (big blind) folded on the River
Seat 5: gcz_1886_1 folded before Flop (didn't bet)
Seat 7: I The King I folded before Flop (didn't bet)
Seat 8: sanpidk folded before Flop (didn't bet)
Seat 9: matiko09 (button) folded before Flop (didn't bet)





PokerStars Hand #152560429515:  Hold'em No Limit ($1/$2 USD) - 2016/04/28 15:36:45 CET [2016/04/28 9:36:45 ET]
Table 'Idomeneus II' 9-max Seat #4 is the button
Seat 1: 13Ghosts ($249.47 in chips) 
Seat 2: libbyyww ($410.61 in chips) 
Seat 3: adrenalin333 ($128.22 in chips) 
Seat 4: SoNe1988 ($80 in chips) 
Seat 5: matiko09 ($232.36 in chips) 
Seat 7: ersevi6 ($225.03 in chips) 
Seat 8: di0d80 ($222.85 in chips) 
Seat 9: prominente ($200 in chips) 
matiko09: posts small blind $1
rmanjkeee: is sitting out 
ersevi6: posts big blind $2
*** HOLE CARDS ***
Dealt to matiko09 [Qc 9h]
rmanjkeee leaves the table
peevoajax joins the table at seat #6 
di0d80: raises $3 to $5
prominente: folds 
13Ghosts: folds 
libbyyww: folds 
adrenalin333: calls $5
SoNe1988: folds 
matiko09: folds 
ersevi6: folds 
*** FLOP *** [Js Kc 9s]
di0d80: checks 
adrenalin333: checks 
*** TURN *** [Js Kc 9s] [2c]
di0d80: checks 
adrenalin333: checks 
*** RIVER *** [Js Kc 9s 2c] [5s]
di0d80: checks 
adrenalin333: checks 
*** SHOW DOWN ***
di0d80: shows [4d Ad] (high card Ace)
adrenalin333: shows [5c 4c] (a pair of Fives)
adrenalin333 collected $12.35 from pot
*** SUMMARY ***
Total pot $13 | Rake $0.65 
Board [Js Kc 9s 2c 5s]
Seat 1: 13Ghosts folded before Flop (didn't bet)
Seat 2: libbyyww folded before Flop (didn't bet)
Seat 3: adrenalin333 showed [5c 4c] and won ($12.35) with a pair of Fives
Seat 4: SoNe1988 (button) folded before Flop (didn't bet)
Seat 5: matiko09 (small blind) folded before Flop
Seat 7: ersevi6 (big blind) folded before Flop
Seat 8: di0d80 showed [4d Ad] and lost with high card Ace
Seat 9: prominente folded before Flop (didn't bet)





PokerStars Hand #152560435313:  Hold'em No Limit (€0.50/€1.00 EUR) - 2016/04/28 15:36:55 CET [2016/04/28 9:36:55 ET]
Table 'Lumiere II' 9-max Seat #6 is the button
Seat 1: maxxmeister (€104.68 in chips) 
Seat 2: Racushniak (€109.40 in chips) 
Seat 4: ruslik_by (€50.70 in chips) 
Seat 5: Schmidy7 (€56.55 in chips) 
Seat 6: azzad2007 (€99.50 in chips) 
Seat 7: hammerwife (€102.18 in chips) 
Seat 8: sanpidk (€108.52 in chips) 
Seat 9: matiko09 (€102.50 in chips) 
hammerwife: posts small blind €0.50
sanpidk: posts big blind €1
Ouga Buga: sits out 
*** HOLE CARDS ***
Dealt to matiko09 [4d 8d]
Ouga Buga leaves the table
Glushchenko joins the table at seat #3 
matiko09: folds 
maxxmeister: raises €2.50 to €3.50
Racushniak: folds 
Glushchenko leaves the table
ruslik_by: folds 
di0d80 joins the table at seat #3 
di0d80 leaves the table
Schmidy7: folds 
azzad2007: folds 
hammerwife: folds 
sanpidk: folds 
Uncalled bet (€2.50) returned to maxxmeister
maxxmeister collected €2.50 from pot
maxxmeister: doesn't show hand 
*** SUMMARY ***
Total pot €2.50 | Rake €0 
Seat 1: maxxmeister collected (€2.50)
Seat 2: Racushniak folded before Flop (didn't bet)
Seat 4: ruslik_by folded before Flop (didn't bet)
Seat 5: Schmidy7 folded before Flop (didn't bet)
Seat 6: azzad2007 (button) folded before Flop (didn't bet)
Seat 7: hammerwife (small blind) folded before Flop
Seat 8: sanpidk (big blind) folded before Flop
Seat 9: matiko09 folded before Flop (didn't bet)





PokerStars Hand #152560438168:  Hold'em No Limit ($0.50/$1.00 USD) - 2016/04/28 15:37:00 CET [2016/04/28 9:37:00 ET]
Table 'Zachia II' 9-max Seat #6 is the button
Seat 1: ka100pka527 ($40 in chips) 
Seat 2: sanpidk ($145.13 in chips) 
Seat 3: matiko09 ($100 in chips) 
Seat 4: omorfadramou ($106.65 in chips) 
Seat 5: vrnMike ($101.50 in chips) 
Seat 6: koksskrt ($105.54 in chips) 
Seat 7: ozone2003 ($100 in chips) 
ozone2003: posts small blind $0.50
CI58: is sitting out 
Painkiller72: is sitting out 
ka100pka527: posts big blind $1
*** HOLE CARDS ***
Dealt to matiko09 [6s 8d]
Painkiller72 leaves the table
sanpidk: folds 
CI58 leaves the table
matiko09: folds 
omorfadramou: folds 
vrnMike: folds 
koksskrt: raises $1 to $2
ozone2003: folds 
ka100pka527: raises $4.50 to $6.50
koksskrt: folds 
Uncalled bet ($4.50) returned to ka100pka527
ka100pka527 collected $4.50 from pot
ka100pka527: doesn't show hand 
*** SUMMARY ***
Total pot $4.50 | Rake $0 
Seat 1: ka100pka527 (big blind) collected ($4.50)
Seat 2: sanpidk folded before Flop (didn't bet)
Seat 3: matiko09 folded before Flop (didn't bet)
Seat 4: omorfadramou folded before Flop (didn't bet)
Seat 5: vrnMike folded before Flop (didn't bet)
Seat 6: koksskrt (button) folded before Flop
Seat 7: ozone2003 (small blind) folded before Flop





PokerStars Hand #152560447452:  Hold'em No Limit ($1/$2 USD) - 2016/04/28 15:37:15 CET [2016/04/28 9:37:15 ET]
Table 'Sequoia II' 9-max Seat #2 is the button
Seat 1: ersevi6 ($156.40 in chips) 
Seat 2: gudridornot ($232.20 in chips) 
Seat 3: Teddygram902 ($248.21 in chips) 
Seat 4: wiseyoyo ($200 in chips) 
Seat 5: matiko09 ($200 in chips) 
Seat 6: YOU-MAD-BR0 ($328.85 in chips) 
Seat 7: libbyyww ($242.85 in chips) 
Seat 8: CI58 ($200 in chips) 
Seat 9: JustinRuth88 ($147 in chips) 
Teddygram902: posts small blind $1
wiseyoyo: posts big blind $2
ersevi6: posts the ante $0.40
gudridornot: posts the ante $0.40
Teddygram902: posts the ante $0.40
wiseyoyo: posts the ante $0.40
matiko09: posts the ante $0.40
YOU-MAD-BR0: posts the ante $0.40
libbyyww: posts the ante $0.40
CI58: posts the ante $0.40
JustinRuth88: posts the ante $0.40
*** HOLE CARDS ***
Dealt to matiko09 [2h 5d]
matiko09: folds 
YOU-MAD-BR0: folds 
libbyyww: folds 
CI58: folds 
JustinRuth88: folds 
ersevi6: folds 
gudridornot: folds 
Teddygram902: raises $2 to $4
wiseyoyo: calls $2
*** FLOP *** [8s 6c 5h]
Teddygram902: bets $4
wiseyoyo: folds 
Uncalled bet ($4) returned to Teddygram902
Teddygram902 collected $11.02 from pot
*** SUMMARY ***
Total pot $11.60 | Rake $0.58 
Board [8s 6c 5h]
Seat 1: ersevi6 folded before Flop (didn't bet)
Seat 2: gudridornot (button) folded before Flop (didn't bet)
Seat 3: Teddygram902 (small blind) collected ($11.02)
Seat 4: wiseyoyo (big blind) folded on the Flop
Seat 5: matiko09 folded before Flop (didn't bet)
Seat 6: YOU-MAD-BR0 folded before Flop (didn't bet)
Seat 7: libbyyww folded before Flop (didn't bet)
Seat 8: CI58 folded before Flop (didn't bet)
Seat 9: JustinRuth88 folded before Flop (didn't bet)





PokerStars Hand #152560449093:  Hold'em No Limit ($0.50/$1.00 USD) - 2016/04/28 15:37:18 CET [2016/04/28 9:37:18 ET]
Table 'Agapenor III' 9-max Seat #5 is the button
Seat 1: I The King I ($147.02 in chips) 
Seat 2: cerbisor1 ($49.97 in chips) 
Seat 3: sanpidk ($143.13 in chips) 
Seat 4: matiko09 ($100 in chips) 
Seat 5: maxxmeister ($103.27 in chips) 
Seat 6: azzad2007 ($115.43 in chips) 
Seat 7: tylerz71 ($119.98 in chips) 
Seat 8: Ceanucs ($52.41 in chips) 
azzad2007: posts small blind $0.50
tylerz71: posts big blind $1
Glushchenko: sits out 
*** HOLE CARDS ***
Dealt to matiko09 [7h 4s]
Ceanucs: calls $1
I The King I: folds 
cerbisor1: folds 
sanpidk: folds 
matiko09: folds 
maxxmeister: folds 
azzad2007: raises $4 to $5
tylerz71: folds 
Ceanucs: calls $4
*** FLOP *** [2d 5h 8d]
azzad2007: bets $6.96
Ceanucs: calls $6.96
*** TURN *** [2d 5h 8d] [Kc]
azzad2007: bets $11.83
Ceanucs: folds 
Uncalled bet ($11.83) returned to azzad2007
azzad2007 collected $23.67 from pot
azzad2007: doesn't show hand 
*** SUMMARY ***
Total pot $24.92 | Rake $1.25 
Board [2d 5h 8d Kc]
Seat 1: I The King I folded before Flop (didn't bet)
Seat 2: cerbisor1 folded before Flop (didn't bet)
Seat 3: sanpidk folded before Flop (didn't bet)
Seat 4: matiko09 folded before Flop (didn't bet)
Seat 5: maxxmeister (button) folded before Flop (didn't bet)
Seat 6: azzad2007 (small blind) collected ($23.67)
Seat 7: tylerz71 (big blind) folded before Flop
Seat 8: Ceanucs folded on the Turn





PokerStars Hand #152560450611:  Hold'em No Limit ($0.50/$1.00 USD) - 2016/04/28 15:37:21 CET [2016/04/28 9:37:21 ET]
Table 'Erynia' 9-max Seat #9 is the button
Seat 1: I The King I ($100 in chips) 
Seat 2: matiko09 ($161.70 in chips) 
Seat 3: vilo1070 ($111.63 in chips) 
Seat 4: omorfadramou ($119.10 in chips) 
Seat 5: RMilPoker ($90.50 in chips) 
Seat 6: peevoajax ($100 in chips) 
Seat 7: vrnMike ($110.74 in chips) 
Seat 8: YourKicker78 ($93.79 in chips) 
Seat 9: ruslik_by ($40 in chips) 
I The King I: posts small blind $0.50
matiko09: posts big blind $1
*** HOLE CARDS ***
Dealt to matiko09 [7c Jd]
vilo1070: folds 
omorfadramou: raises $2 to $3
RMilPoker: folds 
peevoajax: folds 
vrnMike: folds 
YourKicker78: folds 
ruslik_by: folds 
I The King I: folds 
matiko09: folds 
Uncalled bet ($2) returned to omorfadramou
omorfadramou collected $2.50 from pot
omorfadramou: doesn't show hand 
*** SUMMARY ***
Total pot $2.50 | Rake $0 
Seat 1: I The King I (small blind) folded before Flop
Seat 2: matiko09 (big blind) folded before Flop
Seat 3: vilo1070 folded before Flop (didn't bet)
Seat 4: omorfadramou collected ($2.50)
Seat 5: RMilPoker folded before Flop (didn't bet)
Seat 6: peevoajax folded before Flop (didn't bet)
Seat 7: vrnMike folded before Flop (didn't bet)
Seat 8: YourKicker78 folded before Flop (didn't bet)
Seat 9: ruslik_by (button) folded before Flop (didn't bet)





PokerStars Hand #152560453077:  Hold'em No Limit ($0.50/$1.00 USD) - 2016/04/28 15:37:25 CET [2016/04/28 9:37:25 ET]
Table 'Musa II' 9-max Seat #6 is the button
Seat 1: matiko09 ($110.52 in chips) 
Seat 2: ozone2003 ($100 in chips) 
Seat 3: vrnMike ($100 in chips) 
Seat 4: ipashutapkom ($49.14 in chips) 
Seat 5: thecurv ($102.30 in chips) 
Seat 6: skolombi77 ($80.75 in chips) 
Seat 7: ka100pka527 ($70.50 in chips) 
Seat 8: darren1031 ($86.72 in chips) 
Seat 9: Moszes360 ($140.08 in chips) 
ka100pka527: posts small blind $0.50
darren1031: posts big blind $1
*** HOLE CARDS ***
Dealt to matiko09 [Qc 4c]
Moszes360: folds 
matiko09: folds 
ozone2003: folds 
vrnMike: folds 
ipashutapkom: folds 
thecurv: folds 
skolombi77: raises $1 to $2
ka100pka527: folds 
darren1031: folds 
Uncalled bet ($1) returned to skolombi77
skolombi77 collected $2.50 from pot
skolombi77: doesn't show hand 
*** SUMMARY ***
Total pot $2.50 | Rake $0 
Seat 1: matiko09 folded before Flop (didn't bet)
Seat 2: ozone2003 folded before Flop (didn't bet)
Seat 3: vrnMike folded before Flop (didn't bet)
Seat 4: ipashutapkom folded before Flop (didn't bet)
Seat 5: thecurv folded before Flop (didn't bet)
Seat 6: skolombi77 (button) collected ($2.50)
Seat 7: ka100pka527 (small blind) folded before Flop
Seat 8: darren1031 (big blind) folded before Flop
Seat 9: Moszes360 folded before Flop (didn't bet)





PokerStars Hand #152560467911:  Hold'em No Limit ($1/$2 USD) - 2016/04/28 15:37:49 CET [2016/04/28 9:37:49 ET]
Table 'Naos II' 9-max Seat #6 is the button
Seat 1: wiseyoyo ($233.79 in chips) 
Seat 2: peevoajax ($200 in chips) 
Seat 3: SoNe1988 ($88.42 in chips) 
Seat 4: Iggso ($229.25 in chips) 
Seat 6: I The King I ($208.50 in chips) 
Seat 8: libbyyww ($251.52 in chips) 
Seat 9: matiko09 ($200 in chips) 
libbyyww: posts small blind $1
matiko09: posts big blind $2
*** HOLE CARDS ***
Dealt to matiko09 [4d 7s]
wiseyoyo: folds 
wiseyoyo leaves the table
peevoajax: folds 
SoNe1988: folds 
Iggso: folds 
Ouga Buga joins the table at seat #1 
Ouga Buga leaves the table
I The King I: raises $2 to $4
libbyyww: folds 
matiko09: folds 
Uncalled bet ($2) returned to I The King I
I The King I collected $5 from pot
I The King I: doesn't show hand 
*** SUMMARY ***
Total pot $5 | Rake $0 
Seat 1: wiseyoyo folded before Flop (didn't bet)
Seat 2: peevoajax folded before Flop (didn't bet)
Seat 3: SoNe1988 folded before Flop (didn't bet)
Seat 4: Iggso folded before Flop (didn't bet)
Seat 6: I The King I (button) collected ($5)
Seat 8: libbyyww (small blind) folded before Flop
Seat 9: matiko09 (big blind) folded before Flop





PokerStars Hand #152560468186:  Hold'em No Limit (€0.50/€1.00 EUR) - 2016/04/28 15:37:49 CET [2016/04/28 9:37:49 ET]
Table 'Lumiere II' 9-max Seat #7 is the button
Seat 1: maxxmeister (€106.18 in chips) 
Seat 4: ruslik_by (€50.70 in chips) 
Seat 5: Schmidy7 (€56.55 in chips) 
Seat 6: azzad2007 (€99.50 in chips) 
Seat 7: hammerwife (€101.68 in chips) 
Seat 8: sanpidk (€107.52 in chips) 
Seat 9: matiko09 (€102.50 in chips) 
sanpidk: posts small blind €0.50
matiko09: posts big blind €1
*** HOLE CARDS ***
Dealt to matiko09 [4s Jh]
maxxmeister: raises €2 to €3
Racushniak leaves the table
ruslik_by: folds 
Schmidy7: folds 
azzad2007: calls €3
hammerwife: folds 
sanpidk: folds 
matiko09: folds 
*** FLOP *** [Td Qh 9c]
maxxmeister: checks 
azzad2007: checks 
*** TURN *** [Td Qh 9c] [Js]
maxxmeister: checks 
azzad2007: checks 
*** RIVER *** [Td Qh 9c Js] [4h]
maxxmeister: bets €4.69
azzad2007: folds 
Uncalled bet (€4.69) returned to maxxmeister
maxxmeister collected €7.12 from pot
maxxmeister: doesn't show hand 
*** SUMMARY ***
Total pot €7.50 | Rake €0.38 
Board [Td Qh 9c Js 4h]
Seat 1: maxxmeister collected (€7.12)
Seat 4: ruslik_by folded before Flop (didn't bet)
Seat 5: Schmidy7 folded before Flop (didn't bet)
Seat 6: azzad2007 folded on the River
Seat 7: hammerwife (button) folded before Flop (didn't bet)
Seat 8: sanpidk (small blind) folded before Flop
Seat 9: matiko09 (big blind) folded before Flop





PokerStars Hand #152560467646:  Hold'em No Limit ($1/$2 USD) - 2016/04/28 15:37:49 CET [2016/04/28 9:37:49 ET]
Table 'Sequoia II' 9-max Seat #3 is the button
Seat 1: ersevi6 ($156 in chips) 
Seat 2: gudridornot ($231.80 in chips) 
Seat 3: Teddygram902 ($254.83 in chips) 
Seat 4: wiseyoyo ($200 in chips) 
Seat 5: matiko09 ($200 in chips) 
Seat 6: YOU-MAD-BR0 ($328.45 in chips) 
Seat 7: libbyyww ($242.45 in chips) 
Seat 8: CI58 ($200 in chips) 
Seat 9: JustinRuth88 ($186.60 in chips) 
wiseyoyo: posts small blind $1
matiko09: posts big blind $2
ersevi6: posts the ante $0.40
gudridornot: posts the ante $0.40
Teddygram902: posts the ante $0.40
wiseyoyo: posts the ante $0.40
matiko09: posts the ante $0.40
YOU-MAD-BR0: posts the ante $0.40
libbyyww: posts the ante $0.40
CI58: posts the ante $0.40
JustinRuth88: posts the ante $0.40
*** HOLE CARDS ***
Dealt to matiko09 [3d 6c]
YOU-MAD-BR0: folds 
libbyyww: folds 
YOU-MAD-BR0 leaves the table
CI58: folds 
JustinRuth88: calls $2
Ouga Buga joins the table at seat #6 
ersevi6: raises $6 to $8
gudridornot: calls $8
Teddygram902: folds 
wiseyoyo: folds 
matiko09: folds 
JustinRuth88: calls $6
*** FLOP *** [Ks Th 5h]
JustinRuth88: checks 
ersevi6: checks 
gudridornot: checks 
*** TURN *** [Ks Th 5h] [Jd]
JustinRuth88: checks 
ersevi6: checks 
gudridornot: checks 
*** RIVER *** [Ks Th 5h Jd] [2s]
JustinRuth88: checks 
ersevi6: bets $15.40
gudridornot: folds 
JustinRuth88: folds 
Uncalled bet ($15.40) returned to ersevi6
ersevi6 collected $29.07 from pot
ersevi6: doesn't show hand 
*** SUMMARY ***
Total pot $30.60 | Rake $1.53 
Board [Ks Th 5h Jd 2s]
Seat 1: ersevi6 collected ($29.07)
Seat 2: gudridornot folded on the River
Seat 3: Teddygram902 (button) folded before Flop (didn't bet)
Seat 4: wiseyoyo (small blind) folded before Flop
Seat 5: matiko09 (big blind) folded before Flop
Seat 6: YOU-MAD-BR0 folded before Flop (didn't bet)
Seat 7: libbyyww folded before Flop (didn't bet)
Seat 8: CI58 folded before Flop (didn't bet)
Seat 9: JustinRuth88 folded on the River





PokerStars Hand #152560469447:  Hold'em No Limit ($0.50/$1.00 USD) - 2016/04/28 15:37:51 CET [2016/04/28 9:37:51 ET]
Table 'Halleria' 9-max Seat #1 is the button
Seat 1: JediGaGa ($103.47 in chips) 
Seat 4: ka100pka527 ($39.71 in chips) 
Seat 5: gcz_1886_1 ($109.95 in chips) 
Seat 7: I The King I ($207.50 in chips) 
Seat 8: sanpidk ($104.61 in chips) 
Seat 9: matiko09 ($100 in chips) 
koksskrt will be allowed to play after the button
ka100pka527: posts small blind $0.50
gcz_1886_1: posts big blind $1
Dantist1122: sits out 
*** HOLE CARDS ***
Dealt to matiko09 [6d 7d]
I The King I: folds 
sanpidk: folds 
matiko09: raises $1.50 to $2.50
JediGaGa: folds 
ka100pka527: raises $6 to $8.50
gcz_1886_1: folds 
matiko09: folds 
Uncalled bet ($6) returned to ka100pka527
ka100pka527 collected $6 from pot
ka100pka527: doesn't show hand 
*** SUMMARY ***
Total pot $6 | Rake $0 
Seat 1: JediGaGa (button) folded before Flop (didn't bet)
Seat 4: ka100pka527 (small blind) collected ($6)
Seat 5: gcz_1886_1 (big blind) folded before Flop
Seat 7: I The King I folded before Flop (didn't bet)
Seat 8: sanpidk folded before Flop (didn't bet)
Seat 9: matiko09 folded before Flop





PokerStars Hand #152560470836:  Hold'em No Limit ($1/$2 USD) - 2016/04/28 15:37:54 CET [2016/04/28 9:37:54 ET]
Table 'Idomeneus II' 9-max Seat #5 is the button
Seat 1: 13Ghosts ($249.47 in chips) 
Seat 2: libbyyww ($410.61 in chips) 
Seat 3: adrenalin333 ($135.57 in chips) 
Seat 4: SoNe1988 ($80 in chips) 
Seat 5: matiko09 ($231.36 in chips) 
Seat 7: ersevi6 ($223.03 in chips) 
Seat 8: di0d80 ($217.85 in chips) 
Seat 9: prominente ($200 in chips) 
peevoajax will be allowed to play after the button
ersevi6: posts small blind $1
di0d80: posts big blind $2
*** HOLE CARDS ***
Dealt to matiko09 [8h Ad]
prominente: folds 
13Ghosts: folds 
libbyyww: folds 
adrenalin333: folds 
SoNe1988: folds 
matiko09: raises $2.54 to $4.54
ersevi6: folds 
di0d80: calls $2.54
*** FLOP *** [6d 3d Ah]
di0d80: checks 
matiko09: checks 
*** TURN *** [6d 3d Ah] [2d]
di0d80: bets $6
matiko09: calls $6
*** RIVER *** [6d 3d Ah 2d] [Jc]
di0d80: bets $38
matiko09: folds 
Uncalled bet ($38) returned to di0d80
di0d80 collected $20.98 from pot
di0d80: doesn't show hand 
*** SUMMARY ***
Total pot $22.08 | Rake $1.10 
Board [6d 3d Ah 2d Jc]
Seat 1: 13Ghosts folded before Flop (didn't bet)
Seat 2: libbyyww folded before Flop (didn't bet)
Seat 3: adrenalin333 folded before Flop (didn't bet)
Seat 4: SoNe1988 folded before Flop (didn't bet)
Seat 5: matiko09 (button) folded on the River
Seat 7: ersevi6 (small blind) folded before Flop
Seat 8: di0d80 (big blind) collected ($20.98)
Seat 9: prominente folded before Flop (didn't bet)





PokerStars Hand #152560483972:  Hold'em No Limit ($0.50/$1.00 USD) - 2016/04/28 15:38:16 CET [2016/04/28 9:38:16 ET]
Table 'Musa II' 9-max Seat #7 is the button
Seat 1: matiko09 ($110.52 in chips) 
Seat 2: ozone2003 ($100 in chips) 
Seat 3: vrnMike ($100 in chips) 
Seat 4: ipashutapkom ($49.14 in chips) 
Seat 5: thecurv ($102.30 in chips) 
Seat 6: skolombi77 ($82.25 in chips) 
Seat 7: ka100pka527 ($70 in chips) 
Seat 8: darren1031 ($85.72 in chips) 
Seat 9: Moszes360 ($140.08 in chips) 
darren1031: posts small blind $0.50
Moszes360: posts big blind $1
*** HOLE CARDS ***
Dealt to matiko09 [Qc 5s]
matiko09: folds 
ozone2003: folds 
vrnMike: folds 
ipashutapkom: folds 
thecurv: folds 
skolombi77: folds 
ka100pka527: folds 
darren1031: folds 
Uncalled bet ($0.50) returned to Moszes360
Moszes360 collected $1 from pot
Moszes360: doesn't show hand 
*** SUMMARY ***
Total pot $1 | Rake $0 
Seat 1: matiko09 folded before Flop (didn't bet)
Seat 2: ozone2003 folded before Flop (didn't bet)
Seat 3: vrnMike folded before Flop (didn't bet)
Seat 4: ipashutapkom folded before Flop (didn't bet)
Seat 5: thecurv folded before Flop (didn't bet)
Seat 6: skolombi77 folded before Flop (didn't bet)
Seat 7: ka100pka527 (button) folded before Flop (didn't bet)
Seat 8: darren1031 (small blind) folded before Flop
Seat 9: Moszes360 (big blind) collected ($1)





PokerStars Hand #152560487824:  Hold'em No Limit ($1/$2 USD) - 2016/04/28 15:38:22 CET [2016/04/28 9:38:22 ET]
Table 'Naos II' 9-max Seat #8 is the button
Seat 2: peevoajax ($200 in chips) 
Seat 3: SoNe1988 ($88.42 in chips) 
Seat 4: Iggso ($229.25 in chips) 
Seat 6: I The King I ($211.50 in chips) 
Seat 8: libbyyww ($250.52 in chips) 
Seat 9: matiko09 ($200 in chips) 
matiko09: posts small blind $1
peevoajax: posts big blind $2
*** HOLE CARDS ***
Dealt to matiko09 [Jc 6s]
SoNe1988: folds 
Iggso: raises $3.15 to $5.15
SoNe1988 leaves the table
I The King I: folds 
libbyyww: folds 
matiko09: folds 
peevoajax: folds 
Uncalled bet ($3.15) returned to Iggso
Iggso collected $5 from pot
Iggso: doesn't show hand 
*** SUMMARY ***
Total pot $5 | Rake $0 
Seat 2: peevoajax (big blind) folded before Flop
Seat 3: SoNe1988 folded before Flop (didn't bet)
Seat 4: Iggso collected ($5)
Seat 6: I The King I folded before Flop (didn't bet)
Seat 8: libbyyww (button) folded before Flop (didn't bet)
Seat 9: matiko09 (small blind) folded before Flop





PokerStars Hand #152560493261:  Hold'em No Limit ($0.50/$1.00 USD) - 2016/04/28 15:38:31 CET [2016/04/28 9:38:31 ET]
Table 'Halleria' 9-max Seat #4 is the button
Seat 1: JediGaGa ($103.47 in chips) 
Seat 4: ka100pka527 ($43.21 in chips) 
Seat 5: gcz_1886_1 ($108.95 in chips) 
Seat 6: Dantist1122 ($101.50 in chips) 
Seat 7: I The King I ($207.50 in chips) 
Seat 8: sanpidk ($104.61 in chips) 
Seat 9: matiko09 ($100 in chips) 
gcz_1886_1: posts small blind $0.50
Dantist1122: posts big blind $1
koksskrt: sits out 
*** HOLE CARDS ***
Dealt to matiko09 [7d 2s]
I The King I: folds 
richiemay83 joins the table at seat #2 
sanpidk: folds 
matiko09: folds 
JediGaGa: folds 
ka100pka527: folds 
gcz_1886_1: raises $1.50 to $2.50
Dantist1122: folds 
Uncalled bet ($1.50) returned to gcz_1886_1
gcz_1886_1 collected $2 from pot
gcz_1886_1: doesn't show hand 
*** SUMMARY ***
Total pot $2 | Rake $0 
Seat 1: JediGaGa folded before Flop (didn't bet)
Seat 4: ka100pka527 (button) folded before Flop (didn't bet)
Seat 5: gcz_1886_1 (small blind) collected ($2)
Seat 6: Dantist1122 (big blind) folded before Flop
Seat 7: I The King I folded before Flop (didn't bet)
Seat 8: sanpidk folded before Flop (didn't bet)
Seat 9: matiko09 folded before Flop (didn't bet)





PokerStars Hand #152560495382:  Hold'em No Limit ($0.50/$1.00 USD) - 2016/04/28 15:38:34 CET [2016/04/28 9:38:34 ET]
Table 'Erynia' 9-max Seat #1 is the button
Seat 1: I The King I ($100 in chips) 
Seat 2: matiko09 ($160.70 in chips) 
Seat 3: vilo1070 ($111.63 in chips) 
Seat 4: omorfadramou ($120.60 in chips) 
Seat 5: RMilPoker ($90.50 in chips) 
Seat 6: peevoajax ($100 in chips) 
Seat 7: vrnMike ($110.74 in chips) 
Seat 8: YourKicker78 ($93.79 in chips) 
Seat 9: ruslik_by ($40 in chips) 
matiko09: posts small blind $0.50
vilo1070: posts big blind $1
*** HOLE CARDS ***
Dealt to matiko09 [2d 5c]
omorfadramou: folds 
RMilPoker: folds 
peevoajax: folds 
vrnMike: raises $1 to $2
YourKicker78: folds 
ruslik_by: folds 
I The King I: folds 
matiko09: folds 
vilo1070: calls $1
*** FLOP *** [3d Ts Td]
vilo1070: checks 
vrnMike: bets $2
vilo1070: folds 
Uncalled bet ($2) returned to vrnMike
vrnMike collected $4.28 from pot
*** SUMMARY ***
Total pot $4.50 | Rake $0.22 
Board [3d Ts Td]
Seat 1: I The King I (button) folded before Flop (didn't bet)
Seat 2: matiko09 (small blind) folded before Flop
Seat 3: vilo1070 (big blind) folded on the Flop
Seat 4: omorfadramou folded before Flop (didn't bet)
Seat 5: RMilPoker folded before Flop (didn't bet)
Seat 6: peevoajax folded before Flop (didn't bet)
Seat 7: vrnMike collected ($4.28)
Seat 8: YourKicker78 folded before Flop (didn't bet)
Seat 9: ruslik_by folded before Flop (didn't bet)





PokerStars Hand #152560499322:  Hold'em No Limit ($0.50/$1.00 USD) - 2016/04/28 15:38:41 CET [2016/04/28 9:38:41 ET]
Table 'Musa II' 9-max Seat #8 is the button
Seat 1: matiko09 ($110.52 in chips) 
Seat 2: ozone2003 ($100 in chips) 
Seat 3: vrnMike ($100 in chips) 
Seat 4: ipashutapkom ($49.14 in chips) 
Seat 5: thecurv ($102.30 in chips) 
Seat 6: skolombi77 ($82.25 in chips) 
Seat 7: ka100pka527 ($70 in chips) 
Seat 8: darren1031 ($85.22 in chips) 
Seat 9: Moszes360 ($140.58 in chips) 
Moszes360: posts small blind $0.50
matiko09: posts big blind $1
*** HOLE CARDS ***
Dealt to matiko09 [Th 4s]
ozone2003: folds 
vrnMike: folds 
ipashutapkom: raises $1.26 to $2.26
thecurv: folds 
skolombi77: folds 
ka100pka527: folds 
darren1031: folds 
Moszes360: folds 
matiko09: folds 
Uncalled bet ($1.26) returned to ipashutapkom
ipashutapkom collected $2.50 from pot
ipashutapkom: doesn't show hand 
*** SUMMARY ***
Total pot $2.50 | Rake $0 
Seat 1: matiko09 (big blind) folded before Flop
Seat 2: ozone2003 folded before Flop (didn't bet)
Seat 3: vrnMike folded before Flop (didn't bet)
Seat 4: ipashutapkom collected ($2.50)
Seat 5: thecurv folded before Flop (didn't bet)
Seat 6: skolombi77 folded before Flop (didn't bet)
Seat 7: ka100pka527 folded before Flop (didn't bet)
Seat 8: darren1031 (button) folded before Flop (didn't bet)
Seat 9: Moszes360 (small blind) folded before Flop





PokerStars Hand #152560504524:  Hold'em No Limit ($0.50/$1.00 USD) - 2016/04/28 15:38:49 CET [2016/04/28 9:38:49 ET]
Table 'Agapenor III' 9-max Seat #6 is the button
Seat 1: I The King I ($147.02 in chips) 
Seat 2: cerbisor1 ($49.97 in chips) 
Seat 3: sanpidk ($143.13 in chips) 
Seat 4: matiko09 ($100 in chips) 
Seat 5: maxxmeister ($103.27 in chips) 
Seat 6: azzad2007 ($127.14 in chips) 
Seat 7: tylerz71 ($118.98 in chips) 
Seat 8: Ceanucs ($40.45 in chips) 
tylerz71: posts small blind $0.50
Ceanucs: posts big blind $1
Glushchenko: sits out 
*** HOLE CARDS ***
Dealt to matiko09 [As 5c]
I The King I: folds 
cerbisor1: raises $1 to $2
sanpidk: folds 
matiko09: folds 
maxxmeister: folds 
azzad2007: folds 
tylerz71: folds 
Ceanucs: calls $1
*** FLOP *** [8s 3c 2h]
Ceanucs: checks 
cerbisor1: bets $3
Ceanucs: calls $3
*** TURN *** [8s 3c 2h] [Ts]
Ceanucs: checks 
cerbisor1: bets $7
Ceanucs: folds 
Uncalled bet ($7) returned to cerbisor1
cerbisor1 collected $9.98 from pot
cerbisor1: doesn't show hand 
*** SUMMARY ***
Total pot $10.50 | Rake $0.52 
Board [8s 3c 2h Ts]
Seat 1: I The King I folded before Flop (didn't bet)
Seat 2: cerbisor1 collected ($9.98)
Seat 3: sanpidk folded before Flop (didn't bet)
Seat 4: matiko09 folded before Flop (didn't bet)
Seat 5: maxxmeister folded before Flop (didn't bet)
Seat 6: azzad2007 (button) folded before Flop (didn't bet)
Seat 7: tylerz71 (small blind) folded before Flop
Seat 8: Ceanucs (big blind) folded on the Turn





PokerStars Hand #152560504906:  Hold'em No Limit ($1/$2 USD) - 2016/04/28 15:38:50 CET [2016/04/28 9:38:50 ET]
Table 'Sequoia II' 9-max Seat #4 is the button
Seat 1: ersevi6 ($176.67 in chips) 
Seat 2: gudridornot ($223.40 in chips) 
Seat 3: Teddygram902 ($254.43 in chips) 
Seat 4: wiseyoyo ($200 in chips) 
Seat 5: matiko09 ($200 in chips) 
Seat 6: Ouga Buga ($200 in chips) 
Seat 7: libbyyww ($242.05 in chips) 
Seat 8: CI58 ($200 in chips) 
Seat 9: JustinRuth88 ($178.20 in chips) 
matiko09: posts small blind $1
Ouga Buga: posts big blind $2
ersevi6: posts the ante $0.40
gudridornot: posts the ante $0.40
Teddygram902: posts the ante $0.40
wiseyoyo: posts the ante $0.40
matiko09: posts the ante $0.40
Ouga Buga: posts the ante $0.40
libbyyww: posts the ante $0.40
CI58: posts the ante $0.40
JustinRuth88: posts the ante $0.40
*** HOLE CARDS ***
Dealt to matiko09 [4s 8s]
libbyyww: folds 
CI58: folds 
JustinRuth88: calls $2
ersevi6: folds 
gudridornot: folds 
Teddygram902: folds 
wiseyoyo: folds 
matiko09: folds 
Ouga Buga: checks 
*** FLOP *** [Td 4d 8c]
Ouga Buga: checks 
JustinRuth88: bets $10
Ouga Buga: folds 
Uncalled bet ($10) returned to JustinRuth88
JustinRuth88 collected $8.17 from pot
*** SUMMARY ***
Total pot $8.60 | Rake $0.43 
Board [Td 4d 8c]
Seat 1: ersevi6 folded before Flop (didn't bet)
Seat 2: gudridornot folded before Flop (didn't bet)
Seat 3: Teddygram902 folded before Flop (didn't bet)
Seat 4: wiseyoyo (button) folded before Flop (didn't bet)
Seat 5: matiko09 (small blind) folded before Flop
Seat 6: Ouga Buga (big blind) folded on the Flop
Seat 7: libbyyww folded before Flop (didn't bet)
Seat 8: CI58 folded before Flop (didn't bet)
Seat 9: JustinRuth88 collected ($8.17)





PokerStars Hand #152560508644:  Hold'em No Limit ($1/$2 USD) - 2016/04/28 15:38:56 CET [2016/04/28 9:38:56 ET]
Table 'Naos II' 9-max Seat #9 is the button
Seat 2: peevoajax ($200 in chips) 
Seat 6: I The King I ($211.50 in chips) 
Seat 8: libbyyww ($250.52 in chips) 
Seat 9: matiko09 ($200 in chips) 
peevoajax: posts small blind $1
Iggso: is sitting out 
I The King I: posts big blind $2
*** HOLE CARDS ***
Dealt to matiko09 [Ah 5h]
libbyyww: folds 
libbyyww leaves the table
matiko09: raises $2.54 to $4.54
Iggso leaves the table
peevoajax: raises $13.46 to $18
I The King I: folds 
matiko09: calls $13.46
*** FLOP *** [8d 7s 3s]
peevoajax: bets $20
matiko09: folds 
Uncalled bet ($20) returned to peevoajax
peevoajax collected $36.75 from pot
peevoajax: doesn't show hand 
*** SUMMARY ***
Total pot $38 | Rake $1.25 
Board [8d 7s 3s]
Seat 2: peevoajax (small blind) collected ($36.75)
Seat 6: I The King I (big blind) folded before Flop
Seat 8: libbyyww folded before Flop (didn't bet)
Seat 9: matiko09 (button) folded on the Flop





PokerStars Hand #152560511033:  Hold'em No Limit ($0.50/$1.00 USD) - 2016/04/28 15:39:00 CET [2016/04/28 9:39:00 ET]
Table 'Musa II' 9-max Seat #9 is the button
Seat 1: matiko09 ($109.52 in chips) 
Seat 2: ozone2003 ($100 in chips) 
Seat 3: vrnMike ($100 in chips) 
Seat 4: ipashutapkom ($50.64 in chips) 
Seat 5: thecurv ($102.30 in chips) 
Seat 6: skolombi77 ($82.25 in chips) 
Seat 7: ka100pka527 ($70 in chips) 
Seat 8: darren1031 ($85.22 in chips) 
Seat 9: Moszes360 ($140.08 in chips) 
matiko09: posts small blind $0.50
ozone2003: posts big blind $1
*** HOLE CARDS ***
Dealt to matiko09 [5d 8d]
vrnMike: folds 
ipashutapkom: folds 
thecurv: folds 
skolombi77: raises $1 to $2
ka100pka527: folds 
darren1031: folds 
Moszes360: folds 
matiko09: folds 
ozone2003: folds 
Uncalled bet ($1) returned to skolombi77
skolombi77 collected $2.50 from pot
skolombi77: doesn't show hand 
*** SUMMARY ***
Total pot $2.50 | Rake $0 
Seat 1: matiko09 (small blind) folded before Flop
Seat 2: ozone2003 (big blind) folded before Flop
Seat 3: vrnMike folded before Flop (didn't bet)
Seat 4: ipashutapkom folded before Flop (didn't bet)
Seat 5: thecurv folded before Flop (didn't bet)
Seat 6: skolombi77 collected ($2.50)
Seat 7: ka100pka527 folded before Flop (didn't bet)
Seat 8: darren1031 folded before Flop (didn't bet)
Seat 9: Moszes360 (button) folded before Flop (didn't bet)





PokerStars Hand #152560524110:  Hold'em No Limit (€0.50/€1.00 EUR) - 2016/04/28 15:39:21 CET [2016/04/28 9:39:21 ET]
Table 'Lumiere II' 9-max Seat #8 is the button
Seat 1: maxxmeister (€110.30 in chips) 
Seat 4: ruslik_by (€50.70 in chips) 
Seat 5: Schmidy7 (€56.55 in chips) 
Seat 6: azzad2007 (€96.50 in chips) 
Seat 7: hammerwife (€101.68 in chips) 
Seat 8: sanpidk (€107.02 in chips) 
Seat 9: matiko09 (€101.50 in chips) 
matiko09: posts small blind €0.50
maxxmeister: posts big blind €1
*** HOLE CARDS ***
Dealt to matiko09 [Qd 6s]
ruslik_by: folds 
Schmidy7: folds 
azzad2007: raises €2 to €3
hammerwife: folds 
sanpidk: folds 
matiko09: folds 
maxxmeister: folds 
Uncalled bet (€2) returned to azzad2007
azzad2007 collected €2.50 from pot
azzad2007: doesn't show hand 
*** SUMMARY ***
Total pot €2.50 | Rake €0 
Seat 1: maxxmeister (big blind) folded before Flop
Seat 4: ruslik_by folded before Flop (didn't bet)
Seat 5: Schmidy7 folded before Flop (didn't bet)
Seat 6: azzad2007 collected (€2.50)
Seat 7: hammerwife folded before Flop (didn't bet)
Seat 8: sanpidk (button) folded before Flop (didn't bet)
Seat 9: matiko09 (small blind) folded before Flop





PokerStars Hand #152560525935:  Hold'em No Limit ($0.50/$1.00 USD) - 2016/04/28 15:39:25 CET [2016/04/28 9:39:25 ET]
Table 'Erynia' 9-max Seat #2 is the button
Seat 1: I The King I ($100 in chips) 
Seat 2: matiko09 ($160.20 in chips) 
Seat 3: vilo1070 ($109.63 in chips) 
Seat 4: omorfadramou ($120.60 in chips) 
Seat 5: RMilPoker ($90.50 in chips) 
Seat 6: peevoajax ($100 in chips) 
Seat 7: vrnMike ($113.02 in chips) 
Seat 8: YourKicker78 ($93.79 in chips) 
Seat 9: ruslik_by ($40 in chips) 
vilo1070: posts small blind $0.50
omorfadramou: posts big blind $1
*** HOLE CARDS ***
Dealt to matiko09 [6s 2d]
RMilPoker: raises $2 to $3
peevoajax: folds 
vrnMike: folds 
YourKicker78: folds 
ruslik_by: folds 
I The King I: folds 
matiko09: folds 
vilo1070: calls $2.50
omorfadramou: folds 
*** FLOP *** [2h 7h 5d]
vilo1070: bets $5.26
RMilPoker: folds 
Uncalled bet ($5.26) returned to vilo1070
vilo1070 collected $6.65 from pot
vilo1070: doesn't show hand 
*** SUMMARY ***
Total pot $7 | Rake $0.35 
Board [2h 7h 5d]
Seat 1: I The King I folded before Flop (didn't bet)
Seat 2: matiko09 (button) folded before Flop (didn't bet)
Seat 3: vilo1070 (small blind) collected ($6.65)
Seat 4: omorfadramou (big blind) folded before Flop
Seat 5: RMilPoker folded on the Flop
Seat 6: peevoajax folded before Flop (didn't bet)
Seat 7: vrnMike folded before Flop (didn't bet)
Seat 8: YourKicker78 folded before Flop (didn't bet)
Seat 9: ruslik_by folded before Flop (didn't bet)





PokerStars Hand #152560527525:  Hold'em No Limit ($0.50/$1.00 USD) - 2016/04/28 15:39:27 CET [2016/04/28 9:39:27 ET]
Table 'Halleria' 9-max Seat #5 is the button
Seat 1: JediGaGa ($103.47 in chips) 
Seat 4: ka100pka527 ($43.21 in chips) 
Seat 5: gcz_1886_1 ($109.95 in chips) 
Seat 6: Dantist1122 ($100.50 in chips) 
Seat 7: I The King I ($207.50 in chips) 
Seat 8: sanpidk ($104.61 in chips) 
Seat 9: matiko09 ($100 in chips) 
Dantist1122: posts small blind $0.50
I The King I: posts big blind $1
richiemay83: sits out 
koksskrt: sits out 
*** HOLE CARDS ***
Dealt to matiko09 [6h Ad]
sanpidk: folds 
matiko09: folds 
JediGaGa: folds 
ka100pka527: folds 
gcz_1886_1: folds 
Dantist1122: raises $1.05 to $2.05
I The King I: folds 
Uncalled bet ($1.05) returned to Dantist1122
Dantist1122 collected $2 from pot
Dantist1122: doesn't show hand 
*** SUMMARY ***
Total pot $2 | Rake $0 
Seat 1: JediGaGa folded before Flop (didn't bet)
Seat 4: ka100pka527 folded before Flop (didn't bet)
Seat 5: gcz_1886_1 (button) folded before Flop (didn't bet)
Seat 6: Dantist1122 (small blind) collected ($2)
Seat 7: I The King I (big blind) folded before Flop
Seat 8: sanpidk folded before Flop (didn't bet)
Seat 9: matiko09 folded before Flop (didn't bet)





PokerStars Hand #152560528997:  Hold'em No Limit ($0.50/$1.00 USD) - 2016/04/28 15:39:30 CET [2016/04/28 9:39:30 ET]
Table 'Musa II' 9-max Seat #1 is the button
Seat 1: matiko09 ($109.02 in chips) 
Seat 2: ozone2003 ($100 in chips) 
Seat 3: vrnMike ($100 in chips) 
Seat 4: ipashutapkom ($50.64 in chips) 
Seat 5: thecurv ($102.30 in chips) 
Seat 6: skolombi77 ($83.75 in chips) 
Seat 7: ka100pka527 ($70 in chips) 
Seat 8: darren1031 ($85.22 in chips) 
Seat 9: Moszes360 ($140.08 in chips) 
ozone2003: posts small blind $0.50
vrnMike: posts big blind $1
*** HOLE CARDS ***
Dealt to matiko09 [Jc Ad]
ipashutapkom: raises $1.26 to $2.26
thecurv: folds 
skolombi77: folds 
ka100pka527: folds 
darren1031: folds 
Moszes360: folds 
matiko09: raises $5.74 to $8
ozone2003: folds 
vrnMike: folds 
ipashutapkom: calls $5.74
*** FLOP *** [Ks 4s Qc]
ipashutapkom: checks 
matiko09: bets $8.64
ipashutapkom: calls $8.64
*** TURN *** [Ks 4s Qc] [Ts]
ipashutapkom: checks 
matiko09: bets $16
ipashutapkom: folds 
Uncalled bet ($16) returned to matiko09
matiko09 collected $33.04 from pot
matiko09: doesn't show hand 
*** SUMMARY ***
Total pot $34.78 | Rake $1.74 
Board [Ks 4s Qc Ts]
Seat 1: matiko09 (button) collected ($33.04)
Seat 2: ozone2003 (small blind) folded before Flop
Seat 3: vrnMike (big blind) folded before Flop
Seat 4: ipashutapkom folded on the Turn
Seat 5: thecurv folded before Flop (didn't bet)
Seat 6: skolombi77 folded before Flop (didn't bet)
Seat 7: ka100pka527 folded before Flop (didn't bet)
Seat 8: darren1031 folded before Flop (didn't bet)
Seat 9: Moszes360 folded before Flop (didn't bet)





PokerStars Hand #152560530357:  Hold'em No Limit ($1/$2 USD) - 2016/04/28 15:39:32 CET [2016/04/28 9:39:32 ET]
Table 'Idomeneus II' 9-max Seat #7 is the button
Seat 1: 13Ghosts ($249.47 in chips) 
Seat 2: libbyyww ($410.61 in chips) 
Seat 3: adrenalin333 ($135.57 in chips) 
Seat 4: SoNe1988 ($80 in chips) 
Seat 5: matiko09 ($220.82 in chips) 
Seat 7: ersevi6 ($222.03 in chips) 
Seat 8: di0d80 ($228.29 in chips) 
Seat 9: prominente ($200 in chips) 
di0d80: posts small blind $1
prominente: posts big blind $2
peevoajax: sits out 
*** HOLE CARDS ***
Dealt to matiko09 [5d Jd]
13Ghosts: raises $2.78 to $4.78
libbyyww: folds 
adrenalin333: raises $7.22 to $12
SoNe1988: folds 
matiko09: folds 
ersevi6: folds 
di0d80: folds 
prominente: folds 
13Ghosts: folds 
Uncalled bet ($7.22) returned to adrenalin333
adrenalin333 collected $12.56 from pot
adrenalin333: doesn't show hand 
*** SUMMARY ***
Total pot $12.56 | Rake $0 
Seat 1: 13Ghosts folded before Flop
Seat 2: libbyyww folded before Flop (didn't bet)
Seat 3: adrenalin333 collected ($12.56)
Seat 4: SoNe1988 folded before Flop (didn't bet)
Seat 5: matiko09 folded before Flop (didn't bet)
Seat 7: ersevi6 (button) folded before Flop (didn't bet)
Seat 8: di0d80 (small blind) folded before Flop
Seat 9: prominente (big blind) folded before Flop





PokerStars Hand #152560531464:  Hold'em No Limit ($0.50/$1.00 USD) - 2016/04/28 15:39:34 CET [2016/04/28 9:39:34 ET]
Table 'Bruwer' 9-max Seat #7 is the button
Seat 1: peevoajax ($100 in chips) 
Seat 2: ruslik_by ($40 in chips) 
Seat 3: koksskrt ($141.51 in chips) 
Seat 4: matiko09 ($133.04 in chips) 
Seat 5: Carloszhang ($106.31 in chips) 
Seat 6: I The King I ($100.02 in chips) 
Seat 7: R1aki ($219.16 in chips) 
Seat 8: ozone2003 ($141.03 in chips) 
Seat 9: Dantist1122 ($121.10 in chips) 
ozone2003: posts small blind $0.50
Dantist1122: posts big blind $1
*** HOLE CARDS ***
Dealt to matiko09 [9s 3d]
peevoajax: folds 
ruslik_by: folds 
koksskrt: folds 
matiko09: folds 
Carloszhang: folds 
I The King I: folds 
R1aki: folds 
ozone2003: folds 
Uncalled bet ($0.50) returned to Dantist1122
Dantist1122 collected $1 from pot
Dantist1122: doesn't show hand 
*** SUMMARY ***
Total pot $1 | Rake $0 
Seat 1: peevoajax folded before Flop (didn't bet)
Seat 2: ruslik_by folded before Flop (didn't bet)
Seat 3: koksskrt folded before Flop (didn't bet)
Seat 4: matiko09 folded before Flop (didn't bet)
Seat 5: Carloszhang folded before Flop (didn't bet)
Seat 6: I The King I folded before Flop (didn't bet)
Seat 7: R1aki (button) folded before Flop (didn't bet)
Seat 8: ozone2003 (small blind) folded before Flop
Seat 9: Dantist1122 (big blind) collected ($1)





PokerStars Hand #152560532972:  Hold'em No Limit ($1/$2 USD) - 2016/04/28 15:39:36 CET [2016/04/28 9:39:36 ET]
Table 'Sequoia II' 9-max Seat #5 is the button
Seat 1: ersevi6 ($176.27 in chips) 
Seat 2: gudridornot ($223 in chips) 
Seat 3: Teddygram902 ($254.03 in chips) 
Seat 4: wiseyoyo ($200 in chips) 
Seat 5: matiko09 ($200 in chips) 
Seat 6: Ouga Buga ($200 in chips) 
Seat 7: libbyyww ($241.65 in chips) 
Seat 8: CI58 ($200 in chips) 
Seat 9: JustinRuth88 ($183.97 in chips) 
Ouga Buga: posts small blind $1
libbyyww: posts big blind $2
ersevi6: posts the ante $0.40
gudridornot: posts the ante $0.40
Teddygram902: posts the ante $0.40
wiseyoyo: posts the ante $0.40
matiko09: posts the ante $0.40
Ouga Buga: posts the ante $0.40
libbyyww: posts the ante $0.40
CI58: posts the ante $0.40
JustinRuth88: posts the ante $0.40
*** HOLE CARDS ***
Dealt to matiko09 [5s 7s]
CI58: folds 
JustinRuth88: folds 
ersevi6: folds 
gudridornot: folds 
Teddygram902: folds 
wiseyoyo: raises $2.42 to $4.42
matiko09: folds 
Ouga Buga: folds 
libbyyww: folds 
Uncalled bet ($2.42) returned to wiseyoyo
wiseyoyo collected $8.60 from pot
wiseyoyo: doesn't show hand 
*** SUMMARY ***
Total pot $8.60 | Rake $0 
Seat 1: ersevi6 folded before Flop (didn't bet)
Seat 2: gudridornot folded before Flop (didn't bet)
Seat 3: Teddygram902 folded before Flop (didn't bet)
Seat 4: wiseyoyo collected ($8.60)
Seat 5: matiko09 (button) folded before Flop (didn't bet)
Seat 6: Ouga Buga (small blind) folded before Flop
Seat 7: libbyyww (big blind) folded before Flop
Seat 8: CI58 folded before Flop (didn't bet)
Seat 9: JustinRuth88 folded before Flop (didn't bet)





PokerStars Hand #152560545670:  Hold'em No Limit (€0.50/€1.00 EUR) - 2016/04/28 15:39:57 CET [2016/04/28 9:39:57 ET]
Table 'Lumiere II' 9-max Seat #9 is the button
Seat 1: maxxmeister (€109.30 in chips) 
Seat 4: ruslik_by (€50.70 in chips) 
Seat 5: Schmidy7 (€56.55 in chips) 
Seat 6: azzad2007 (€98 in chips) 
Seat 7: hammerwife (€101.68 in chips) 
Seat 8: sanpidk (€107.02 in chips) 
Seat 9: matiko09 (€101 in chips) 
maxxmeister: posts small blind €0.50
ruslik_by: posts big blind €1
*** HOLE CARDS ***
Dealt to matiko09 [9c 5s]
Schmidy7: calls €1
azzad2007: raises €3 to €4
hammerwife: raises €8 to €12
sanpidk: folds 
matiko09: folds 
maxxmeister: folds 
ruslik_by: folds 
Schmidy7: folds 
azzad2007: folds 
Uncalled bet (€8) returned to hammerwife
hammerwife collected €10.50 from pot
hammerwife: doesn't show hand 
*** SUMMARY ***
Total pot €10.50 | Rake €0 
Seat 1: maxxmeister (small blind) folded before Flop
Seat 4: ruslik_by (big blind) folded before Flop
Seat 5: Schmidy7 folded before Flop
Seat 6: azzad2007 folded before Flop
Seat 7: hammerwife collected (€10.50)
Seat 8: sanpidk folded before Flop (didn't bet)
Seat 9: matiko09 (button) folded before Flop (didn't bet)





PokerStars Hand #152560550185:  Hold'em No Limit ($0.50/$1.00 USD) - 2016/04/28 15:40:04 CET [2016/04/28 9:40:04 ET]
Table 'Agapenor III' 9-max Seat #7 is the button
Seat 1: I The King I ($147.02 in chips) 
Seat 2: cerbisor1 ($54.95 in chips) 
Seat 3: sanpidk ($143.13 in chips) 
Seat 4: matiko09 ($100 in chips) 
Seat 5: maxxmeister ($103.27 in chips) 
Seat 6: azzad2007 ($127.14 in chips) 
Seat 7: tylerz71 ($118.48 in chips) 
Seat 8: Ceanucs ($35.45 in chips) 
Seat 9: Glushchenko ($100 in chips) 
Ceanucs: posts small blind $0.50
Glushchenko: posts big blind $1
*** HOLE CARDS ***
Dealt to matiko09 [Ah 4d]
I The King I: folds 
cerbisor1: calls $1
sanpidk: raises $3 to $4
matiko09: folds 
maxxmeister: folds 
azzad2007: folds 
tylerz71: folds 
Ceanucs: calls $3.50
Glushchenko: folds 
cerbisor1: calls $3
*** FLOP *** [Kh 6d 5s]
Ceanucs: checks 
cerbisor1: checks 
sanpidk: checks 
*** TURN *** [Kh 6d 5s] [3h]
Ceanucs: bets $5
cerbisor1: raises $11 to $16
sanpidk: folds 
Ceanucs: raises $15.45 to $31.45 and is all-in
cerbisor1: calls $15.45
*** RIVER *** [Kh 6d 5s 3h] [Th]
*** SHOW DOWN ***
Ceanucs: shows [5c 6c] (two pair, Sixes and Fives)
cerbisor1: shows [3c 3s] (three of a kind, Threes)
cerbisor1 collected $73.40 from pot
*** SUMMARY ***
Total pot $75.90 | Rake $2.50 
Board [Kh 6d 5s 3h Th]
Seat 1: I The King I folded before Flop (didn't bet)
Seat 2: cerbisor1 showed [3c 3s] and won ($73.40) with three of a kind, Threes
Seat 3: sanpidk folded on the Turn
Seat 4: matiko09 folded before Flop (didn't bet)
Seat 5: maxxmeister folded before Flop (didn't bet)
Seat 6: azzad2007 folded before Flop (didn't bet)
Seat 7: tylerz71 (button) folded before Flop (didn't bet)
Seat 8: Ceanucs (small blind) showed [5c 6c] and lost with two pair, Sixes and Fives
Seat 9: Glushchenko (big blind) folded before Flop





PokerStars Hand #152560552942:  Hold'em No Limit ($1/$2 USD) - 2016/04/28 15:40:09 CET [2016/04/28 9:40:09 ET]
Table 'Idomeneus II' 9-max Seat #8 is the button
Seat 1: 13Ghosts ($244.69 in chips) 
Seat 2: libbyyww ($410.61 in chips) 
Seat 3: adrenalin333 ($143.35 in chips) 
Seat 4: SoNe1988 ($80 in chips) 
Seat 5: matiko09 ($220.82 in chips) 
Seat 7: ersevi6 ($222.03 in chips) 
Seat 8: di0d80 ($227.29 in chips) 
Seat 9: prominente ($200 in chips) 
prominente: posts small blind $1
13Ghosts: posts big blind $2
peevoajax: sits out 
*** HOLE CARDS ***
Dealt to matiko09 [3s 7d]
libbyyww: folds 
adrenalin333: folds 
SoNe1988: folds 
matiko09: folds 
ersevi6: raises $3 to $5
di0d80: folds 
prominente: folds 
13Ghosts: folds 
Uncalled bet ($3) returned to ersevi6
ersevi6 collected $5 from pot
ersevi6: doesn't show hand 
*** SUMMARY ***
Total pot $5 | Rake $0 
Seat 1: 13Ghosts (big blind) folded before Flop
Seat 2: libbyyww folded before Flop (didn't bet)
Seat 3: adrenalin333 folded before Flop (didn't bet)
Seat 4: SoNe1988 folded before Flop (didn't bet)
Seat 5: matiko09 folded before Flop (didn't bet)
Seat 7: ersevi6 collected ($5)
Seat 8: di0d80 (button) folded before Flop (didn't bet)
Seat 9: prominente (small blind) folded before Flop





PokerStars Hand #152560553204:  Hold'em No Limit ($0.50/$1.00 USD) - 2016/04/28 15:40:10 CET [2016/04/28 9:40:10 ET]
Table 'Bruwer' 9-max Seat #8 is the button
Seat 1: peevoajax ($100 in chips) 
Seat 2: ruslik_by ($40 in chips) 
Seat 3: koksskrt ($141.51 in chips) 
Seat 4: matiko09 ($133.04 in chips) 
Seat 5: Carloszhang ($106.31 in chips) 
Seat 6: I The King I ($100.02 in chips) 
Seat 7: R1aki ($219.16 in chips) 
Seat 8: ozone2003 ($140.53 in chips) 
Seat 9: Dantist1122 ($121.60 in chips) 
Dantist1122: posts small blind $0.50
peevoajax: posts big blind $1
*** HOLE CARDS ***
Dealt to matiko09 [4s 6c]
ruslik_by: folds 
koksskrt: folds 
matiko09: folds 
Carloszhang: folds 
I The King I: folds 
R1aki: folds 
ozone2003: folds 
Dantist1122: raises $1.05 to $2.05
peevoajax: calls $1.05
*** FLOP *** [As Jc Qh]
Dantist1122: bets $3
peevoajax: folds 
Uncalled bet ($3) returned to Dantist1122
Dantist1122 collected $3.90 from pot
Dantist1122: doesn't show hand 
*** SUMMARY ***
Total pot $4.10 | Rake $0.20 
Board [As Jc Qh]
Seat 1: peevoajax (big blind) folded on the Flop
Seat 2: ruslik_by folded before Flop (didn't bet)
Seat 3: koksskrt folded before Flop (didn't bet)
Seat 4: matiko09 folded before Flop (didn't bet)
Seat 5: Carloszhang folded before Flop (didn't bet)
Seat 6: I The King I folded before Flop (didn't bet)
Seat 7: R1aki folded before Flop (didn't bet)
Seat 8: ozone2003 (button) folded before Flop (didn't bet)
Seat 9: Dantist1122 (small blind) collected ($3.90)





PokerStars Hand #152560553184:  Hold'em No Limit ($0.50/$1.00 USD) - 2016/04/28 15:40:10 CET [2016/04/28 9:40:10 ET]
Table 'Halleria' 9-max Seat #6 is the button
Seat 1: JediGaGa ($103.47 in chips) 
Seat 4: ka100pka527 ($43.21 in chips) 
Seat 5: gcz_1886_1 ($109.95 in chips) 
Seat 6: Dantist1122 ($101.50 in chips) 
Seat 7: I The King I ($206.50 in chips) 
Seat 8: sanpidk ($104.61 in chips) 
Seat 9: matiko09 ($100 in chips) 
I The King I: posts small blind $0.50
sanpidk: posts big blind $1
richiemay83: sits out 
koksskrt: sits out 
*** HOLE CARDS ***
Dealt to matiko09 [3c 6d]
matiko09: folds 
JediGaGa: folds 
ka100pka527: folds 
gcz_1886_1: folds 
Dantist1122: raises $1.05 to $2.05
I The King I: folds 
sanpidk: calls $1.05
*** FLOP *** [Th Qh 9d]
sanpidk: checks 
Dantist1122: bets $3.36
sanpidk: folds 
Uncalled bet ($3.36) returned to Dantist1122
Dantist1122 collected $4.37 from pot
Dantist1122: doesn't show hand 
*** SUMMARY ***
Total pot $4.60 | Rake $0.23 
Board [Th Qh 9d]
Seat 1: JediGaGa folded before Flop (didn't bet)
Seat 4: ka100pka527 folded before Flop (didn't bet)
Seat 5: gcz_1886_1 folded before Flop (didn't bet)
Seat 6: Dantist1122 (button) collected ($4.37)
Seat 7: I The King I (small blind) folded before Flop
Seat 8: sanpidk (big blind) folded on the Flop
Seat 9: matiko09 folded before Flop (didn't bet)





PokerStars Hand #152560559899:  Hold'em No Limit ($1/$2 USD) - 2016/04/28 15:40:21 CET [2016/04/28 9:40:21 ET]
Table 'Sequoia II' 9-max Seat #6 is the button
Seat 1: ersevi6 ($175.87 in chips) 
Seat 2: gudridornot ($222.60 in chips) 
Seat 3: Teddygram902 ($253.63 in chips) 
Seat 4: wiseyoyo ($206.20 in chips) 
Seat 5: matiko09 ($200 in chips) 
Seat 6: Ouga Buga ($200 in chips) 
Seat 7: libbyyww ($239.25 in chips) 
Seat 8: CI58 ($200 in chips) 
Seat 9: JustinRuth88 ($183.57 in chips) 
libbyyww: posts small blind $1
CI58: posts big blind $2
ersevi6: posts the ante $0.40
gudridornot: posts the ante $0.40
Teddygram902: posts the ante $0.40
wiseyoyo: posts the ante $0.40
matiko09: posts the ante $0.40
Ouga Buga: posts the ante $0.40
libbyyww: posts the ante $0.40
CI58: posts the ante $0.40
JustinRuth88: posts the ante $0.40
*** HOLE CARDS ***
Dealt to matiko09 [7s 8h]
JustinRuth88: folds 
ersevi6: folds 
gudridornot: folds 
Teddygram902: folds 
wiseyoyo: folds 
matiko09: folds 
Ouga Buga: raises $3 to $5
libbyyww: folds 
CI58: folds 
Uncalled bet ($3) returned to Ouga Buga
Ouga Buga collected $8.60 from pot
Ouga Buga: doesn't show hand 
*** SUMMARY ***
Total pot $8.60 | Rake $0 
Seat 1: ersevi6 folded before Flop (didn't bet)
Seat 2: gudridornot folded before Flop (didn't bet)
Seat 3: Teddygram902 folded before Flop (didn't bet)
Seat 4: wiseyoyo folded before Flop (didn't bet)
Seat 5: matiko09 folded before Flop (didn't bet)
Seat 6: Ouga Buga (button) collected ($8.60)
Seat 7: libbyyww (small blind) folded before Flop
Seat 8: CI58 (big blind) folded before Flop
Seat 9: JustinRuth88 folded before Flop (didn't bet)





PokerStars Hand #152560565782:  Hold'em No Limit ($0.50/$1.00 USD) - 2016/04/28 15:40:30 CET [2016/04/28 9:40:30 ET]
Table 'Erynia' 9-max Seat #3 is the button
Seat 1: I The King I ($100 in chips) 
Seat 2: matiko09 ($160.20 in chips) 
Seat 3: vilo1070 ($113.28 in chips) 
Seat 4: omorfadramou ($119.60 in chips) 
Seat 5: RMilPoker ($87.50 in chips) 
Seat 6: peevoajax ($100 in chips) 
Seat 7: vrnMike ($113.02 in chips) 
Seat 8: YourKicker78 ($93.79 in chips) 
Seat 9: ruslik_by ($40 in chips) 
omorfadramou: posts small blind $0.50
RMilPoker: posts big blind $1
*** HOLE CARDS ***
Dealt to matiko09 [7h Ah]
peevoajax: folds 
vrnMike: folds 
YourKicker78: folds 
ruslik_by: folds 
I The King I: folds 
matiko09: raises $1.50 to $2.50
vilo1070: calls $2.50
omorfadramou: folds 
RMilPoker: folds 
*** FLOP *** [6h Kh 6c]
matiko09: bets $4.02
vilo1070: calls $4.02
*** TURN *** [6h Kh 6c] [7d]
matiko09: checks 
vilo1070: checks 
*** RIVER *** [6h Kh 6c 7d] [Qd]
matiko09: checks 
vilo1070: checks 
*** SHOW DOWN ***
matiko09: shows [7h Ah] (two pair, Sevens and Sixes)
vilo1070: shows [Td Tc] (two pair, Tens and Sixes)
vilo1070 collected $13.81 from pot
*** SUMMARY ***
Total pot $14.54 | Rake $0.73 
Board [6h Kh 6c 7d Qd]
Seat 1: I The King I folded before Flop (didn't bet)
Seat 2: matiko09 showed [7h Ah] and lost with two pair, Sevens and Sixes
Seat 3: vilo1070 (button) showed [Td Tc] and won ($13.81) with two pair, Tens and Sixes
Seat 4: omorfadramou (small blind) folded before Flop
Seat 5: RMilPoker (big blind) folded before Flop
Seat 6: peevoajax folded before Flop (didn't bet)
Seat 7: vrnMike folded before Flop (didn't bet)
Seat 8: YourKicker78 folded before Flop (didn't bet)
Seat 9: ruslik_by folded before Flop (didn't bet)





PokerStars Hand #152560577191:  Hold'em No Limit ($1/$2 USD) - 2016/04/28 15:40:49 CET [2016/04/28 9:40:49 ET]
Table 'Sequoia II' 9-max Seat #7 is the button
Seat 1: ersevi6 ($175.47 in chips) 
Seat 2: gudridornot ($222.20 in chips) 
Seat 3: Teddygram902 ($253.23 in chips) 
Seat 4: wiseyoyo ($205.80 in chips) 
Seat 5: matiko09 ($200 in chips) 
Seat 6: Ouga Buga ($206.20 in chips) 
Seat 7: libbyyww ($237.85 in chips) 
Seat 8: CI58 ($200 in chips) 
Seat 9: JustinRuth88 ($183.17 in chips) 
CI58: posts small blind $1
JustinRuth88: posts big blind $2
ersevi6: posts the ante $0.40
gudridornot: posts the ante $0.40
Teddygram902: posts the ante $0.40
wiseyoyo: posts the ante $0.40
matiko09: posts the ante $0.40
Ouga Buga: posts the ante $0.40
libbyyww: posts the ante $0.40
CI58: posts the ante $0.40
JustinRuth88: posts the ante $0.40
*** HOLE CARDS ***
Dealt to matiko09 [Qh 3c]
ersevi6: folds 
gudridornot: folds 
Teddygram902: raises $3 to $5
wiseyoyo: folds 
matiko09: folds 
Ouga Buga: folds 
libbyyww: folds 
CI58: folds 
JustinRuth88: calls $3
*** FLOP *** [9c 7d Tc]
JustinRuth88: checks 
Teddygram902: checks 
*** TURN *** [9c 7d Tc] [2h]
JustinRuth88: checks 
Teddygram902: bets $6
JustinRuth88: folds 
Uncalled bet ($6) returned to Teddygram902
Teddygram902 collected $13.87 from pot
*** SUMMARY ***
Total pot $14.60 | Rake $0.73 
Board [9c 7d Tc 2h]
Seat 1: ersevi6 folded before Flop (didn't bet)
Seat 2: gudridornot folded before Flop (didn't bet)
Seat 3: Teddygram902 collected ($13.87)
Seat 4: wiseyoyo folded before Flop (didn't bet)
Seat 5: matiko09 folded before Flop (didn't bet)
Seat 6: Ouga Buga folded before Flop (didn't bet)
Seat 7: libbyyww (button) folded before Flop (didn't bet)
Seat 8: CI58 (small blind) folded before Flop
Seat 9: JustinRuth88 (big blind) folded on the Turn





PokerStars Hand #152560579308:  Hold'em No Limit (€0.50/€1.00 EUR) - 2016/04/28 15:40:53 CET [2016/04/28 9:40:53 ET]
Table 'Lumiere II' 9-max Seat #1 is the button
Seat 1: maxxmeister (€108.80 in chips) 
Seat 4: ruslik_by (€49.70 in chips) 
Seat 5: Schmidy7 (€55.55 in chips) 
Seat 6: azzad2007 (€94 in chips) 
Seat 7: hammerwife (€108.18 in chips) 
Seat 8: sanpidk (€107.02 in chips) 
Seat 9: matiko09 (€101 in chips) 
ruslik_by: posts small blind €0.50
Schmidy7: posts big blind €1
*** HOLE CARDS ***
Dealt to matiko09 [Tc 6d]
azzad2007: raises €2 to €3
hammerwife: folds 
sanpidk: folds 
matiko09: folds 
maxxmeister: folds 
ruslik_by: folds 
Schmidy7: folds 
Uncalled bet (€2) returned to azzad2007
azzad2007 collected €2.50 from pot
azzad2007: doesn't show hand 
*** SUMMARY ***
Total pot €2.50 | Rake €0 
Seat 1: maxxmeister (button) folded before Flop (didn't bet)
Seat 4: ruslik_by (small blind) folded before Flop
Seat 5: Schmidy7 (big blind) folded before Flop
Seat 6: azzad2007 collected (€2.50)
Seat 7: hammerwife folded before Flop (didn't bet)
Seat 8: sanpidk folded before Flop (didn't bet)
Seat 9: matiko09 folded before Flop (didn't bet)





PokerStars Hand #152560585698:  Hold'em No Limit ($1/$2 USD) - 2016/04/28 15:41:03 CET [2016/04/28 9:41:03 ET]
Table 'Idomeneus II' 9-max Seat #9 is the button
Seat 1: 13Ghosts ($242.69 in chips) 
Seat 2: libbyyww ($410.61 in chips) 
Seat 3: adrenalin333 ($143.35 in chips) 
Seat 4: SoNe1988 ($80 in chips) 
Seat 5: matiko09 ($220.82 in chips) 
Seat 7: ersevi6 ($225.03 in chips) 
Seat 8: di0d80 ($227.29 in chips) 
Seat 9: prominente ($200 in chips) 
13Ghosts: posts small blind $1
libbyyww: posts big blind $2
peevoajax: sits out 
*** HOLE CARDS ***
Dealt to matiko09 [3s Ac]
adrenalin333: folds 
SoNe1988: folds 
matiko09: folds 
ersevi6: folds 
di0d80: folds 
prominente: raises $2 to $4
13Ghosts: folds 
libbyyww: calls $2
*** FLOP *** [4d 9d Ah]
libbyyww: checks 
prominente: checks 
*** TURN *** [4d 9d Ah] [7s]
libbyyww: checks 
prominente: bets $4
libbyyww: folds 
Uncalled bet ($4) returned to prominente
prominente collected $8.55 from pot
prominente: doesn't show hand 
*** SUMMARY ***
Total pot $9 | Rake $0.45 
Board [4d 9d Ah 7s]
Seat 1: 13Ghosts (small blind) folded before Flop
Seat 2: libbyyww (big blind) folded on the Turn
Seat 3: adrenalin333 folded before Flop (didn't bet)
Seat 4: SoNe1988 folded before Flop (didn't bet)
Seat 5: matiko09 folded before Flop (didn't bet)
Seat 7: ersevi6 folded before Flop (didn't bet)
Seat 8: di0d80 folded before Flop (didn't bet)
Seat 9: prominente (button) collected ($8.55)





PokerStars Hand #152560589996:  Hold'em No Limit ($0.50/$1.00 USD) - 2016/04/28 15:41:10 CET [2016/04/28 9:41:10 ET]
Table 'Bruwer' 9-max Seat #9 is the button
Seat 1: peevoajax ($100 in chips) 
Seat 2: ruslik_by ($40 in chips) 
Seat 3: koksskrt ($141.51 in chips) 
Seat 4: matiko09 ($133.04 in chips) 
Seat 5: Carloszhang ($106.31 in chips) 
Seat 6: I The King I ($100.02 in chips) 
Seat 7: R1aki ($219.16 in chips) 
Seat 8: ozone2003 ($140.53 in chips) 
Seat 9: Dantist1122 ($123.45 in chips) 
peevoajax: posts small blind $0.50
ruslik_by: posts big blind $1
*** HOLE CARDS ***
Dealt to matiko09 [8d 7h]
koksskrt: folds 
matiko09: folds 
Carloszhang: raises $1 to $2
I The King I: folds 
R1aki: folds 
ozone2003: calls $2
Dantist1122: folds 
peevoajax: folds 
ruslik_by: calls $1
*** FLOP *** [7c Jd Qc]
ruslik_by: checks 
Carloszhang: checks 
ozone2003: checks 
*** TURN *** [7c Jd Qc] [8h]
ruslik_by: bets $2.50
Carloszhang: calls $2.50
ozone2003: calls $2.50
*** RIVER *** [7c Jd Qc 8h] [Ac]
ruslik_by: checks 
Carloszhang: checks 
ozone2003: checks 
*** SHOW DOWN ***
ruslik_by: shows [3c Qh] (a pair of Queens)
Carloszhang: shows [2d Ad] (a pair of Aces)
ozone2003: mucks hand 
Carloszhang collected $13.30 from pot
*** SUMMARY ***
Total pot $14 | Rake $0.70 
Board [7c Jd Qc 8h Ac]
Seat 1: peevoajax (small blind) folded before Flop
Seat 2: ruslik_by (big blind) showed [3c Qh] and lost with a pair of Queens
Seat 3: koksskrt folded before Flop (didn't bet)
Seat 4: matiko09 folded before Flop (didn't bet)
Seat 5: Carloszhang showed [2d Ad] and won ($13.30) with a pair of Aces
Seat 6: I The King I folded before Flop (didn't bet)
Seat 7: R1aki folded before Flop (didn't bet)
Seat 8: ozone2003 mucked [Js 9s]
Seat 9: Dantist1122 (button) folded before Flop (didn't bet)





PokerStars Hand #152560594844:  Hold'em No Limit (€0.50/€1.00 EUR) - 2016/04/28 15:41:18 CET [2016/04/28 9:41:18 ET]
Table 'Lumiere II' 9-max Seat #4 is the button
Seat 1: maxxmeister (€108.80 in chips) 
Seat 4: ruslik_by (€49.20 in chips) 
Seat 5: Schmidy7 (€54.55 in chips) 
Seat 6: azzad2007 (€95.50 in chips) 
Seat 7: hammerwife (€108.18 in chips) 
Seat 8: sanpidk (€107.02 in chips) 
Seat 9: matiko09 (€101 in chips) 
Schmidy7: posts small blind €0.50
azzad2007: posts big blind €1
*** HOLE CARDS ***
Dealt to matiko09 [5h Ac]
hammerwife: folds 
sanpidk: folds 
matiko09: folds 
maxxmeister: folds 
ruslik_by: folds 
Schmidy7: calls €0.50
azzad2007: checks 
*** FLOP *** [6c 3d 7c]
Schmidy7: checks 
azzad2007: checks 
*** TURN *** [6c 3d 7c] [9s]
Schmidy7: bets €1.90
azzad2007: folds 
Uncalled bet (€1.90) returned to Schmidy7
Schmidy7 collected €1.90 from pot
*** SUMMARY ***
Total pot €2 | Rake €0.10 
Board [6c 3d 7c 9s]
Seat 1: maxxmeister folded before Flop (didn't bet)
Seat 4: ruslik_by (button) folded before Flop (didn't bet)
Seat 5: Schmidy7 (small blind) collected (€1.90)
Seat 6: azzad2007 (big blind) folded on the Turn
Seat 7: hammerwife folded before Flop (didn't bet)
Seat 8: sanpidk folded before Flop (didn't bet)
Seat 9: matiko09 folded before Flop (didn't bet)





PokerStars Hand #152560597954:  Hold'em No Limit ($0.50/$1.00 USD) - 2016/04/28 15:41:23 CET [2016/04/28 9:41:23 ET]
Table 'Erynia' 9-max Seat #4 is the button
Seat 1: I The King I ($100 in chips) 
Seat 2: matiko09 ($153.68 in chips) 
Seat 3: vilo1070 ($120.57 in chips) 
Seat 4: omorfadramou ($119.10 in chips) 
Seat 5: RMilPoker ($86.50 in chips) 
Seat 6: peevoajax ($100 in chips) 
Seat 7: vrnMike ($113.02 in chips) 
Seat 8: YourKicker78 ($93.79 in chips) 
Seat 9: ruslik_by ($40 in chips) 
RMilPoker: posts small blind $0.50
peevoajax: posts big blind $1
*** HOLE CARDS ***
Dealt to matiko09 [Ah 8h]
vrnMike: folds 
YourKicker78: folds 
ruslik_by: raises $2 to $3
I The King I: folds 
matiko09: folds 
vilo1070: folds 
omorfadramou: folds 
RMilPoker: folds 
peevoajax: folds 
Uncalled bet ($2) returned to ruslik_by
ruslik_by collected $2.50 from pot
ruslik_by: doesn't show hand 
*** SUMMARY ***
Total pot $2.50 | Rake $0 
Seat 1: I The King I folded before Flop (didn't bet)
Seat 2: matiko09 folded before Flop (didn't bet)
Seat 3: vilo1070 folded before Flop (didn't bet)
Seat 4: omorfadramou (button) folded before Flop (didn't bet)
Seat 5: RMilPoker (small blind) folded before Flop
Seat 6: peevoajax (big blind) folded before Flop
Seat 7: vrnMike folded before Flop (didn't bet)
Seat 8: YourKicker78 folded before Flop (didn't bet)
Seat 9: ruslik_by collected ($2.50)





PokerStars Hand #152560607378:  Hold'em No Limit ($0.50/$1.00 USD) - 2016/04/28 15:41:39 CET [2016/04/28 9:41:39 ET]
Table 'Musa II' 9-max Seat #2 is the button
Seat 1: matiko09 ($125.42 in chips) 
Seat 2: ozone2003 ($100 in chips) 
Seat 3: vrnMike ($100 in chips) 
Seat 4: ipashutapkom ($40 in chips) 
Seat 5: thecurv ($102.30 in chips) 
Seat 6: skolombi77 ($83.75 in chips) 
Seat 7: ka100pka527 ($70 in chips) 
Seat 8: darren1031 ($85.22 in chips) 
Seat 9: Moszes360 ($140.08 in chips) 
vrnMike: posts small blind $0.50
ipashutapkom: posts big blind $1
*** HOLE CARDS ***
Dealt to matiko09 [9c 7d]
thecurv: folds 
skolombi77: folds 
ka100pka527: folds 
darren1031: folds 
Moszes360: folds 
matiko09: folds 
ozone2003: folds 
vrnMike: raises $1 to $2
ipashutapkom: calls $1
*** FLOP *** [9d 7h Qh]
vrnMike: bets $2
ipashutapkom: calls $2
*** TURN *** [9d 7h Qh] [Jh]
vrnMike: checks 
ipashutapkom: checks 
*** RIVER *** [9d 7h Qh Jh] [5c]
vrnMike: checks 
ipashutapkom: checks 
*** SHOW DOWN ***
vrnMike: shows [Td Jd] (a pair of Jacks)
ipashutapkom: mucks hand 
vrnMike collected $7.60 from pot
*** SUMMARY ***
Total pot $8 | Rake $0.40 
Board [9d 7h Qh Jh 5c]
Seat 1: matiko09 folded before Flop (didn't bet)
Seat 2: ozone2003 (button) folded before Flop (didn't bet)
Seat 3: vrnMike (small blind) showed [Td Jd] and won ($7.60) with a pair of Jacks
Seat 4: ipashutapkom (big blind) mucked [Kh 9s]
Seat 5: thecurv folded before Flop (didn't bet)
Seat 6: skolombi77 folded before Flop (didn't bet)
Seat 7: ka100pka527 folded before Flop (didn't bet)
Seat 8: darren1031 folded before Flop (didn't bet)
Seat 9: Moszes360 folded before Flop (didn't bet)





PokerStars Hand #152560613777:  Hold'em No Limit ($0.50/$1.00 USD) - 2016/04/28 15:41:49 CET [2016/04/28 9:41:49 ET]
Table 'Agapenor III' 9-max Seat #9 is the button
Seat 1: I The King I ($147.02 in chips) 
Seat 2: cerbisor1 ($92.90 in chips) 
Seat 3: sanpidk ($139.13 in chips) 
Seat 4: matiko09 ($100 in chips) 
Seat 5: maxxmeister ($103.27 in chips) 
Seat 6: azzad2007 ($127.14 in chips) 
Seat 7: tylerz71 ($118.48 in chips) 
Seat 9: Glushchenko ($100 in chips) 
I The King I: posts small blind $0.50
cerbisor1: posts big blind $1
*** HOLE CARDS ***
Dealt to matiko09 [8d 7h]
sanpidk: folds 
Ceanucs leaves the table
St.LaCoste joins the table at seat #8 
matiko09: folds 
maxxmeister: folds 
azzad2007: raises $2 to $3
tylerz71: calls $3
Glushchenko: folds 
St.LaCoste leaves the table
I The King I: raises $11 to $14
cerbisor1: folds 
azzad2007: folds 
tylerz71: folds 
Uncalled bet ($11) returned to I The King I
I The King I collected $10 from pot
I The King I: doesn't show hand 
*** SUMMARY ***
Total pot $10 | Rake $0 
Seat 1: I The King I (small blind) collected ($10)
Seat 2: cerbisor1 (big blind) folded before Flop
Seat 3: sanpidk folded before Flop (didn't bet)
Seat 4: matiko09 folded before Flop (didn't bet)
Seat 5: maxxmeister folded before Flop (didn't bet)
Seat 6: azzad2007 folded before Flop
Seat 7: tylerz71 folded before Flop
Seat 9: Glushchenko (button) folded before Flop (didn't bet)





PokerStars Hand #152560614891:  Hold'em No Limit ($0.50/$1.00 USD) - 2016/04/28 15:41:51 CET [2016/04/28 9:41:51 ET]
Table 'Erynia' 9-max Seat #5 is the button
Seat 1: I The King I ($100 in chips) 
Seat 2: matiko09 ($153.68 in chips) 
Seat 3: vilo1070 ($120.57 in chips) 
Seat 4: omorfadramou ($119.10 in chips) 
Seat 5: RMilPoker ($86 in chips) 
Seat 6: peevoajax ($100 in chips) 
Seat 7: vrnMike ($113.02 in chips) 
Seat 8: YourKicker78 ($93.79 in chips) 
Seat 9: ruslik_by ($41.50 in chips) 
peevoajax: posts small blind $0.50
vrnMike: posts big blind $1
*** HOLE CARDS ***
Dealt to matiko09 [9s 8s]
YourKicker78: folds 
ruslik_by: folds 
I The King I: folds 
matiko09: raises $2 to $3
vilo1070: folds 
omorfadramou: folds 
RMilPoker: folds 
peevoajax: folds 
vrnMike: folds 
Uncalled bet ($2) returned to matiko09
matiko09 collected $2.50 from pot
matiko09: doesn't show hand 
*** SUMMARY ***
Total pot $2.50 | Rake $0 
Seat 1: I The King I folded before Flop (didn't bet)
Seat 2: matiko09 collected ($2.50)
Seat 3: vilo1070 folded before Flop (didn't bet)
Seat 4: omorfadramou folded before Flop (didn't bet)
Seat 5: RMilPoker (button) folded before Flop (didn't bet)
Seat 6: peevoajax (small blind) folded before Flop
Seat 7: vrnMike (big blind) folded before Flop
Seat 8: YourKicker78 folded before Flop (didn't bet)
Seat 9: ruslik_by folded before Flop (didn't bet)





PokerStars Hand #152560620819:  Hold'em No Limit ($1/$2 USD) - 2016/04/28 15:42:01 CET [2016/04/28 9:42:01 ET]
Table 'Sequoia II' 9-max Seat #8 is the button
Seat 1: ersevi6 ($175.07 in chips) 
Seat 2: gudridornot ($221.80 in chips) 
Seat 3: Teddygram902 ($261.70 in chips) 
Seat 4: wiseyoyo ($205.40 in chips) 
Seat 5: matiko09 ($200 in chips) 
Seat 6: Ouga Buga ($205.80 in chips) 
Seat 7: libbyyww ($237.45 in chips) 
Seat 8: CI58 ($200 in chips) 
Seat 9: JustinRuth88 ($177.77 in chips) 
JustinRuth88: posts small blind $1
ersevi6: posts big blind $2
ersevi6: posts the ante $0.40
gudridornot: posts the ante $0.40
Teddygram902: posts the ante $0.40
wiseyoyo: posts the ante $0.40
matiko09: posts the ante $0.40
Ouga Buga: posts the ante $0.40
libbyyww: posts the ante $0.40
CI58: posts the ante $0.40
JustinRuth88: posts the ante $0.40
*** HOLE CARDS ***
Dealt to matiko09 [2c 2h]
gudridornot: folds 
Teddygram902: folds 
wiseyoyo: raises $3 to $5
matiko09: folds 
Ouga Buga: folds 
libbyyww: folds 
CI58: folds 
JustinRuth88: calls $4
ersevi6: calls $3
*** FLOP *** [Qd 2s Jh]
JustinRuth88: checks 
ersevi6: checks 
wiseyoyo: checks 
*** TURN *** [Qd 2s Jh] [6d]
JustinRuth88: bets $8
ersevi6: calls $8
wiseyoyo: folds 
*** RIVER *** [Qd 2s Jh 6d] [3d]
JustinRuth88: bets $14
ersevi6: folds 
Uncalled bet ($14) returned to JustinRuth88
JustinRuth88 collected $32.87 from pot
*** SUMMARY ***
Total pot $34.60 | Rake $1.73 
Board [Qd 2s Jh 6d 3d]
Seat 1: ersevi6 (big blind) folded on the River
Seat 2: gudridornot folded before Flop (didn't bet)
Seat 3: Teddygram902 folded before Flop (didn't bet)
Seat 4: wiseyoyo folded on the Turn
Seat 5: matiko09 folded before Flop (didn't bet)
Seat 6: Ouga Buga folded before Flop (didn't bet)
Seat 7: libbyyww folded before Flop (didn't bet)
Seat 8: CI58 (button) folded before Flop (didn't bet)
Seat 9: JustinRuth88 (small blind) collected ($32.87)





PokerStars Hand #152560624026:  Hold'em No Limit (€0.50/€1.00 EUR) - 2016/04/28 15:42:06 CET [2016/04/28 9:42:06 ET]
Table 'Lumiere II' 9-max Seat #5 is the button
Seat 1: maxxmeister (€108.80 in chips) 
Seat 4: ruslik_by (€49.20 in chips) 
Seat 5: Schmidy7 (€55.45 in chips) 
Seat 6: azzad2007 (€94.50 in chips) 
Seat 7: hammerwife (€108.18 in chips) 
Seat 8: sanpidk (€107.02 in chips) 
Seat 9: matiko09 (€101 in chips) 
azzad2007: posts small blind €0.50
hammerwife: posts big blind €1
*** HOLE CARDS ***
Dealt to matiko09 [Ks 5c]
sanpidk: folds 
matiko09: folds 
maxxmeister: folds 
ruslik_by: raises €1.50 to €2.50
Schmidy7: folds 
azzad2007: folds 
hammerwife: calls €1.50
*** FLOP *** [As 6s 9d]
hammerwife: checks 
ruslik_by: bets €2.50
hammerwife: raises €6.50 to €9
ruslik_by: folds 
Uncalled bet (€6.50) returned to hammerwife
hammerwife collected €9.98 from pot
hammerwife: doesn't show hand 
*** SUMMARY ***
Total pot €10.50 | Rake €0.52 
Board [As 6s 9d]
Seat 1: maxxmeister folded before Flop (didn't bet)
Seat 4: ruslik_by folded on the Flop
Seat 5: Schmidy7 (button) folded before Flop (didn't bet)
Seat 6: azzad2007 (small blind) folded before Flop
Seat 7: hammerwife (big blind) collected (€9.98)
Seat 8: sanpidk folded before Flop (didn't bet)
Seat 9: matiko09 folded before Flop (didn't bet)





PokerStars Hand #152560634308:  Hold'em No Limit ($0.50/$1.00 USD) - 2016/04/28 15:42:23 CET [2016/04/28 9:42:23 ET]
Table 'Erynia' 9-max Seat #6 is the button
Seat 1: I The King I ($100 in chips) 
Seat 2: matiko09 ($155.18 in chips) 
Seat 3: vilo1070 ($120.57 in chips) 
Seat 4: omorfadramou ($119.10 in chips) 
Seat 5: RMilPoker ($86 in chips) 
Seat 6: peevoajax ($100 in chips) 
Seat 7: vrnMike ($112.02 in chips) 
Seat 8: YourKicker78 ($93.79 in chips) 
Seat 9: ruslik_by ($41.50 in chips) 
vrnMike: posts small blind $0.50
YourKicker78: posts big blind $1
*** HOLE CARDS ***
Dealt to matiko09 [6s Js]
ruslik_by: folds 
I The King I: raises $2 to $3
matiko09: folds 
vilo1070: folds 
omorfadramou: folds 
RMilPoker: folds 
peevoajax: folds 
vrnMike: folds 
YourKicker78: calls $2
*** FLOP *** [9s Tc 3h]
YourKicker78: checks 
I The King I: bets $4
YourKicker78: raises $4 to $8
I The King I: calls $4
*** TURN *** [9s Tc 3h] [Ts]
YourKicker78: checks 
I The King I: checks 
*** RIVER *** [9s Tc 3h Ts] [2s]
YourKicker78: bets $12
I The King I: folds 
Uncalled bet ($12) returned to YourKicker78
YourKicker78 collected $21.38 from pot
YourKicker78: doesn't show hand 
*** SUMMARY ***
Total pot $22.50 | Rake $1.12 
Board [9s Tc 3h Ts 2s]
Seat 1: I The King I folded on the River
Seat 2: matiko09 folded before Flop (didn't bet)
Seat 3: vilo1070 folded before Flop (didn't bet)
Seat 4: omorfadramou folded before Flop (didn't bet)
Seat 5: RMilPoker folded before Flop (didn't bet)
Seat 6: peevoajax (button) folded before Flop (didn't bet)
Seat 7: vrnMike (small blind) folded before Flop
Seat 8: YourKicker78 (big blind) collected ($21.38)
Seat 9: ruslik_by folded before Flop (didn't bet)





PokerStars Hand #152560638202:  Hold'em No Limit ($1/$2 USD) - 2016/04/28 15:42:30 CET [2016/04/28 9:42:30 ET]
Table 'Idomeneus II' 9-max Seat #1 is the button
Seat 1: 13Ghosts ($241.69 in chips) 
Seat 2: libbyyww ($406.61 in chips) 
Seat 3: adrenalin333 ($143.35 in chips) 
Seat 4: SoNe1988 ($80 in chips) 
Seat 5: matiko09 ($220.82 in chips) 
Seat 7: ersevi6 ($225.03 in chips) 
Seat 8: di0d80 ($227.29 in chips) 
Seat 9: prominente ($204.55 in chips) 
libbyyww: posts small blind $1
adrenalin333: posts big blind $2
peevoajax: sits out 
*** HOLE CARDS ***
Dealt to matiko09 [5c 2h]
SoNe1988: folds 
SoNe1988 leaves the table
wiseyoyo joins the table at seat #4 
matiko09: folds 
ersevi6: raises $3 to $5
di0d80: calls $5
prominente is connected 
prominente: folds 
13Ghosts: folds 
libbyyww: folds 
adrenalin333: raises $11 to $16
ersevi6: folds 
di0d80: calls $11
*** FLOP *** [Jd 5h 7h]
adrenalin333: bets $24
di0d80: calls $24
*** TURN *** [Jd 5h 7h] [6c]
adrenalin333: bets $36
di0d80: raises $151.29 to $187.29 and is all-in
adrenalin333: folds 
Uncalled bet ($151.29) returned to di0d80
di0d80 collected $155.25 from pot
di0d80: doesn't show hand 
*** SUMMARY ***
Total pot $158 | Rake $2.75 
Board [Jd 5h 7h 6c]
Seat 1: 13Ghosts (button) folded before Flop (didn't bet)
Seat 2: libbyyww (small blind) folded before Flop
Seat 3: adrenalin333 (big blind) folded on the Turn
Seat 4: SoNe1988 folded before Flop (didn't bet)
Seat 5: matiko09 folded before Flop (didn't bet)
Seat 7: ersevi6 folded before Flop
Seat 8: di0d80 collected ($155.25)
Seat 9: prominente folded before Flop (didn't bet)





PokerStars Hand #152560647797:  Hold'em No Limit ($0.50/$1.00 USD) - 2016/04/28 15:42:45 CET [2016/04/28 9:42:45 ET]
Table 'Agapenor III' 9-max Seat #1 is the button
Seat 1: I The King I ($154.02 in chips) 
Seat 2: cerbisor1 ($91.90 in chips) 
Seat 3: sanpidk ($139.13 in chips) 
Seat 4: matiko09 ($100 in chips) 
Seat 5: maxxmeister ($103.27 in chips) 
Seat 6: azzad2007 ($124.14 in chips) 
Seat 7: tylerz71 ($115.48 in chips) 
Seat 9: Glushchenko ($100 in chips) 
cerbisor1: posts small blind $0.50
sanpidk: posts big blind $1
*** HOLE CARDS ***
Dealt to matiko09 [4h 9d]
matiko09: folds 
maxxmeister: folds 
azzad2007: folds 
tylerz71: folds 
Glushchenko: raises $1.50 to $2.50
I The King I: folds 
cerbisor1: folds 
sanpidk: folds 
Uncalled bet ($1.50) returned to Glushchenko
Glushchenko collected $2.50 from pot
*** SUMMARY ***
Total pot $2.50 | Rake $0 
Seat 1: I The King I (button) folded before Flop (didn't bet)
Seat 2: cerbisor1 (small blind) folded before Flop
Seat 3: sanpidk (big blind) folded before Flop
Seat 4: matiko09 folded before Flop (didn't bet)
Seat 5: maxxmeister folded before Flop (didn't bet)
Seat 6: azzad2007 folded before Flop (didn't bet)
Seat 7: tylerz71 folded before Flop (didn't bet)
Seat 9: Glushchenko collected ($2.50)





PokerStars Hand #152560652980:  Hold'em No Limit ($0.50/$1.00 USD) - 2016/04/28 15:42:54 CET [2016/04/28 9:42:54 ET]
Table 'Musa II' 9-max Seat #3 is the button
Seat 1: matiko09 ($125.42 in chips) 
Seat 2: ozone2003 ($100 in chips) 
Seat 3: vrnMike ($103.60 in chips) 
Seat 4: ipashutapkom ($40 in chips) 
Seat 5: thecurv ($102.30 in chips) 
Seat 6: skolombi77 ($83.75 in chips) 
Seat 7: ka100pka527 ($70 in chips) 
Seat 8: darren1031 ($85.22 in chips) 
Seat 9: Moszes360 ($140.08 in chips) 
ipashutapkom: posts small blind $0.50
thecurv: posts big blind $1
*** HOLE CARDS ***
Dealt to matiko09 [7c 2c]
skolombi77: folds 
ka100pka527: folds 
darren1031: folds 
Moszes360: folds 
matiko09: folds 
ozone2003: folds 
vrnMike: folds 
ipashutapkom: raises $1.26 to $2.26
thecurv: calls $1.26
*** FLOP *** [7s 9s Qh]
ipashutapkom: checks 
thecurv: checks 
*** TURN *** [7s 9s Qh] [Th]
ipashutapkom: bets $2.87
thecurv: calls $2.87
*** RIVER *** [7s 9s Qh Th] [Ah]
ipashutapkom: bets $6.53
thecurv: folds 
Uncalled bet ($6.53) returned to ipashutapkom
ipashutapkom collected $9.75 from pot
ipashutapkom: doesn't show hand 
*** SUMMARY ***
Total pot $10.26 | Rake $0.51 
Board [7s 9s Qh Th Ah]
Seat 1: matiko09 folded before Flop (didn't bet)
Seat 2: ozone2003 folded before Flop (didn't bet)
Seat 3: vrnMike (button) folded before Flop (didn't bet)
Seat 4: ipashutapkom (small blind) collected ($9.75)
Seat 5: thecurv (big blind) folded on the River
Seat 6: skolombi77 folded before Flop (didn't bet)
Seat 7: ka100pka527 folded before Flop (didn't bet)
Seat 8: darren1031 folded before Flop (didn't bet)
Seat 9: Moszes360 folded before Flop (didn't bet)





PokerStars Hand #152560657481:  Hold'em No Limit ($0.50/$1.00 USD) - 2016/04/28 15:43:01 CET [2016/04/28 9:43:01 ET]
Table 'Bruwer' 9-max Seat #1 is the button
Seat 1: peevoajax ($100 in chips) 
Seat 2: ruslik_by ($40 in chips) 
Seat 3: koksskrt ($141.51 in chips) 
Seat 4: matiko09 ($133.04 in chips) 
Seat 5: Carloszhang ($115.11 in chips) 
Seat 6: I The King I ($100.02 in chips) 
Seat 7: R1aki ($219.16 in chips) 
Seat 8: ozone2003 ($136.03 in chips) 
Seat 9: Dantist1122 ($123.45 in chips) 
ruslik_by: posts small blind $0.50
koksskrt: posts big blind $1
*** HOLE CARDS ***
Dealt to matiko09 [Jh 4c]
matiko09: folds 
Carloszhang: raises $1 to $2
I The King I: folds 
R1aki: folds 
ozone2003: folds 
Dantist1122: folds 
peevoajax: folds 
ruslik_by: folds 
koksskrt: calls $1
*** FLOP *** [Kd Ad 8d]
koksskrt: checks 
Carloszhang: bets $4
koksskrt: folds 
Uncalled bet ($4) returned to Carloszhang
Carloszhang collected $4.28 from pot
*** SUMMARY ***
Total pot $4.50 | Rake $0.22 
Board [Kd Ad 8d]
Seat 1: peevoajax (button) folded before Flop (didn't bet)
Seat 2: ruslik_by (small blind) folded before Flop
Seat 3: koksskrt (big blind) folded on the Flop
Seat 4: matiko09 folded before Flop (didn't bet)
Seat 5: Carloszhang collected ($4.28)
Seat 6: I The King I folded before Flop (didn't bet)
Seat 7: R1aki folded before Flop (didn't bet)
Seat 8: ozone2003 folded before Flop (didn't bet)
Seat 9: Dantist1122 folded before Flop (didn't bet)





PokerStars Hand #152560668934:  Hold'em No Limit (€0.50/€1.00 EUR) - 2016/04/28 15:43:20 CET [2016/04/28 9:43:20 ET]
Table 'Lumiere II' 9-max Seat #6 is the button
Seat 1: maxxmeister (€108.80 in chips) 
Seat 4: ruslik_by (€44.20 in chips) 
Seat 5: Schmidy7 (€55.45 in chips) 
Seat 6: azzad2007 (€94 in chips) 
Seat 7: hammerwife (€113.16 in chips) 
Seat 8: sanpidk (€107.02 in chips) 
Seat 9: matiko09 (€101 in chips) 
hammerwife: posts small blind €0.50
sanpidk: posts big blind €1
*** HOLE CARDS ***
Dealt to matiko09 [8c 4d]
matiko09: folds 
maxxmeister: folds 
ruslik_by: folds 
Schmidy7: folds 
azzad2007: folds 
hammerwife: folds 
Uncalled bet (€0.50) returned to sanpidk
sanpidk collected €1 from pot
sanpidk: doesn't show hand 
*** SUMMARY ***
Total pot €1 | Rake €0 
Seat 1: maxxmeister folded before Flop (didn't bet)
Seat 4: ruslik_by folded before Flop (didn't bet)
Seat 5: Schmidy7 folded before Flop (didn't bet)
Seat 6: azzad2007 (button) folded before Flop (didn't bet)
Seat 7: hammerwife (small blind) folded before Flop
Seat 8: sanpidk (big blind) collected (€1)
Seat 9: matiko09 folded before Flop (didn't bet)





PokerStars Hand #152560672458:  Hold'em No Limit ($0.50/$1.00 USD) - 2016/04/28 15:43:26 CET [2016/04/28 9:43:26 ET]
Table 'Erynia' 9-max Seat #7 is the button
Seat 1: I The King I ($100 in chips) 
Seat 2: matiko09 ($155.18 in chips) 
Seat 3: vilo1070 ($120.57 in chips) 
Seat 4: omorfadramou ($119.10 in chips) 
Seat 5: RMilPoker ($86 in chips) 
Seat 6: peevoajax ($100 in chips) 
Seat 7: vrnMike ($111.52 in chips) 
Seat 8: YourKicker78 ($104.17 in chips) 
Seat 9: ruslik_by ($41.50 in chips) 
YourKicker78: posts small blind $0.50
ruslik_by: posts big blind $1
*** HOLE CARDS ***
Dealt to matiko09 [Kd Jh]
I The King I: folds 
matiko09: folds 
vilo1070: folds 
omorfadramou: folds 
RMilPoker: folds 
peevoajax: folds 
vrnMike: raises $2 to $3
YourKicker78: folds 
ruslik_by: folds 
Uncalled bet ($2) returned to vrnMike
vrnMike collected $2.50 from pot
*** SUMMARY ***
Total pot $2.50 | Rake $0 
Seat 1: I The King I folded before Flop (didn't bet)
Seat 2: matiko09 folded before Flop (didn't bet)
Seat 3: vilo1070 folded before Flop (didn't bet)
Seat 4: omorfadramou folded before Flop (didn't bet)
Seat 5: RMilPoker folded before Flop (didn't bet)
Seat 6: peevoajax folded before Flop (didn't bet)
Seat 7: vrnMike (button) collected ($2.50)
Seat 8: YourKicker78 (small blind) folded before Flop
Seat 9: ruslik_by (big blind) folded before Flop





PokerStars Hand #152560674665:  Hold'em No Limit ($1/$2 USD) - 2016/04/28 15:43:30 CET [2016/04/28 9:43:30 ET]
Table 'Sequoia II' 9-max Seat #9 is the button
Seat 1: ersevi6 ($161.67 in chips) 
Seat 2: gudridornot ($221.40 in chips) 
Seat 3: Teddygram902 ($261.30 in chips) 
Seat 4: wiseyoyo ($200 in chips) 
Seat 5: matiko09 ($200 in chips) 
Seat 6: Ouga Buga ($205.40 in chips) 
Seat 7: libbyyww ($237.05 in chips) 
Seat 8: CI58 ($200 in chips) 
Seat 9: JustinRuth88 ($197.24 in chips) 
ersevi6: posts small blind $1
gudridornot: posts big blind $2
ersevi6: posts the ante $0.40
gudridornot: posts the ante $0.40
Teddygram902: posts the ante $0.40
wiseyoyo: posts the ante $0.40
matiko09: posts the ante $0.40
Ouga Buga: posts the ante $0.40
libbyyww: posts the ante $0.40
CI58: posts the ante $0.40
JustinRuth88: posts the ante $0.40
*** HOLE CARDS ***
Dealt to matiko09 [6h 5s]
Teddygram902: folds 
wiseyoyo: folds 
matiko09: folds 
Ouga Buga: folds 
libbyyww: folds 
CI58: folds 
JustinRuth88: folds 
ersevi6: folds 
Uncalled bet ($1) returned to gudridornot
gudridornot collected $5.60 from pot
gudridornot: doesn't show hand 
*** SUMMARY ***
Total pot $5.60 | Rake $0 
Seat 1: ersevi6 (small blind) folded before Flop
Seat 2: gudridornot (big blind) collected ($5.60)
Seat 3: Teddygram902 folded before Flop (didn't bet)
Seat 4: wiseyoyo folded before Flop (didn't bet)
Seat 5: matiko09 folded before Flop (didn't bet)
Seat 6: Ouga Buga folded before Flop (didn't bet)
Seat 7: libbyyww folded before Flop (didn't bet)
Seat 8: CI58 folded before Flop (didn't bet)
Seat 9: JustinRuth88 (button) folded before Flop (didn't bet)





PokerStars Hand #152560694471:  Hold'em No Limit ($0.50/$1.00 USD) - 2016/04/28 15:44:02 CET [2016/04/28 9:44:02 ET]
Table 'Erynia' 9-max Seat #8 is the button
Seat 1: I The King I ($100 in chips) 
Seat 2: matiko09 ($155.18 in chips) 
Seat 3: vilo1070 ($120.57 in chips) 
Seat 4: omorfadramou ($119.10 in chips) 
Seat 5: RMilPoker ($86 in chips) 
Seat 6: peevoajax ($100 in chips) 
Seat 7: vrnMike ($113.02 in chips) 
Seat 8: YourKicker78 ($103.67 in chips) 
Seat 9: ruslik_by ($40.50 in chips) 
ruslik_by: posts small blind $0.50
I The King I: posts big blind $1
*** HOLE CARDS ***
Dealt to matiko09 [6h Qs]
matiko09: folds 
vilo1070: folds 
omorfadramou: folds 
RMilPoker: folds 
peevoajax: folds 
vrnMike: folds 
YourKicker78: folds 
ruslik_by: raises $2 to $3
I The King I: folds 
Uncalled bet ($2) returned to ruslik_by
ruslik_by collected $2 from pot
ruslik_by: doesn't show hand 
*** SUMMARY ***
Total pot $2 | Rake $0 
Seat 1: I The King I (big blind) folded before Flop
Seat 2: matiko09 folded before Flop (didn't bet)
Seat 3: vilo1070 folded before Flop (didn't bet)
Seat 4: omorfadramou folded before Flop (didn't bet)
Seat 5: RMilPoker folded before Flop (didn't bet)
Seat 6: peevoajax folded before Flop (didn't bet)
Seat 7: vrnMike folded before Flop (didn't bet)
Seat 8: YourKicker78 (button) folded before Flop (didn't bet)
Seat 9: ruslik_by (small blind) collected ($2)





PokerStars Hand #152560696176:  Hold'em No Limit ($0.50/$1.00 USD) - 2016/04/28 15:44:05 CET [2016/04/28 9:44:05 ET]
Table 'Musa II' 9-max Seat #4 is the button
Seat 1: matiko09 ($125.42 in chips) 
Seat 2: ozone2003 ($100 in chips) 
Seat 3: vrnMike ($103.60 in chips) 
Seat 4: ipashutapkom ($44.62 in chips) 
Seat 5: thecurv ($100 in chips) 
Seat 6: skolombi77 ($83.75 in chips) 
Seat 7: ka100pka527 ($70 in chips) 
Seat 8: darren1031 ($85.22 in chips) 
Seat 9: Moszes360 ($140.08 in chips) 
thecurv: posts small blind $0.50
skolombi77: posts big blind $1
*** HOLE CARDS ***
Dealt to matiko09 [2d As]
ka100pka527: folds 
darren1031: folds 
Moszes360: folds 
matiko09: folds 
ozone2003: folds 
vrnMike: folds 
ipashutapkom: folds 
thecurv: calls $0.50
skolombi77: raises $3 to $4
thecurv: folds 
Uncalled bet ($3) returned to skolombi77
skolombi77 collected $2 from pot
skolombi77: doesn't show hand 
*** SUMMARY ***
Total pot $2 | Rake $0 
Seat 1: matiko09 folded before Flop (didn't bet)
Seat 2: ozone2003 folded before Flop (didn't bet)
Seat 3: vrnMike folded before Flop (didn't bet)
Seat 4: ipashutapkom (button) folded before Flop (didn't bet)
Seat 5: thecurv (small blind) folded before Flop
Seat 6: skolombi77 (big blind) collected ($2)
Seat 7: ka100pka527 folded before Flop (didn't bet)
Seat 8: darren1031 folded before Flop (didn't bet)
Seat 9: Moszes360 folded before Flop (didn't bet)





PokerStars Hand #152560700643:  Hold'em No Limit ($1/$2 USD) - 2016/04/28 15:44:12 CET [2016/04/28 9:44:12 ET]
Table 'Sequoia II' 9-max Seat #1 is the button
Seat 1: ersevi6 ($160.27 in chips) 
Seat 2: gudridornot ($225.60 in chips) 
Seat 3: Teddygram902 ($260.90 in chips) 
Seat 4: wiseyoyo ($200 in chips) 
Seat 5: matiko09 ($200 in chips) 
Seat 6: Ouga Buga ($205 in chips) 
Seat 7: libbyyww ($236.65 in chips) 
Seat 8: CI58 ($200 in chips) 
Seat 9: JustinRuth88 ($196.84 in chips) 
gudridornot: posts small blind $1
Teddygram902: posts big blind $2
ersevi6: posts the ante $0.40
gudridornot: posts the ante $0.40
Teddygram902: posts the ante $0.40
wiseyoyo: posts the ante $0.40
matiko09: posts the ante $0.40
Ouga Buga: posts the ante $0.40
libbyyww: posts the ante $0.40
CI58: posts the ante $0.40
JustinRuth88: posts the ante $0.40
*** HOLE CARDS ***
Dealt to matiko09 [4d 3h]
wiseyoyo: folds 
matiko09: folds 
Ouga Buga: folds 
libbyyww: folds 
CI58: folds 
JustinRuth88: folds 
ersevi6: raises $4 to $6
gudridornot: folds 
Teddygram902: folds 
Uncalled bet ($4) returned to ersevi6
ersevi6 collected $8.60 from pot
ersevi6: doesn't show hand 
*** SUMMARY ***
Total pot $8.60 | Rake $0 
Seat 1: ersevi6 (button) collected ($8.60)
Seat 2: gudridornot (small blind) folded before Flop
Seat 3: Teddygram902 (big blind) folded before Flop
Seat 4: wiseyoyo folded before Flop (didn't bet)
Seat 5: matiko09 folded before Flop (didn't bet)
Seat 6: Ouga Buga folded before Flop (didn't bet)
Seat 7: libbyyww folded before Flop (didn't bet)
Seat 8: CI58 folded before Flop (didn't bet)
Seat 9: JustinRuth88 folded before Flop (didn't bet)





PokerStars Hand #152560708799:  Hold'em No Limit ($1/$2 USD) - 2016/04/28 15:44:26 CET [2016/04/28 9:44:26 ET]
Table 'Idomeneus II' 9-max Seat #2 is the button
Seat 1: 13Ghosts ($241.69 in chips) 
Seat 2: libbyyww ($405.61 in chips) 
Seat 3: adrenalin333 ($67.35 in chips) 
Seat 4: wiseyoyo ($200 in chips) 
Seat 5: matiko09 ($220.82 in chips) 
Seat 7: ersevi6 ($220.03 in chips) 
Seat 8: di0d80 ($306.54 in chips) 
Seat 9: prominente ($204.55 in chips) 
adrenalin333: posts small blind $1
wiseyoyo: posts big blind $2
peevoajax: sits out 
*** HOLE CARDS ***
Dealt to matiko09 [6h Js]
matiko09: folds 
ersevi6: folds 
di0d80: folds 
prominente: raises $3 to $5
13Ghosts: folds 
libbyyww: folds 
adrenalin333: calls $4
wiseyoyo: raises $17 to $22
prominente: folds 
adrenalin333: calls $17
*** FLOP *** [7d Tc Qs]
adrenalin333: bets $45.35 and is all-in
wiseyoyo: calls $45.35
*** TURN *** [7d Tc Qs] [Jc]
*** RIVER *** [7d Tc Qs Jc] [Qd]
*** SHOW DOWN ***
adrenalin333: shows [4h Th] (two pair, Queens and Tens)
wiseyoyo: shows [Kc Kh] (two pair, Kings and Queens)
wiseyoyo collected $136.95 from pot
*** SUMMARY ***
Total pot $139.70 | Rake $2.75 
Board [7d Tc Qs Jc Qd]
Seat 1: 13Ghosts folded before Flop (didn't bet)
Seat 2: libbyyww (button) folded before Flop (didn't bet)
Seat 3: adrenalin333 (small blind) showed [4h Th] and lost with two pair, Queens and Tens
Seat 4: wiseyoyo (big blind) showed [Kc Kh] and won ($136.95) with two pair, Kings and Queens
Seat 5: matiko09 folded before Flop (didn't bet)
Seat 7: ersevi6 folded before Flop (didn't bet)
Seat 8: di0d80 folded before Flop (didn't bet)
Seat 9: prominente folded before Flop





PokerStars Hand #152560736898:  Hold'em No Limit ($1/$2 USD) - 2016/04/28 15:45:12 CET [2016/04/28 9:45:12 ET]
Table 'Sequoia II' 9-max Seat #2 is the button
Seat 1: ersevi6 ($166.47 in chips) 
Seat 2: gudridornot ($224.20 in chips) 
Seat 3: Teddygram902 ($258.50 in chips) 
Seat 4: wiseyoyo ($200 in chips) 
Seat 5: matiko09 ($200 in chips) 
Seat 6: Ouga Buga ($204.60 in chips) 
Seat 7: libbyyww ($236.25 in chips) 
Seat 8: CI58 ($200 in chips) 
Seat 9: JustinRuth88 ($196.44 in chips) 
Teddygram902: posts small blind $1
wiseyoyo: posts big blind $2
ersevi6: posts the ante $0.40
gudridornot: posts the ante $0.40
Teddygram902: posts the ante $0.40
wiseyoyo: posts the ante $0.40
matiko09: posts the ante $0.40
Ouga Buga: posts the ante $0.40
libbyyww: posts the ante $0.40
CI58: posts the ante $0.40
JustinRuth88: posts the ante $0.40
*** HOLE CARDS ***
Dealt to matiko09 [Jd Kh]
matiko09: folds 
Ouga Buga: folds 
libbyyww: folds 
CI58: raises $4 to $6
JustinRuth88: folds 
ersevi6: folds 
gudridornot: calls $6
Teddygram902: folds 
wiseyoyo: calls $4
*** FLOP *** [Qs 4d 9h]
wiseyoyo: checks 
CI58: bets $10.73
gudridornot: calls $10.73
wiseyoyo: folds 
*** TURN *** [Qs 4d 9h] [2d]
CI58: checks 
gudridornot: bets $24
CI58: raises $24 to $48
gudridornot: calls $24
*** RIVER *** [Qs 4d 9h 2d] [4h]
CI58: bets $68.65
gudridornot: calls $68.65
*** SHOW DOWN ***
CI58: shows [Kd Kc] (two pair, Kings and Fours)
gudridornot: mucks hand 
CI58 collected $274.61 from pot
*** SUMMARY ***
Total pot $277.36 | Rake $2.75 
Board [Qs 4d 9h 2d 4h]
Seat 1: ersevi6 folded before Flop (didn't bet)
Seat 2: gudridornot (button) mucked [Qh 6h]
Seat 3: Teddygram902 (small blind) folded before Flop
Seat 4: wiseyoyo (big blind) folded on the Flop
Seat 5: matiko09 folded before Flop (didn't bet)
Seat 6: Ouga Buga folded before Flop (didn't bet)
Seat 7: libbyyww folded before Flop (didn't bet)
Seat 8: CI58 showed [Kd Kc] and won ($274.61) with two pair, Kings and Fours
Seat 9: JustinRuth88 folded before Flop (didn't bet)





PokerStars Hand #152560744788:  Hold'em No Limit ($1/$2 USD) - 2016/04/28 15:45:25 CET [2016/04/28 9:45:25 ET]
Table 'Idomeneus II' 9-max Seat #4 is the button
Seat 1: 13Ghosts ($241.69 in chips) 
Seat 2: libbyyww ($405.61 in chips) 
Seat 4: wiseyoyo ($269.60 in chips) 
Seat 5: matiko09 ($220.82 in chips) 
Seat 6: peevoajax ($200 in chips) 
Seat 7: ersevi6 ($220.03 in chips) 
Seat 8: di0d80 ($306.54 in chips) 
Seat 9: prominente ($200 in chips) 
matiko09: posts small blind $1
peevoajax: posts big blind $2
*** HOLE CARDS ***
Dealt to matiko09 [2s 3h]
ersevi6: folds 
di0d80: folds 
prominente: raises $3 to $5
13Ghosts: folds 
adrenalin333 leaves the table
libbyyww: calls $5
wiseyoyo: folds 
I The King I joins the table at seat #3 
I The King I leaves the table
matiko09: folds 
peevoajax: folds 
*** FLOP *** [4s As Ac]
Iggso joins the table at seat #3 
Iggso leaves the table
prominente: checks 
libbyyww: bets $7.41
prominente: calls $7.41
*** TURN *** [4s As Ac] [8s]
prominente: bets $17.61
libbyyww: calls $17.61
*** RIVER *** [4s As Ac 8s] [Jh]
prominente: checks 
libbyyww: checks 
*** SHOW DOWN ***
prominente: shows [9s 9h] (two pair, Aces and Nines)
libbyyww: shows [Qs Ad] (three of a kind, Aces)
libbyyww collected $60.29 from pot
*** SUMMARY ***
Total pot $63.04 | Rake $2.75 
Board [4s As Ac 8s Jh]
Seat 1: 13Ghosts folded before Flop (didn't bet)
Seat 2: libbyyww showed [Qs Ad] and won ($60.29) with three of a kind, Aces
Seat 4: wiseyoyo (button) folded before Flop (didn't bet)
Seat 5: matiko09 (small blind) folded before Flop
Seat 6: peevoajax (big blind) folded before Flop
Seat 7: ersevi6 folded before Flop (didn't bet)
Seat 8: di0d80 folded before Flop (didn't bet)
Seat 9: prominente showed [9s 9h] and lost with two pair, Aces and Nines





PokerStars Hand #152560752728:  Hold'em No Limit ($0.50/$1.00 USD) - 2016/04/28 15:45:38 CET [2016/04/28 9:45:38 ET]
Table 'Musa II' 9-max Seat #5 is the button
Seat 1: matiko09 ($125.42 in chips) 
Seat 2: ozone2003 ($100 in chips) 
Seat 3: vrnMike ($103.60 in chips) 
Seat 4: ipashutapkom ($44.62 in chips) 
Seat 5: thecurv ($100 in chips) 
Seat 6: skolombi77 ($84.75 in chips) 
Seat 7: ka100pka527 ($70 in chips) 
Seat 8: darren1031 ($85.22 in chips) 
Seat 9: Moszes360 ($140.08 in chips) 
skolombi77: posts small blind $0.50
ka100pka527: posts big blind $1
*** HOLE CARDS ***
Dealt to matiko09 [Ac 3c]
darren1031: folds 
Moszes360: folds 
matiko09: folds 
ozone2003: raises $2 to $3
vrnMike: folds 
ipashutapkom: folds 
thecurv: folds 
skolombi77: folds 
ka100pka527: folds 
Uncalled bet ($2) returned to ozone2003
ozone2003 collected $2.50 from pot
ozone2003: doesn't show hand 
*** SUMMARY ***
Total pot $2.50 | Rake $0 
Seat 1: matiko09 folded before Flop (didn't bet)
Seat 2: ozone2003 collected ($2.50)
Seat 3: vrnMike folded before Flop (didn't bet)
Seat 4: ipashutapkom folded before Flop (didn't bet)
Seat 5: thecurv (button) folded before Flop (didn't bet)
Seat 6: skolombi77 (small blind) folded before Flop
Seat 7: ka100pka527 (big blind) folded before Flop
Seat 8: darren1031 folded before Flop (didn't bet)
Seat 9: Moszes360 folded before Flop (didn't bet)





PokerStars Hand #152560775805:  Hold'em No Limit ($0.50/$1.00 USD) - 2016/04/28 15:46:16 CET [2016/04/28 9:46:16 ET]
Table 'Musa II' 9-max Seat #6 is the button
Seat 1: matiko09 ($125.42 in chips) 
Seat 2: ozone2003 ($101.50 in chips) 
Seat 3: vrnMike ($103.60 in chips) 
Seat 4: ipashutapkom ($44.62 in chips) 
Seat 5: thecurv ($100 in chips) 
Seat 6: skolombi77 ($84.25 in chips) 
Seat 7: ka100pka527 ($69 in chips) 
Seat 8: darren1031 ($85.22 in chips) 
Seat 9: Moszes360 ($140.08 in chips) 
ka100pka527: posts small blind $0.50
darren1031: posts big blind $1
*** HOLE CARDS ***
Dealt to matiko09 [7c Jd]
Moszes360: folds 
matiko09: folds 
ozone2003: folds 
vrnMike: folds 
ipashutapkom: folds 
thecurv: folds 
skolombi77 has timed out
skolombi77: folds 
ka100pka527: raises $2 to $3
darren1031: calls $2
*** FLOP *** [5h Ts Js]
ka100pka527: checks 
darren1031: bets $3
ka100pka527: folds 
Uncalled bet ($3) returned to darren1031
darren1031 collected $5.70 from pot
darren1031: doesn't show hand 
*** SUMMARY ***
Total pot $6 | Rake $0.30 
Board [5h Ts Js]
Seat 1: matiko09 folded before Flop (didn't bet)
Seat 2: ozone2003 folded before Flop (didn't bet)
Seat 3: vrnMike folded before Flop (didn't bet)
Seat 4: ipashutapkom folded before Flop (didn't bet)
Seat 5: thecurv folded before Flop (didn't bet)
Seat 6: skolombi77 (button) folded before Flop (didn't bet)
Seat 7: ka100pka527 (small blind) folded on the Flop
Seat 8: darren1031 (big blind) collected ($5.70)
Seat 9: Moszes360 folded before Flop (didn't bet)





PokerStars Hand #152560828707:  Hold'em No Limit ($1/$2 USD) - 2016/04/28 15:47:27 CET [2016/04/28 9:47:27 ET]
Table 'Idomeneus II' 9-max Seat #5 is the button
Seat 1: 13Ghosts ($241.69 in chips) 
Seat 2: libbyyww ($435.88 in chips) 
Seat 4: wiseyoyo ($269.60 in chips) 
Seat 5: matiko09 ($219.82 in chips) 
Seat 6: peevoajax ($200 in chips) 
Seat 8: di0d80 ($306.54 in chips) 
Seat 9: prominente ($200 in chips) 
peevoajax: posts small blind $1
ersevi6: is sitting out 
ersevi6 leaves the table
di0d80: posts big blind $2
*** HOLE CARDS ***
Dealt to matiko09 [Qh Kd]
prominente: folds 
prominente leaves the table
Ouga Buga joins the table at seat #3 
13Ghosts: folds 
libbyyww: folds 
wiseyoyo: raises $2.42 to $4.42
matiko09: raises $10.58 to $15
13Ghosts leaves the table
peevoajax: folds 
di0d80: folds 
wiseyoyo: folds 
Uncalled bet ($10.58) returned to matiko09
matiko09 collected $11.84 from pot
matiko09: doesn't show hand 
*** SUMMARY ***
Total pot $11.84 | Rake $0 
Seat 1: 13Ghosts folded before Flop (didn't bet)
Seat 2: libbyyww folded before Flop (didn't bet)
Seat 4: wiseyoyo folded before Flop
Seat 5: matiko09 (button) collected ($11.84)
Seat 6: peevoajax (small blind) folded before Flop
Seat 8: di0d80 (big blind) folded before Flop
Seat 9: prominente folded before Flop (didn't bet)





PokerStars Hand #152560844957:  Hold'em No Limit ($0.50/$1.00 USD) - 2016/04/28 15:47:47 CET [2016/04/28 9:47:47 ET]
Table 'Musa II' 9-max Seat #7 is the button
Seat 1: matiko09 ($125.42 in chips) 
Seat 2: ozone2003 ($101.50 in chips) 
Seat 3: vrnMike ($103.60 in chips) 
Seat 4: ipashutapkom ($44.62 in chips) 
Seat 5: thecurv ($100 in chips) 
Seat 6: skolombi77 ($84.25 in chips) 
Seat 7: ka100pka527 ($66 in chips) 
Seat 8: darren1031 ($87.92 in chips) 
Seat 9: Moszes360 ($140.08 in chips) 
darren1031: posts small blind $0.50
Moszes360: posts big blind $1
*** HOLE CARDS ***
Dealt to matiko09 [6h 6s]
matiko09: folds 
ozone2003: folds 
vrnMike: folds 
ipashutapkom: folds 
thecurv: folds 
skolombi77: folds 
ka100pka527: raises $1 to $2
darren1031: folds 
Moszes360: calls $1
*** FLOP *** [6c Js Ts]
Moszes360: checks 
ka100pka527: checks 
*** TURN *** [6c Js Ts] [4c]
Moszes360: bets $2.82
ka100pka527: raises $6.61 to $9.43
Moszes360: folds 
Uncalled bet ($6.61) returned to ka100pka527
ka100pka527 collected $9.63 from pot
ka100pka527: doesn't show hand 
*** SUMMARY ***
Total pot $10.14 | Rake $0.51 
Board [6c Js Ts 4c]
Seat 1: matiko09 folded before Flop (didn't bet)
Seat 2: ozone2003 folded before Flop (didn't bet)
Seat 3: vrnMike folded before Flop (didn't bet)
Seat 4: ipashutapkom folded before Flop (didn't bet)
Seat 5: thecurv folded before Flop (didn't bet)
Seat 6: skolombi77 folded before Flop (didn't bet)
Seat 7: ka100pka527 (button) collected ($9.63)
Seat 8: darren1031 (small blind) folded before Flop
Seat 9: Moszes360 (big blind) folded on the Turn





PokerStars Hand #152560855083:  Hold'em No Limit ($1/$2 USD) - 2016/04/28 15:48:03 CET [2016/04/28 9:48:03 ET]
Table 'Idomeneus II' 9-max Seat #6 is the button
Seat 3: Ouga Buga ($200 in chips) 
Seat 4: wiseyoyo ($265.18 in chips) 
Seat 5: matiko09 ($227.24 in chips) 
Seat 6: peevoajax ($200 in chips) 
Seat 8: di0d80 ($304.54 in chips) 
di0d80: posts small blind $1
libbyyww: is sitting out 
Ouga Buga: posts big blind $2
*** HOLE CARDS ***
Dealt to matiko09 [7s Ac]
libbyyww leaves the table
wiseyoyo: folds 
wiseyoyo leaves the table
matiko09: folds 
peevoajax: folds 
peevoajax leaves the table
di0d80: raises $4 to $6
hurtNCYDE joins the table at seat #6 
hurtNCYDE leaves the table
Ouga Buga: folds [Qc 5s]
Uncalled bet ($4) returned to di0d80
di0d80 collected $4 from pot
di0d80: doesn't show hand 
*** SUMMARY ***
Total pot $4 | Rake $0 
Seat 3: Ouga Buga (big blind) folded before Flop
Seat 4: wiseyoyo folded before Flop (didn't bet)
Seat 5: matiko09 folded before Flop (didn't bet)
Seat 6: peevoajax (button) folded before Flop (didn't bet)
Seat 8: di0d80 (small blind) collected ($4)





PokerStars Hand #152660145415:  Hold'em No Limit (€0.50/€1.00 EUR) - 2016/04/30 17:46:04 CET [2016/04/30 11:46:04 ET]
Table 'Benda' 9-max Seat #6 is the button
Seat 1: aquarua7 (€203.38 in chips) 
Seat 5: chijara (€100 in chips) 
Seat 6: Nunzio1985ct (€41.61 in chips) 
Seat 7: Fivez (€100 in chips) 
Seat 8: matiko09 (€100 in chips) 
Seat 9: Racushniak (€135.73 in chips) 
Fivez: posts small blind €0.50
matiko09: posts big blind €1
*** HOLE CARDS ***
Dealt to matiko09 [Kc 6d]
Racushniak: folds 
aquarua7: raises €1.50 to €2.50
chijara: folds 
Nunzio1985ct: folds 
Fivez: folds 
matiko09: folds 
Uncalled bet (€1.50) returned to aquarua7
aquarua7 collected €2.50 from pot
aquarua7: doesn't show hand 
*** SUMMARY ***
Total pot €2.50 | Rake €0 
Seat 1: aquarua7 collected (€2.50)
Seat 5: chijara folded before Flop (didn't bet)
Seat 6: Nunzio1985ct (button) folded before Flop (didn't bet)
Seat 7: Fivez (small blind) folded before Flop
Seat 8: matiko09 (big blind) folded before Flop
Seat 9: Racushniak folded before Flop (didn't bet)





PokerStars Hand #152660162886:  Hold'em No Limit (€0.50/€1.00 EUR) - 2016/04/30 17:46:28 CET [2016/04/30 11:46:28 ET]
Table 'Benda' 9-max Seat #7 is the button
Seat 1: aquarua7 (€204.88 in chips) 
Seat 5: chijara (€100 in chips) 
Seat 6: Nunzio1985ct (€41.61 in chips) 
Seat 7: Fivez (€100 in chips) 
Seat 8: matiko09 (€100 in chips) 
Seat 9: Racushniak (€135.73 in chips) 
matiko09: posts small blind €0.50
Racushniak: posts big blind €1
*** HOLE CARDS ***
Dealt to matiko09 [8h Ac]
aquarua7: folds 
chijara: raises €2 to €3
Nunzio1985ct: folds 
Fivez: folds 
matiko09: folds 
Racushniak: folds 
Uncalled bet (€2) returned to chijara
chijara collected €2.50 from pot
chijara: doesn't show hand 
*** SUMMARY ***
Total pot €2.50 | Rake €0 
Seat 1: aquarua7 folded before Flop (didn't bet)
Seat 5: chijara collected (€2.50)
Seat 6: Nunzio1985ct folded before Flop (didn't bet)
Seat 7: Fivez (button) folded before Flop (didn't bet)
Seat 8: matiko09 (small blind) folded before Flop
Seat 9: Racushniak (big blind) folded before Flop





PokerStars Hand #152660183080:  Hold'em No Limit (€0.50/€1.00 EUR) - 2016/04/30 17:46:55 CET [2016/04/30 11:46:55 ET]
Table 'Benda' 9-max Seat #8 is the button
Seat 1: aquarua7 (€204.88 in chips) 
Seat 5: chijara (€101.50 in chips) 
Seat 6: Nunzio1985ct (€41.61 in chips) 
Seat 7: Fivez (€100 in chips) 
Seat 8: matiko09 (€100 in chips) 
Seat 9: Racushniak (€134.73 in chips) 
Racushniak: posts small blind €0.50
aquarua7: posts big blind €1
*** HOLE CARDS ***
Dealt to matiko09 [5h 7h]
chijara: folds 
Nunzio1985ct: folds 
Fivez: raises €1.50 to €2.50
matiko09: folds 
Racushniak: folds 
aquarua7: folds 
Uncalled bet (€1.50) returned to Fivez
Fivez collected €2.50 from pot
Fivez: doesn't show hand 
*** SUMMARY ***
Total pot €2.50 | Rake €0 
Seat 1: aquarua7 (big blind) folded before Flop
Seat 5: chijara folded before Flop (didn't bet)
Seat 6: Nunzio1985ct folded before Flop (didn't bet)
Seat 7: Fivez collected (€2.50)
Seat 8: matiko09 (button) folded before Flop (didn't bet)
Seat 9: Racushniak (small blind) folded before Flop





PokerStars Hand #152660206233:  Hold'em No Limit (€0.50/€1.00 EUR) - 2016/04/30 17:47:27 CET [2016/04/30 11:47:27 ET]
Table 'Benda' 9-max Seat #9 is the button
Seat 1: aquarua7 (€203.88 in chips) 
Seat 5: chijara (€101.50 in chips) 
Seat 6: Nunzio1985ct (€41.61 in chips) 
Seat 7: Fivez (€101.50 in chips) 
Seat 8: matiko09 (€100 in chips) 
Seat 9: Racushniak (€134.23 in chips) 
aquarua7: posts small blind €0.50
chijara: posts big blind €1
*** HOLE CARDS ***
Dealt to matiko09 [5d 9s]
Nunzio1985ct: folds 
Fivez: raises €2 to €3
matiko09: folds 
Racushniak: calls €3
aquarua7: folds 
chijara: folds 
*** FLOP *** [2h 6c 2s]
Fivez: checks 
Racushniak: checks 
*** TURN *** [2h 6c 2s] [3h]
Fivez: checks 
Racushniak: checks 
*** RIVER *** [2h 6c 2s 3h] [4c]
Fivez: checks 
cap. marb joins the table at seat #2 
Racushniak: checks 
*** SHOW DOWN ***
Fivez: shows [Ad Td] (a pair of Deuces)
Racushniak: mucks hand 
Fivez collected €7.12 from pot
*** SUMMARY ***
Total pot €7.50 | Rake €0.38 
Board [2h 6c 2s 3h 4c]
Seat 1: aquarua7 (small blind) folded before Flop
Seat 5: chijara (big blind) folded before Flop
Seat 6: Nunzio1985ct folded before Flop (didn't bet)
Seat 7: Fivez showed [Ad Td] and won (€7.12) with a pair of Deuces
Seat 8: matiko09 folded before Flop (didn't bet)
Seat 9: Racushniak (button) mucked [Qd Kd]





PokerStars Hand #152660249003:  Hold'em No Limit (€0.50/€1.00 EUR) - 2016/04/30 17:48:25 CET [2016/04/30 11:48:25 ET]
Table 'Benda' 9-max Seat #1 is the button
Seat 1: aquarua7 (€203.38 in chips) 
Seat 5: chijara (€100.50 in chips) 
Seat 6: Nunzio1985ct (€41.61 in chips) 
Seat 7: Fivez (€105.62 in chips) 
Seat 8: matiko09 (€100 in chips) 
Seat 9: Racushniak (€131.23 in chips) 
cap. marb will be allowed to play after the button
chijara: posts small blind €0.50
Nunzio1985ct: posts big blind €1
*** HOLE CARDS ***
Dealt to matiko09 [2d Qs]
Fivez: folds 
matiko09: folds 
Racushniak: raises €2 to €3
aquarua7: folds 
chijara: folds 
Nunzio1985ct: raises €4 to €7
Racushniak: folds 
Uncalled bet (€4) returned to Nunzio1985ct
Nunzio1985ct collected €6.50 from pot
*** SUMMARY ***
Total pot €6.50 | Rake €0 
Seat 1: aquarua7 (button) folded before Flop (didn't bet)
Seat 5: chijara (small blind) folded before Flop
Seat 6: Nunzio1985ct (big blind) collected (€6.50)
Seat 7: Fivez folded before Flop (didn't bet)
Seat 8: matiko09 folded before Flop (didn't bet)
Seat 9: Racushniak folded before Flop





PokerStars Hand #152660255275:  Hold'em No Limit (€0.50/€1.00 EUR) - 2016/04/30 17:48:34 CET [2016/04/30 11:48:34 ET]
Table 'Oceax II' 9-max Seat #6 is the button
Seat 2: Algarra1 (€49.16 in chips) 
Seat 3: maxxmeister (€100 in chips) 
Seat 4: Racushniak (€109.23 in chips) 
Seat 5: Spid1 (€110.40 in chips) 
Seat 6: Sitech lehne (€60.60 in chips) 
Seat 7: chijara (€100 in chips) 
Seat 8: matiko09 (€100 in chips) 
Seat 9: sinkgraven (€120.38 in chips) 
chijara: posts small blind €0.50
matiko09: posts big blind €1
Fivez: sits out 
*** HOLE CARDS ***
Dealt to matiko09 [Qc 5h]
sinkgraven: folds 
Algarra1: folds 
maxxmeister: folds 
Racushniak: raises €2 to €3
Spid1: raises €6 to €9
Sitech lehne: folds 
chijara: folds 
matiko09: folds 
Racushniak: folds 
Uncalled bet (€6) returned to Spid1
Spid1 collected €7.50 from pot
Spid1: doesn't show hand 
*** SUMMARY ***
Total pot €7.50 | Rake €0 
Seat 2: Algarra1 folded before Flop (didn't bet)
Seat 3: maxxmeister folded before Flop (didn't bet)
Seat 4: Racushniak folded before Flop
Seat 5: Spid1 collected (€7.50)
Seat 6: Sitech lehne (button) folded before Flop (didn't bet)
Seat 7: chijara (small blind) folded before Flop
Seat 8: matiko09 (big blind) folded before Flop
Seat 9: sinkgraven folded before Flop (didn't bet)





PokerStars Hand #152660275619:  Hold'em No Limit ($0.50/$1.00 USD) - 2016/04/30 17:49:02 CET [2016/04/30 11:49:02 ET]
Table 'Raissa II' 9-max Seat #5 is the button
Seat 1: ilaviiitech ($100 in chips) 
Seat 2: Spid1 ($123.58 in chips) 
Seat 3: Kelvin sai ($40.50 in chips) 
Seat 4: koksskrt ($115.20 in chips) 
Seat 5: Jess7jay ($92.18 in chips) 
Seat 6: 9lKBXKTT6 ($104.28 in chips) 
Seat 7: matiko09 ($100 in chips) 
Seat 9: ApkawaDavit ($100 in chips) 
9lKBXKTT6: posts small blind $0.50
matiko09: posts big blind $1
R1aki: sits out 
*** HOLE CARDS ***
Dealt to matiko09 [3c 9c]
ApkawaDavit: raises $2 to $3
ilaviiitech: folds 
Spid1: folds 
Kelvin sai: folds 
koksskrt: folds 
Jess7jay: folds 
9lKBXKTT6: folds 
matiko09: folds 
Uncalled bet ($2) returned to ApkawaDavit
ApkawaDavit collected $2.50 from pot
ApkawaDavit: doesn't show hand 
*** SUMMARY ***
Total pot $2.50 | Rake $0 
Seat 1: ilaviiitech folded before Flop (didn't bet)
Seat 2: Spid1 folded before Flop (didn't bet)
Seat 3: Kelvin sai folded before Flop (didn't bet)
Seat 4: koksskrt folded before Flop (didn't bet)
Seat 5: Jess7jay (button) folded before Flop (didn't bet)
Seat 6: 9lKBXKTT6 (small blind) folded before Flop
Seat 7: matiko09 (big blind) folded before Flop
Seat 9: ApkawaDavit collected ($2.50)





PokerStars Hand #152660291913:  Hold'em No Limit (€0.50/€1.00 EUR) - 2016/04/30 17:49:24 CET [2016/04/30 11:49:24 ET]
Table 'Benda' 9-max Seat #5 is the button
Seat 1: aquarua7 (€203.38 in chips) 
Seat 5: chijara (€100 in chips) 
Seat 6: Nunzio1985ct (€45.11 in chips) 
Seat 7: Fivez (€105.62 in chips) 
Seat 8: matiko09 (€100 in chips) 
Seat 9: Racushniak (€128.23 in chips) 
Nunzio1985ct: posts small blind €0.50
Fivez: posts big blind €1
cap. marb: sits out 
*** HOLE CARDS ***
Dealt to matiko09 [Qh Kh]
matiko09: raises €2 to €3
Racushniak: raises €6 to €9
aquarua7: raises €22.50 to €31.50
fireball2112 joins the table at seat #4 
chijara: folds 
R1aki joins the table at seat #3 
Nunzio1985ct: folds 
Fivez: folds 
matiko09: folds 
Racushniak: folds 
Uncalled bet (€22.50) returned to aquarua7
aquarua7 collected €22.50 from pot
aquarua7: doesn't show hand 
*** SUMMARY ***
Total pot €22.50 | Rake €0 
Seat 1: aquarua7 collected (€22.50)
Seat 5: chijara (button) folded before Flop (didn't bet)
Seat 6: Nunzio1985ct (small blind) folded before Flop
Seat 7: Fivez (big blind) folded before Flop
Seat 8: matiko09 folded before Flop
Seat 9: Racushniak folded before Flop





PokerStars Hand #152660292721:  Hold'em No Limit (€0.50/€1.00 EUR) - 2016/04/30 17:49:26 CET [2016/04/30 11:49:26 ET]
Table 'Oceax II' 9-max Seat #7 is the button
Seat 2: Algarra1 (€49.16 in chips) 
Seat 3: maxxmeister (€100 in chips) 
Seat 4: Racushniak (€106.23 in chips) 
Seat 5: Spid1 (€114.90 in chips) 
Seat 6: Sitech lehne (€60.60 in chips) 
Seat 7: chijara (€100 in chips) 
Seat 8: matiko09 (€100 in chips) 
Seat 9: sinkgraven (€120.38 in chips) 
matiko09: posts small blind €0.50
sinkgraven: posts big blind €1
Fivez: sits out 
*** HOLE CARDS ***
Dealt to matiko09 [8d Ad]
Algarra1: folds 
maxxmeister: folds 
Racushniak: folds 
Spid1: folds 
Sitech lehne: folds 
chijara: folds 
matiko09: raises €2 to €3
sinkgraven: folds 
Uncalled bet (€2) returned to matiko09
matiko09 collected €2 from pot
matiko09: doesn't show hand 
*** SUMMARY ***
Total pot €2 | Rake €0 
Seat 2: Algarra1 folded before Flop (didn't bet)
Seat 3: maxxmeister folded before Flop (didn't bet)
Seat 4: Racushniak folded before Flop (didn't bet)
Seat 5: Spid1 folded before Flop (didn't bet)
Seat 6: Sitech lehne folded before Flop (didn't bet)
Seat 7: chijara (button) folded before Flop (didn't bet)
Seat 8: matiko09 (small blind) collected (€2)
Seat 9: sinkgraven (big blind) folded before Flop





PokerStars Hand #152660295563:  Hold'em No Limit ($0.50/$1.00 USD) - 2016/04/30 17:49:30 CET [2016/04/30 11:49:30 ET]
Table 'Raissa II' 9-max Seat #6 is the button
Seat 1: ilaviiitech ($100 in chips) 
Seat 2: Spid1 ($123.58 in chips) 
Seat 3: Kelvin sai ($40.50 in chips) 
Seat 4: koksskrt ($115.20 in chips) 
Seat 5: Jess7jay ($92.18 in chips) 
Seat 6: 9lKBXKTT6 ($103.78 in chips) 
Seat 7: matiko09 ($100 in chips) 
Seat 8: R1aki ($100 in chips) 
Seat 9: ApkawaDavit ($101.50 in chips) 
matiko09: posts small blind $0.50
R1aki: posts big blind $1
*** HOLE CARDS ***
Dealt to matiko09 [Tc Jh]
ApkawaDavit: folds 
ilaviiitech: folds 
Spid1: folds 
Kelvin sai: raises $1 to $2
koksskrt: folds 
Jess7jay: calls $2
9lKBXKTT6: folds 
matiko09: folds 
R1aki: folds 
*** FLOP *** [3c 5s 7c]
Kelvin sai: checks 
Jess7jay: checks 
*** TURN *** [3c 5s 7c] [Qh]
Kelvin sai: bets $2.61
Jess7jay: calls $2.61
*** RIVER *** [3c 5s 7c Qh] [Ah]
Kelvin sai: bets $5
Jess7jay: folds 
Uncalled bet ($5) returned to Kelvin sai
Kelvin sai collected $10.18 from pot
Kelvin sai: doesn't show hand 
*** SUMMARY ***
Total pot $10.72 | Rake $0.54 
Board [3c 5s 7c Qh Ah]
Seat 1: ilaviiitech folded before Flop (didn't bet)
Seat 2: Spid1 folded before Flop (didn't bet)
Seat 3: Kelvin sai collected ($10.18)
Seat 4: koksskrt folded before Flop (didn't bet)
Seat 5: Jess7jay folded on the River
Seat 6: 9lKBXKTT6 (button) folded before Flop (didn't bet)
Seat 7: matiko09 (small blind) folded before Flop
Seat 8: R1aki (big blind) folded before Flop
Seat 9: ApkawaDavit folded before Flop (didn't bet)





PokerStars Hand #152660308415:  Hold'em No Limit (€0.50/€1.00 EUR) - 2016/04/30 17:49:47 CET [2016/04/30 11:49:47 ET]
Table 'Oceax II' 9-max Seat #8 is the button
Seat 1: Fivez (€100 in chips) 
Seat 2: Algarra1 (€49.16 in chips) 
Seat 3: maxxmeister (€100 in chips) 
Seat 4: Racushniak (€106.23 in chips) 
Seat 5: Spid1 (€114.90 in chips) 
Seat 6: Sitech lehne (€60.60 in chips) 
Seat 7: chijara (€100 in chips) 
Seat 8: matiko09 (€101 in chips) 
Seat 9: sinkgraven (€119.38 in chips) 
sinkgraven: posts small blind €0.50
Fivez: posts big blind €1
*** HOLE CARDS ***
Dealt to matiko09 [Ks 5d]
Algarra1: calls €1
maxxmeister: folds 
Racushniak: folds 
Spid1: raises €3 to €4
Sitech lehne: calls €4
chijara: folds 
matiko09: folds 
sinkgraven: folds 
Fivez: folds 
Algarra1: calls €3
*** FLOP *** [Jd 3s 4c]
Algarra1: bets €6
Spid1: folds 
Sitech lehne: calls €6
*** TURN *** [Jd 3s 4c] [3d]
Algarra1: bets €24
Sitech lehne: folds 
Uncalled bet (€24) returned to Algarra1
Algarra1 collected €24.22 from pot
Algarra1: doesn't show hand 
*** SUMMARY ***
Total pot €25.50 | Rake €1.28 
Board [Jd 3s 4c 3d]
Seat 1: Fivez (big blind) folded before Flop
Seat 2: Algarra1 collected (€24.22)
Seat 3: maxxmeister folded before Flop (didn't bet)
Seat 4: Racushniak folded before Flop (didn't bet)
Seat 5: Spid1 folded on the Flop
Seat 6: Sitech lehne folded on the Turn
Seat 7: chijara folded before Flop (didn't bet)
Seat 8: matiko09 (button) folded before Flop (didn't bet)
Seat 9: sinkgraven (small blind) folded before Flop





PokerStars Hand #152660314370:  Hold'em No Limit (€0.50/€1.00 EUR) - 2016/04/30 17:49:56 CET [2016/04/30 11:49:56 ET]
Table 'Benda' 9-max Seat #6 is the button
Seat 1: aquarua7 (€216.88 in chips) 
Seat 4: fireball2112 (€80 in chips) 
Seat 5: chijara (€100 in chips) 
Seat 6: Nunzio1985ct (€44.61 in chips) 
Seat 7: Fivez (€104.62 in chips) 
Seat 8: matiko09 (€100 in chips) 
Seat 9: Racushniak (€119.23 in chips) 
Fivez: posts small blind €0.50
matiko09: posts big blind €1
cap. marb: sits out 
R1aki: sits out 
fireball2112: posts big blind €1
*** HOLE CARDS ***
Dealt to matiko09 [3h As]
Racushniak: folds 
aquarua7: folds 
fireball2112: checks 
chijara: folds 
Nunzio1985ct: folds 
Fivez: raises €3 to €4
matiko09: folds 
fireball2112: folds 
Uncalled bet (€3) returned to Fivez
Fivez collected €3 from pot
Fivez: doesn't show hand 
*** SUMMARY ***
Total pot €3 | Rake €0 
Seat 1: aquarua7 folded before Flop (didn't bet)
Seat 4: fireball2112 folded before Flop
Seat 5: chijara folded before Flop (didn't bet)
Seat 6: Nunzio1985ct (button) folded before Flop (didn't bet)
Seat 7: Fivez (small blind) collected (€3)
Seat 8: matiko09 (big blind) folded before Flop
Seat 9: Racushniak folded before Flop (didn't bet)





PokerStars Hand #152660332783:  Hold'em No Limit (€0.50/€1.00 EUR) - 2016/04/30 17:50:21 CET [2016/04/30 11:50:21 ET]
Table 'Benda' 9-max Seat #7 is the button
Seat 1: aquarua7 (€216.88 in chips) 
Seat 4: fireball2112 (€79 in chips) 
Seat 5: chijara (€100 in chips) 
Seat 6: Nunzio1985ct (€44.61 in chips) 
Seat 7: Fivez (€106.62 in chips) 
Seat 8: matiko09 (€100 in chips) 
Seat 9: Racushniak (€119.23 in chips) 
matiko09: posts small blind €0.50
Racushniak: posts big blind €1
cap. marb: sits out 
R1aki: sits out 
*** HOLE CARDS ***
Dealt to matiko09 [Qs 5c]
aquarua7: folds 
fireball2112: folds 
chijara: folds 
Nunzio1985ct: folds 
Fivez: raises €1.50 to €2.50
matiko09: folds 
Racushniak: folds 
Uncalled bet (€1.50) returned to Fivez
Fivez collected €2.50 from pot
Fivez: doesn't show hand 
*** SUMMARY ***
Total pot €2.50 | Rake €0 
Seat 1: aquarua7 folded before Flop (didn't bet)
Seat 4: fireball2112 folded before Flop (didn't bet)
Seat 5: chijara folded before Flop (didn't bet)
Seat 6: Nunzio1985ct folded before Flop (didn't bet)
Seat 7: Fivez (button) collected (€2.50)
Seat 8: matiko09 (small blind) folded before Flop
Seat 9: Racushniak (big blind) folded before Flop





PokerStars Hand #152660338695:  Hold'em No Limit ($0.50/$1.00 USD) - 2016/04/30 17:50:29 CET [2016/04/30 11:50:29 ET]
Table 'Tamariwa' 9-max Seat #8 is the button
Seat 1: matiko09 ($100 in chips) 
Seat 2: ilaviiitech ($100 in chips) 
Seat 3: Spid1 ($100 in chips) 
Seat 7: azqanaz ($101.68 in chips) 
Seat 8: R1aki ($100 in chips) 
Seat 9: ApkawaDavit ($103.12 in chips) 
ApkawaDavit: posts small blind $0.50
matiko09: posts big blind $1
cap. marb: sits out 
*** HOLE CARDS ***
Dealt to matiko09 [5h Tc]
ilaviiitech: raises $2 to $3
Spid1: calls $3
azqanaz: folds 
R1aki: folds 
ApkawaDavit: calls $2.50
matiko09: folds 
*** FLOP *** [Qs Qc 8c]
ApkawaDavit: checks 
ilaviiitech: bets $6.33
Spid1: folds 
ApkawaDavit: raises $10.67 to $17
ilaviiitech: raises $80 to $97 and is all-in
ApkawaDavit: calls $80
*** TURN *** [Qs Qc 8c] [3c]
*** RIVER *** [Qs Qc 8c 3c] [6h]
*** SHOW DOWN ***
ApkawaDavit: shows [8d 8h] (a full house, Eights full of Queens)
ilaviiitech: shows [Ac Qd] (three of a kind, Queens)
ApkawaDavit collected $201.50 from pot
*** SUMMARY ***
Total pot $204 | Rake $2.50 
Board [Qs Qc 8c 3c 6h]
Seat 1: matiko09 (big blind) folded before Flop
Seat 2: ilaviiitech showed [Ac Qd] and lost with three of a kind, Queens
Seat 3: Spid1 folded on the Flop
Seat 7: azqanaz folded before Flop (didn't bet)
Seat 8: R1aki (button) folded before Flop (didn't bet)
Seat 9: ApkawaDavit (small blind) showed [8d 8h] and won ($201.50) with a full house, Eights full of Queens





PokerStars Hand #152660350752:  Hold'em No Limit (€0.50/€1.00 EUR) - 2016/04/30 17:50:46 CET [2016/04/30 11:50:46 ET]
Table 'Benda' 9-max Seat #8 is the button
Seat 1: aquarua7 (€216.88 in chips) 
Seat 4: fireball2112 (€79 in chips) 
Seat 5: chijara (€100 in chips) 
Seat 6: Nunzio1985ct (€44.61 in chips) 
Seat 7: Fivez (€108.12 in chips) 
Seat 8: matiko09 (€100 in chips) 
Seat 9: Racushniak (€118.23 in chips) 
Racushniak: posts small blind €0.50
aquarua7: posts big blind €1
cap. marb: sits out 
R1aki: sits out 
*** HOLE CARDS ***
Dealt to matiko09 [As Th]
fireball2112: folds 
chijara: raises €2 to €3
Nunzio1985ct: folds 
Fivez: folds 
matiko09: folds 
Racushniak: folds 
aquarua7: folds 
Uncalled bet (€2) returned to chijara
chijara collected €2.50 from pot
chijara: doesn't show hand 
*** SUMMARY ***
Total pot €2.50 | Rake €0 
Seat 1: aquarua7 (big blind) folded before Flop
Seat 4: fireball2112 folded before Flop (didn't bet)
Seat 5: chijara collected (€2.50)
Seat 6: Nunzio1985ct folded before Flop (didn't bet)
Seat 7: Fivez folded before Flop (didn't bet)
Seat 8: matiko09 (button) folded before Flop (didn't bet)
Seat 9: Racushniak (small blind) folded before Flop





PokerStars Hand #152660357720:  Hold'em No Limit ($0.50/$1.00 USD) - 2016/04/30 17:50:55 CET [2016/04/30 11:50:55 ET]
Table 'Raissa II' 9-max Seat #7 is the button
Seat 1: ilaviiitech ($100 in chips) 
Seat 2: Spid1 ($123.58 in chips) 
Seat 3: Kelvin sai ($46.07 in chips) 
Seat 4: koksskrt ($115.20 in chips) 
Seat 5: Jess7jay ($87.57 in chips) 
Seat 6: 9lKBXKTT6 ($103.78 in chips) 
Seat 7: matiko09 ($100 in chips) 
Seat 8: R1aki ($100 in chips) 
Seat 9: ApkawaDavit ($101.50 in chips) 
R1aki: posts small blind $0.50
ApkawaDavit: posts big blind $1
*** HOLE CARDS ***
Dealt to matiko09 [5s Ac]
ilaviiitech: folds 
Spid1: raises $2 to $3
Kelvin sai: folds 
koksskrt: folds 
Jess7jay: calls $3
ilaviiitech leaves the table
cap. marb joins the table at seat #1 
9lKBXKTT6: folds 
matiko09: folds 
R1aki: folds 
ApkawaDavit: folds 
*** FLOP *** [7d As Js]
Spid1: checks 
Jess7jay: bets $2.50
Spid1: folds 
Uncalled bet ($2.50) returned to Jess7jay
Jess7jay collected $7.12 from pot
Jess7jay: doesn't show hand 
*** SUMMARY ***
Total pot $7.50 | Rake $0.38 
Board [7d As Js]
Seat 1: ilaviiitech folded before Flop (didn't bet)
Seat 2: Spid1 folded on the Flop
Seat 3: Kelvin sai folded before Flop (didn't bet)
Seat 4: koksskrt folded before Flop (didn't bet)
Seat 5: Jess7jay collected ($7.12)
Seat 6: 9lKBXKTT6 folded before Flop (didn't bet)
Seat 7: matiko09 (button) folded before Flop (didn't bet)
Seat 8: R1aki (small blind) folded before Flop
Seat 9: ApkawaDavit (big blind) folded before Flop





PokerStars Hand #152660365680:  Hold'em No Limit (€0.50/€1.00 EUR) - 2016/04/30 17:51:06 CET [2016/04/30 11:51:06 ET]
Table 'Oceax II' 9-max Seat #9 is the button
Seat 1: Fivez (€100 in chips) 
Seat 2: Algarra1 (€63.38 in chips) 
Seat 3: maxxmeister (€100 in chips) 
Seat 4: Racushniak (€106.23 in chips) 
Seat 5: Spid1 (€110.90 in chips) 
Seat 6: Sitech lehne (€50.60 in chips) 
Seat 7: chijara (€100 in chips) 
Seat 8: matiko09 (€101 in chips) 
Seat 9: sinkgraven (€118.88 in chips) 
Fivez: posts small blind €0.50
Algarra1: posts big blind €1
*** HOLE CARDS ***
Dealt to matiko09 [9d 8d]
maxxmeister: folds 
Racushniak: raises €2 to €3
Spid1: folds 
Sitech lehne: folds 
chijara: folds 
matiko09: folds 
Sitech lehne said, "arschloch"
sinkgraven: calls €3
Fivez: folds 
Algarra1: calls €2
*** FLOP *** [Tc 5h 6s]
Algarra1: checks 
Racushniak: bets €5
sinkgraven: calls €5
Algarra1: folds 
*** TURN *** [Tc 5h 6s] [Th]
Racushniak: checks 
sinkgraven: checks 
*** RIVER *** [Tc 5h 6s Th] [Td]
Racushniak: checks 
sinkgraven: bets €12
Racushniak: calls €12
*** SHOW DOWN ***
sinkgraven: shows [Jh Ts] (four of a kind, Tens)
Racushniak: mucks hand 
sinkgraven collected €41.32 from pot
*** SUMMARY ***
Total pot €43.50 | Rake €2.18 
Board [Tc 5h 6s Th Td]
Seat 1: Fivez (small blind) folded before Flop
Seat 2: Algarra1 (big blind) folded on the Flop
Seat 3: maxxmeister folded before Flop (didn't bet)
Seat 4: Racushniak mucked [6c 5c]
Seat 5: Spid1 folded before Flop (didn't bet)
Seat 6: Sitech lehne folded before Flop (didn't bet)
Seat 7: chijara folded before Flop (didn't bet)
Seat 8: matiko09 folded before Flop (didn't bet)
Seat 9: sinkgraven (button) showed [Jh Ts] and won (€41.32) with four of a kind, Tens





PokerStars Hand #152660379559:  Hold'em No Limit (€0.50/€1.00 EUR) - 2016/04/30 17:51:25 CET [2016/04/30 11:51:25 ET]
Table 'Benda' 9-max Seat #9 is the button
Seat 1: aquarua7 (€215.88 in chips) 
Seat 2: cap. marb (€40 in chips) 
Seat 4: fireball2112 (€79 in chips) 
Seat 5: chijara (€101.50 in chips) 
Seat 6: Nunzio1985ct (€44.61 in chips) 
Seat 7: Fivez (€108.12 in chips) 
Seat 8: matiko09 (€100 in chips) 
Seat 9: Racushniak (€117.73 in chips) 
aquarua7: posts small blind €0.50
cap. marb: posts big blind €1
R1aki: sits out 
*** HOLE CARDS ***
Dealt to matiko09 [Qd 2s]
fireball2112: raises €1 to €2
chijara: calls €2
Nunzio1985ct: folds 
Fivez: folds 
matiko09: folds 
Racushniak: folds 
aquarua7: folds 
cap. marb: folds 
*** FLOP *** [Td 6h 7s]
fireball2112: bets €3
chijara: calls €3
*** TURN *** [Td 6h 7s] [3c]
fireball2112: bets €4
chijara: calls €4
*** RIVER *** [Td 6h 7s 3c] [Ks]
fireball2112: bets €5
chijara: calls €5
*** SHOW DOWN ***
fireball2112: shows [9c Qc] (high card King)
chijara: shows [Th 9h] (a pair of Tens)
chijara collected €28.02 from pot
*** SUMMARY ***
Total pot €29.50 | Rake €1.48 
Board [Td 6h 7s 3c Ks]
Seat 1: aquarua7 (small blind) folded before Flop
Seat 2: cap. marb (big blind) folded before Flop
Seat 4: fireball2112 showed [9c Qc] and lost with high card King
Seat 5: chijara showed [Th 9h] and won (€28.02) with a pair of Tens
Seat 6: Nunzio1985ct folded before Flop (didn't bet)
Seat 7: Fivez folded before Flop (didn't bet)
Seat 8: matiko09 folded before Flop (didn't bet)
Seat 9: Racushniak (button) folded before Flop (didn't bet)





PokerStars Hand #152660381154:  Hold'em No Limit ($0.50/$1.00 USD) - 2016/04/30 17:51:28 CET [2016/04/30 11:51:28 ET]
Table 'Tamariwa' 9-max Seat #9 is the button
Seat 1: matiko09 ($100 in chips) 
Seat 2: ilaviiitech ($100 in chips) 
Seat 3: Spid1 ($100 in chips) 
Seat 7: azqanaz ($101.68 in chips) 
Seat 8: R1aki ($100 in chips) 
Seat 9: ApkawaDavit ($204.62 in chips) 
matiko09: posts small blind $0.50
Lobbyist98 joins the table at seat #5 
ilaviiitech: posts big blind $1
cap. marb: sits out 
*** HOLE CARDS ***
Dealt to matiko09 [As Jc]
Spid1: folds 
azqanaz: folds 
R1aki: raises $1.50 to $2.50
ApkawaDavit: folds 
matiko09: raises $6.50 to $9
ilaviiitech: folds 
R1aki: calls $6.50
*** FLOP *** [5c 4c 7d]
matiko09: checks 
R1aki: bets $13.50
matiko09: folds 
Uncalled bet ($13.50) returned to R1aki
R1aki collected $18.05 from pot
R1aki: doesn't show hand 
*** SUMMARY ***
Total pot $19 | Rake $0.95 
Board [5c 4c 7d]
Seat 1: matiko09 (small blind) folded on the Flop
Seat 2: ilaviiitech (big blind) folded before Flop
Seat 3: Spid1 folded before Flop (didn't bet)
Seat 7: azqanaz folded before Flop (didn't bet)
Seat 8: R1aki collected ($18.05)
Seat 9: ApkawaDavit (button) folded before Flop (didn't bet)





PokerStars Hand #152660408210:  Hold'em No Limit ($0.50/$1.00 USD) - 2016/04/30 17:52:05 CET [2016/04/30 11:52:05 ET]
Table 'Raissa II' 9-max Seat #8 is the button
Seat 1: cap. marb ($40 in chips) 
Seat 2: Spid1 ($120.58 in chips) 
Seat 3: Kelvin sai ($46.07 in chips) 
Seat 4: koksskrt ($115.20 in chips) 
Seat 5: Jess7jay ($91.69 in chips) 
Seat 6: 9lKBXKTT6 ($103.78 in chips) 
Seat 7: matiko09 ($100 in chips) 
Seat 8: R1aki ($100 in chips) 
Seat 9: ApkawaDavit ($100.50 in chips) 
ApkawaDavit: posts small blind $0.50
cap. marb: posts big blind $1
*** HOLE CARDS ***
Dealt to matiko09 [Ah 9s]
Spid1: folds 
Kelvin sai: folds 
koksskrt: folds 
Jess7jay: calls $1
9lKBXKTT6: raises $1.50 to $2.50
matiko09: raises $6.50 to $9
R1aki: raises $12 to $21
ApkawaDavit: folds 
cap. marb: folds 
Jess7jay: folds 
9lKBXKTT6: folds 
matiko09: folds 
Uncalled bet ($12) returned to R1aki
R1aki collected $23 from pot
R1aki: doesn't show hand 
*** SUMMARY ***
Total pot $23 | Rake $0 
Seat 1: cap. marb (big blind) folded before Flop
Seat 2: Spid1 folded before Flop (didn't bet)
Seat 3: Kelvin sai folded before Flop (didn't bet)
Seat 4: koksskrt folded before Flop (didn't bet)
Seat 5: Jess7jay folded before Flop
Seat 6: 9lKBXKTT6 folded before Flop
Seat 7: matiko09 folded before Flop
Seat 8: R1aki (button) collected ($23)
Seat 9: ApkawaDavit (small blind) folded before Flop





PokerStars Hand #152660426725:  Hold'em No Limit (€0.50/€1.00 EUR) - 2016/04/30 17:52:30 CET [2016/04/30 11:52:30 ET]
Table 'Oceax II' 9-max Seat #1 is the button
Seat 1: Fivez (€100 in chips) 
Seat 2: Algarra1 (€60.38 in chips) 
Seat 4: Racushniak (€100 in chips) 
Seat 5: Spid1 (€110.90 in chips) 
Seat 6: Sitech lehne (€50.60 in chips) 
Seat 7: chijara (€100 in chips) 
Seat 8: matiko09 (€101 in chips) 
Seat 9: sinkgraven (€140.20 in chips) 
Algarra1: posts small blind €0.50
maxxmeister: is sitting out 
Racushniak: posts big blind €1
*** HOLE CARDS ***
Dealt to matiko09 [4h 2c]
Spid1: folds 
Sitech lehne: folds 
chijara: folds 
matiko09: folds 
sinkgraven: folds 
Fivez: folds 
Algarra1: calls €0.50
Racushniak: checks 
*** FLOP *** [5c 6h 3h]
Algarra1: checks 
Racushniak has timed out
Racushniak: checks 
*** TURN *** [5c 6h 3h] [6c]
Algarra1: checks 
Racushniak has timed out
Racushniak: checks 
*** RIVER *** [5c 6h 3h 6c] [Qd]
Algarra1: bets €1
Racushniak has timed out
Racushniak: folds 
Uncalled bet (€1) returned to Algarra1
Algarra1 collected €1.90 from pot
Algarra1: doesn't show hand 
*** SUMMARY ***
Total pot €2 | Rake €0.10 
Board [5c 6h 3h 6c Qd]
Seat 1: Fivez (button) folded before Flop (didn't bet)
Seat 2: Algarra1 (small blind) collected (€1.90)
Seat 4: Racushniak (big blind) folded on the River
Seat 5: Spid1 folded before Flop (didn't bet)
Seat 6: Sitech lehne folded before Flop (didn't bet)
Seat 7: chijara folded before Flop (didn't bet)
Seat 8: matiko09 folded before Flop (didn't bet)
Seat 9: sinkgraven folded before Flop (didn't bet)





PokerStars Hand #152660427280:  Hold'em No Limit ($0.50/$1.00 USD) - 2016/04/30 17:52:31 CET [2016/04/30 11:52:31 ET]
Table 'Tamariwa' 9-max Seat #1 is the button
Seat 1: matiko09 ($100 in chips) 
Seat 2: ilaviiitech ($100 in chips) 
Seat 3: Spid1 ($100 in chips) 
Seat 7: azqanaz ($101.68 in chips) 
Seat 8: R1aki ($109.05 in chips) 
Seat 9: ApkawaDavit ($204.62 in chips) 
ilaviiitech: posts small blind $0.50
Spid1: posts big blind $1
cap. marb: sits out 
Lobbyist98: sits out 
*** HOLE CARDS ***
Dealt to matiko09 [9h 9c]
azqanaz: folds 
R1aki: folds 
ApkawaDavit: folds 
matiko09: raises $2 to $3
ilaviiitech: folds 
Spid1: folds 
Uncalled bet ($2) returned to matiko09
matiko09 collected $2.50 from pot
matiko09: doesn't show hand 
*** SUMMARY ***
Total pot $2.50 | Rake $0 
Seat 1: matiko09 (button) collected ($2.50)
Seat 2: ilaviiitech (small blind) folded before Flop
Seat 3: Spid1 (big blind) folded before Flop
Seat 7: azqanaz folded before Flop (didn't bet)
Seat 8: R1aki folded before Flop (didn't bet)
Seat 9: ApkawaDavit folded before Flop (didn't bet)





PokerStars Hand #152660454575:  Hold'em No Limit ($0.50/$1.00 USD) - 2016/04/30 17:53:08 CET [2016/04/30 11:53:08 ET]
Table 'Tamariwa' 9-max Seat #2 is the button
Seat 1: matiko09 ($101.50 in chips) 
Seat 2: ilaviiitech ($100 in chips) 
Seat 3: Spid1 ($100 in chips) 
Seat 4: cap. marb ($40 in chips) 
Seat 7: azqanaz ($101.68 in chips) 
Seat 8: R1aki ($109.05 in chips) 
Seat 9: ApkawaDavit ($204.62 in chips) 
Spid1: posts small blind $0.50
cap. marb: posts big blind $1
Lobbyist98: sits out 
*** HOLE CARDS ***
Dealt to matiko09 [7h 2h]
azqanaz has timed out
azqanaz: folds 
R1aki: folds 
ApkawaDavit: folds 
matiko09: folds 
ilaviiitech: folds 
Spid1: folds 
Uncalled bet ($0.50) returned to cap. marb
cap. marb collected $1 from pot
cap. marb: doesn't show hand 
*** SUMMARY ***
Total pot $1 | Rake $0 
Seat 1: matiko09 folded before Flop (didn't bet)
Seat 2: ilaviiitech (button) folded before Flop (didn't bet)
Seat 3: Spid1 (small blind) folded before Flop
Seat 4: cap. marb (big blind) collected ($1)
Seat 7: azqanaz folded before Flop (didn't bet)
Seat 8: R1aki folded before Flop (didn't bet)
Seat 9: ApkawaDavit folded before Flop (didn't bet)





PokerStars Hand #152660456261:  Hold'em No Limit ($0.50/$1.00 USD) - 2016/04/30 17:53:11 CET [2016/04/30 11:53:11 ET]
Table 'Raissa II' 9-max Seat #9 is the button
Seat 1: cap. marb ($39 in chips) 
Seat 3: Kelvin sai ($46.07 in chips) 
Seat 4: koksskrt ($115.20 in chips) 
Seat 5: Jess7jay ($90.69 in chips) 
Seat 6: 9lKBXKTT6 ($101.28 in chips) 
Seat 7: matiko09 ($100 in chips) 
Seat 8: R1aki ($114 in chips) 
Seat 9: ApkawaDavit ($100 in chips) 
cap. marb: posts small blind $0.50
Spid1: is sitting out 
Spid1 leaves the table
Kelvin sai: posts big blind $1
*** HOLE CARDS ***
Dealt to matiko09 [Ah 7s]
koksskrt: folds 
Jess7jay: calls $1
9lKBXKTT6: folds 
matiko09: folds 
R1aki: folds 
ApkawaDavit: folds 
cap. marb: folds 
Kelvin sai: checks 
*** FLOP *** [Tc 7h Qd]
Kelvin sai: bets $1
Jess7jay: raises $2 to $3
Kelvin sai: folds 
Uncalled bet ($2) returned to Jess7jay
Jess7jay collected $4.28 from pot
Jess7jay: doesn't show hand 
*** SUMMARY ***
Total pot $4.50 | Rake $0.22 
Board [Tc 7h Qd]
Seat 1: cap. marb (small blind) folded before Flop
Seat 3: Kelvin sai (big blind) folded on the Flop
Seat 4: koksskrt folded before Flop (didn't bet)
Seat 5: Jess7jay collected ($4.28)
Seat 6: 9lKBXKTT6 folded before Flop (didn't bet)
Seat 7: matiko09 folded before Flop (didn't bet)
Seat 8: R1aki folded before Flop (didn't bet)
Seat 9: ApkawaDavit (button) folded before Flop (didn't bet)





PokerStars Hand #152660457586:  Hold'em No Limit (€0.50/€1.00 EUR) - 2016/04/30 17:53:12 CET [2016/04/30 11:53:12 ET]
Table 'Benda' 9-max Seat #1 is the button
Seat 1: aquarua7 (€215.38 in chips) 
Seat 2: cap. marb (€39 in chips) 
Seat 3: R1aki (€106.52 in chips) 
Seat 4: fireball2112 (€65 in chips) 
Seat 5: chijara (€115.52 in chips) 
Seat 6: Nunzio1985ct (€44.61 in chips) 
Seat 7: Fivez (€108.12 in chips) 
Seat 8: matiko09 (€100 in chips) 
cap. marb: posts small blind €0.50
R1aki: posts big blind €1
*** HOLE CARDS ***
Dealt to matiko09 [Jh 4h]
fireball2112: raises €2 to €3
chijara: folds 
Nunzio1985ct: folds 
Fivez: folds 
matiko09: folds 
aquarua7: folds 
cap. marb: folds 
R1aki: raises €5.50 to €8.50
fireball2112: calls €5.50
*** FLOP *** [Ad 2d 9d]
R1aki: checks 
fireball2112: bets €17
R1aki: folds 
Uncalled bet (€17) returned to fireball2112
fireball2112 collected €16.62 from pot
fireball2112: doesn't show hand 
*** SUMMARY ***
Total pot €17.50 | Rake €0.88 
Board [Ad 2d 9d]
Seat 1: aquarua7 (button) folded before Flop (didn't bet)
Seat 2: cap. marb (small blind) folded before Flop
Seat 3: R1aki (big blind) folded on the Flop
Seat 4: fireball2112 collected (€16.62)
Seat 5: chijara folded before Flop (didn't bet)
Seat 6: Nunzio1985ct folded before Flop (didn't bet)
Seat 7: Fivez folded before Flop (didn't bet)
Seat 8: matiko09 folded before Flop (didn't bet)





PokerStars Hand #152660489160:  Hold'em No Limit ($0.50/$1.00 USD) - 2016/04/30 17:53:56 CET [2016/04/30 11:53:56 ET]
Table 'Tamariwa' 9-max Seat #3 is the button
Seat 1: matiko09 ($101.50 in chips) 
Seat 2: ilaviiitech ($100 in chips) 
Seat 3: Spid1 ($100 in chips) 
Seat 4: cap. marb ($40.50 in chips) 
Seat 5: Lobbyist98 ($80 in chips) 
Seat 7: azqanaz ($101.68 in chips) 
Seat 8: R1aki ($109.05 in chips) 
Seat 9: ApkawaDavit ($204.62 in chips) 
cap. marb: posts small blind $0.50
Lobbyist98: posts big blind $1
*** HOLE CARDS ***
Dealt to matiko09 [Ad 9c]
azqanaz: raises $2 to $3
R1aki: folds 
ApkawaDavit: folds 
matiko09: folds 
ilaviiitech: calls $3
Spid1: folds 
cap. marb: folds 
Lobbyist98: folds 
*** FLOP *** [Th 3s 4s]
azqanaz: bets $3.56
ilaviiitech: folds 
Uncalled bet ($3.56) returned to azqanaz
azqanaz collected $7.12 from pot
*** SUMMARY ***
Total pot $7.50 | Rake $0.38 
Board [Th 3s 4s]
Seat 1: matiko09 folded before Flop (didn't bet)
Seat 2: ilaviiitech folded on the Flop
Seat 3: Spid1 (button) folded before Flop (didn't bet)
Seat 4: cap. marb (small blind) folded before Flop
Seat 5: Lobbyist98 (big blind) folded before Flop
Seat 7: azqanaz collected ($7.12)
Seat 8: R1aki folded before Flop (didn't bet)
Seat 9: ApkawaDavit folded before Flop (didn't bet)





PokerStars Hand #152660498003:  Hold'em No Limit ($0.50/$1.00 USD) - 2016/04/30 17:54:08 CET [2016/04/30 11:54:08 ET]
Table 'Raissa II' 9-max Seat #1 is the button
Seat 1: cap. marb ($38.50 in chips) 
Seat 3: Kelvin sai ($44.07 in chips) 
Seat 4: koksskrt ($115.20 in chips) 
Seat 5: Jess7jay ($92.97 in chips) 
Seat 6: 9lKBXKTT6 ($101.28 in chips) 
Seat 7: matiko09 ($100 in chips) 
Seat 8: R1aki ($114 in chips) 
Seat 9: ApkawaDavit ($100 in chips) 
Kelvin sai: posts small blind $0.50
koksskrt: posts big blind $1
*** HOLE CARDS ***
Dealt to matiko09 [9d 5d]
Jess7jay: folds 
9lKBXKTT6: raises $3.50 to $4.50
matiko09: folds 
R1aki: folds 
ApkawaDavit: folds 
cap. marb: folds 
Kelvin sai: folds 
koksskrt: folds 
Uncalled bet ($3.50) returned to 9lKBXKTT6
9lKBXKTT6 collected $2.50 from pot
9lKBXKTT6: doesn't show hand 
*** SUMMARY ***
Total pot $2.50 | Rake $0 
Seat 1: cap. marb (button) folded before Flop (didn't bet)
Seat 3: Kelvin sai (small blind) folded before Flop
Seat 4: koksskrt (big blind) folded before Flop
Seat 5: Jess7jay folded before Flop (didn't bet)
Seat 6: 9lKBXKTT6 collected ($2.50)
Seat 7: matiko09 folded before Flop (didn't bet)
Seat 8: R1aki folded before Flop (didn't bet)
Seat 9: ApkawaDavit folded before Flop (didn't bet)





PokerStars Hand #152660501060:  Hold'em No Limit (€0.50/€1.00 EUR) - 2016/04/30 17:54:13 CET [2016/04/30 11:54:13 ET]
Table 'Benda' 9-max Seat #2 is the button
Seat 1: aquarua7 (€215.38 in chips) 
Seat 2: cap. marb (€38.50 in chips) 
Seat 3: R1aki (€100 in chips) 
Seat 4: fireball2112 (€73.12 in chips) 
Seat 5: chijara (€115.52 in chips) 
Seat 6: Nunzio1985ct (€44.61 in chips) 
Seat 7: Fivez (€108.12 in chips) 
Seat 8: matiko09 (€100 in chips) 
R1aki: posts small blind €0.50
fireball2112: posts big blind €1
*** HOLE CARDS ***
Dealt to matiko09 [5s 7c]
chijara: folds 
Nunzio1985ct: calls €1
Fivez: folds 
matiko09: folds 
aquarua7: folds 
cap. marb: folds 
R1aki: raises €3 to €4
fireball2112: folds 
Nunzio1985ct: calls €3
*** FLOP *** [Jc 8s Ts]
R1aki: checks 
Nunzio1985ct: checks 
*** TURN *** [Jc 8s Ts] [7d]
R1aki: checks 
Nunzio1985ct: checks 
*** RIVER *** [Jc 8s Ts 7d] [8d]
R1aki: bets €3
Nunzio1985ct: calls €3
*** SHOW DOWN ***
R1aki: shows [Kd Js] (two pair, Jacks and Eights)
Nunzio1985ct: mucks hand 
R1aki collected €14.25 from pot
*** SUMMARY ***
Total pot €15 | Rake €0.75 
Board [Jc 8s Ts 7d 8d]
Seat 1: aquarua7 folded before Flop (didn't bet)
Seat 2: cap. marb (button) folded before Flop (didn't bet)
Seat 3: R1aki (small blind) showed [Kd Js] and won (€14.25) with two pair, Jacks and Eights
Seat 4: fireball2112 (big blind) folded before Flop
Seat 5: chijara folded before Flop (didn't bet)
Seat 6: Nunzio1985ct mucked [4s 4c]
Seat 7: Fivez folded before Flop (didn't bet)
Seat 8: matiko09 folded before Flop (didn't bet)





PokerStars Hand #152660528337:  Hold'em No Limit ($0.50/$1.00 USD) - 2016/04/30 17:54:50 CET [2016/04/30 11:54:50 ET]
Table 'Raissa II' 9-max Seat #3 is the button
Seat 1: cap. marb ($38.50 in chips) 
Seat 3: Kelvin sai ($43.57 in chips) 
Seat 4: koksskrt ($114.20 in chips) 
Seat 5: Jess7jay ($92.97 in chips) 
Seat 6: 9lKBXKTT6 ($102.78 in chips) 
Seat 7: matiko09 ($100 in chips) 
Seat 8: R1aki ($114 in chips) 
Seat 9: ApkawaDavit ($100 in chips) 
koksskrt: posts small blind $0.50
Jess7jay: posts big blind $1
*** HOLE CARDS ***
Dealt to matiko09 [6c Jh]
9lKBXKTT6: folds 
matiko09: folds 
9lKBXKTT6 leaves the table
R1aki: folds 
ApkawaDavit: folds 
cap. marb: raises $1.12 to $2.12
Kelvin sai: folds 
koksskrt: folds 
Jess7jay: calls $1.12
*** FLOP *** [2d As 4c]
Jess7jay: checks 
cap. marb: bets $2.97
Jess7jay: folds 
Uncalled bet ($2.97) returned to cap. marb
cap. marb collected $4.50 from pot
ilaviiitech joins the table at seat #6 
cap. marb: doesn't show hand 
*** SUMMARY ***
Total pot $4.74 | Rake $0.24 
Board [2d As 4c]
Seat 1: cap. marb collected ($4.50)
Seat 3: Kelvin sai (button) folded before Flop (didn't bet)
Seat 4: koksskrt (small blind) folded before Flop
Seat 5: Jess7jay (big blind) folded on the Flop
Seat 6: 9lKBXKTT6 folded before Flop (didn't bet)
Seat 7: matiko09 folded before Flop (didn't bet)
Seat 8: R1aki folded before Flop (didn't bet)
Seat 9: ApkawaDavit folded before Flop (didn't bet)





PokerStars Hand #152660528777:  Hold'em No Limit ($0.50/$1.00 USD) - 2016/04/30 17:54:51 CET [2016/04/30 11:54:51 ET]
Table 'Tamariwa' 9-max Seat #4 is the button
Seat 1: matiko09 ($101.50 in chips) 
Seat 2: ilaviiitech ($100 in chips) 
Seat 3: Spid1 ($100 in chips) 
Seat 4: cap. marb ($40 in chips) 
Seat 5: Lobbyist98 ($79 in chips) 
Seat 7: azqanaz ($105.80 in chips) 
Seat 8: R1aki ($109.05 in chips) 
Seat 9: ApkawaDavit ($204.62 in chips) 
Lobbyist98: posts small blind $0.50
azqanaz: posts big blind $1
*** HOLE CARDS ***
Dealt to matiko09 [Qc 4c]
R1aki: folds 
ApkawaDavit: folds 
matiko09: folds 
ilaviiitech: raises $2 to $3
Spid1: folds 
El tourist joins the table at seat #6 
cap. marb: folds 
Lobbyist98: raises $3 to $6
azqanaz: folds 
ilaviiitech: calls $3
*** FLOP *** [5h 2h 7c]
Lobbyist98: bets $8
ilaviiitech: calls $8
*** TURN *** [5h 2h 7c] [Ts]
Lobbyist98: bets $20
ilaviiitech: folds 
Uncalled bet ($20) returned to Lobbyist98
Lobbyist98 collected $27.55 from pot
Lobbyist98: doesn't show hand 
*** SUMMARY ***
Total pot $29 | Rake $1.45 
Board [5h 2h 7c Ts]
Seat 1: matiko09 folded before Flop (didn't bet)
Seat 2: ilaviiitech folded on the Turn
Seat 3: Spid1 folded before Flop (didn't bet)
Seat 4: cap. marb (button) folded before Flop (didn't bet)
Seat 5: Lobbyist98 (small blind) collected ($27.55)
Seat 7: azqanaz (big blind) folded before Flop
Seat 8: R1aki folded before Flop (didn't bet)
Seat 9: ApkawaDavit folded before Flop (didn't bet)





PokerStars Hand #152660539246:  Hold'em No Limit (€0.50/€1.00 EUR) - 2016/04/30 17:55:05 CET [2016/04/30 11:55:05 ET]
Table 'Benda' 9-max Seat #3 is the button
Seat 1: aquarua7 (€215.38 in chips) 
Seat 2: cap. marb (€38.50 in chips) 
Seat 3: R1aki (€107.25 in chips) 
Seat 4: fireball2112 (€72.12 in chips) 
Seat 6: Nunzio1985ct (€37.61 in chips) 
Seat 7: Fivez (€108.12 in chips) 
Seat 8: matiko09 (€100 in chips) 
fireball2112: posts small blind €0.50
chijara: is sitting out 
chijara leaves the table
Nunzio1985ct: posts big blind €1
*** HOLE CARDS ***
Dealt to matiko09 [Kd Td]
Spid1 joins the table at seat #5 
Fivez: folds 
matiko09: raises €2 to €3
aquarua7: folds 
cap. marb: folds 
R1aki: folds 
fireball2112: folds 
Nunzio1985ct: folds 
Uncalled bet (€2) returned to matiko09
matiko09 collected €2.50 from pot
matiko09: doesn't show hand 
*** SUMMARY ***
Total pot €2.50 | Rake €0 
Seat 1: aquarua7 folded before Flop (didn't bet)
Seat 2: cap. marb folded before Flop (didn't bet)
Seat 3: R1aki (button) folded before Flop (didn't bet)
Seat 4: fireball2112 (small blind) folded before Flop
Seat 6: Nunzio1985ct (big blind) folded before Flop
Seat 7: Fivez folded before Flop (didn't bet)
Seat 8: matiko09 collected (€2.50)





PokerStars Hand #152660551695:  Hold'em No Limit (€0.50/€1.00 EUR) - 2016/04/30 17:55:27 CET [2016/04/30 11:55:27 ET]
Table 'Oceax II' 9-max Seat #2 is the button
Seat 1: Fivez (€100 in chips) 
Seat 2: Algarra1 (€61.28 in chips) 
Seat 5: Spid1 (€110.90 in chips) 
Seat 6: Sitech lehne (€50.60 in chips) 
Seat 7: chijara (€100 in chips) 
Seat 8: matiko09 (€101 in chips) 
Seat 9: sinkgraven (€140.20 in chips) 
Spid1: posts small blind €0.50
Sitech lehne: posts big blind €1
*** HOLE CARDS ***
Dealt to matiko09 [Qc 8h]
chijara: raises €2 to €3
matiko09: folds 
sinkgraven: folds 
Fivez: raises €6 to €9
Algarra1: folds 
Spid1: folds 
Sitech lehne: raises €6 to €15
chijara: folds 
Fivez: raises €13 to €28
Sitech lehne: raises €22.60 to €50.60 and is all-in
Fivez: calls €22.60
*** FLOP *** [Jd Ks 9h]
*** TURN *** [Jd Ks 9h] [2c]
*** RIVER *** [Jd Ks 9h 2c] [Qd]
*** SHOW DOWN ***
Sitech lehne: shows [7c 7h] (a pair of Sevens)
Fivez: shows [As Ah] (a pair of Aces)
Fivez collected €102.45 from pot
*** SUMMARY ***
Total pot €104.70 | Rake €2.25 
Board [Jd Ks 9h 2c Qd]
Seat 1: Fivez showed [As Ah] and won (€102.45) with a pair of Aces
Seat 2: Algarra1 (button) folded before Flop (didn't bet)
Seat 5: Spid1 (small blind) folded before Flop
Seat 6: Sitech lehne (big blind) showed [7c 7h] and lost with a pair of Sevens
Seat 7: chijara folded before Flop
Seat 8: matiko09 folded before Flop (didn't bet)
Seat 9: sinkgraven folded before Flop (didn't bet)





PokerStars Hand #152660552582:  Hold'em No Limit (€0.50/€1.00 EUR) - 2016/04/30 17:55:28 CET [2016/04/30 11:55:28 ET]
Table 'Benda' 9-max Seat #4 is the button
Seat 1: aquarua7 (€215.38 in chips) 
Seat 2: cap. marb (€38.50 in chips) 
Seat 3: R1aki (€107.25 in chips) 
Seat 4: fireball2112 (€71.62 in chips) 
Seat 6: Nunzio1985ct (€36.61 in chips) 
Seat 7: Fivez (€108.12 in chips) 
Seat 8: matiko09 (€101.50 in chips) 
Spid1 will be allowed to play after the button
Nunzio1985ct: posts small blind €0.50
Fivez: posts big blind €1
*** HOLE CARDS ***
Dealt to matiko09 [Kd 8d]
matiko09: folds 
aquarua7: folds 
cap. marb: folds 
R1aki: folds 
fireball2112: folds 
Nunzio1985ct: folds 
Uncalled bet (€0.50) returned to Fivez
Fivez collected €1 from pot
Fivez: doesn't show hand 
*** SUMMARY ***
Total pot €1 | Rake €0 
Seat 1: aquarua7 folded before Flop (didn't bet)
Seat 2: cap. marb folded before Flop (didn't bet)
Seat 3: R1aki folded before Flop (didn't bet)
Seat 4: fireball2112 (button) folded before Flop (didn't bet)
Seat 6: Nunzio1985ct (small blind) folded before Flop
Seat 7: Fivez (big blind) collected (€1)
Seat 8: matiko09 folded before Flop (didn't bet)





PokerStars Hand #152660558963:  Hold'em No Limit ($0.50/$1.00 USD) - 2016/04/30 17:55:40 CET [2016/04/30 11:55:40 ET]
Table 'Raissa II' 9-max Seat #4 is the button
Seat 1: cap. marb ($40.88 in chips) 
Seat 3: Kelvin sai ($43.57 in chips) 
Seat 4: koksskrt ($113.70 in chips) 
Seat 5: Jess7jay ($90.85 in chips) 
Seat 6: ilaviiitech ($100 in chips) 
Seat 7: matiko09 ($100 in chips) 
Seat 8: R1aki ($114 in chips) 
Seat 9: ApkawaDavit ($100 in chips) 
Jess7jay: posts small blind $0.50
ilaviiitech: posts big blind $1
*** HOLE CARDS ***
Dealt to matiko09 [9d 4s]
matiko09: folds 
R1aki: folds 
ApkawaDavit: folds 
cap. marb: folds 
Kelvin sai: raises $1 to $2
azzad2007 joins the table at seat #2 
koksskrt: calls $2
Jess7jay: calls $1.50
ilaviiitech: folds 
*** FLOP *** [Ad 8h 4h]
Jess7jay: checks 
Kelvin sai: bets $2
koksskrt: calls $2
Jess7jay: calls $2
*** TURN *** [Ad 8h 4h] [Kh]
Jess7jay: checks 
Kelvin sai: checks 
koksskrt: checks 
*** RIVER *** [Ad 8h 4h Kh] [Ks]
Jess7jay: checks 
Kelvin sai: checks 
koksskrt: checks 
*** SHOW DOWN ***
Jess7jay: shows [9s 9c] (two pair, Kings and Nines)
Kelvin sai: mucks hand 
koksskrt: shows [5s As] (two pair, Aces and Kings)
koksskrt collected $12.35 from pot
*** SUMMARY ***
Total pot $13 | Rake $0.65 
Board [Ad 8h 4h Kh Ks]
Seat 1: cap. marb folded before Flop (didn't bet)
Seat 3: Kelvin sai mucked [7d 7c]
Seat 4: koksskrt (button) showed [5s As] and won ($12.35) with two pair, Aces and Kings
Seat 5: Jess7jay (small blind) showed [9s 9c] and lost with two pair, Kings and Nines
Seat 6: ilaviiitech (big blind) folded before Flop
Seat 7: matiko09 folded before Flop (didn't bet)
Seat 8: R1aki folded before Flop (didn't bet)
Seat 9: ApkawaDavit folded before Flop (didn't bet)





PokerStars Hand #152660568008:  Hold'em No Limit (€0.50/€1.00 EUR) - 2016/04/30 17:55:56 CET [2016/04/30 11:55:56 ET]
Table 'Benda' 9-max Seat #6 is the button
Seat 1: aquarua7 (€215.38 in chips) 
Seat 2: cap. marb (€38.50 in chips) 
Seat 3: R1aki (€107.25 in chips) 
Seat 4: fireball2112 (€71.62 in chips) 
Seat 6: Nunzio1985ct (€36.11 in chips) 
Seat 7: Fivez (€108.62 in chips) 
Seat 8: matiko09 (€101.50 in chips) 
Fivez: posts small blind €0.50
matiko09: posts big blind €1
Spid1: sits out 
*** HOLE CARDS ***
Dealt to matiko09 [2c Th]
aquarua7: folds 
cap. marb: folds 
R1aki: folds 
fireball2112: raises €1 to €2
Nunzio1985ct: folds 
Fivez: folds 
matiko09: folds 
Uncalled bet (€1) returned to fireball2112
fireball2112 collected €2.50 from pot
fireball2112: doesn't show hand 
*** SUMMARY ***
Total pot €2.50 | Rake €0 
Seat 1: aquarua7 folded before Flop (didn't bet)
Seat 2: cap. marb folded before Flop (didn't bet)
Seat 3: R1aki folded before Flop (didn't bet)
Seat 4: fireball2112 collected (€2.50)
Seat 6: Nunzio1985ct (button) folded before Flop (didn't bet)
Seat 7: Fivez (small blind) folded before Flop
Seat 8: matiko09 (big blind) folded before Flop





PokerStars Hand #152660588314:  Hold'em No Limit ($0.50/$1.00 USD) - 2016/04/30 17:56:33 CET [2016/04/30 11:56:33 ET]
Table 'Arcturus' 9-max Seat #7 is the button
Seat 1: matiko09 ($100 in chips) 
Seat 2: Khaine_CM ($106.85 in chips) 
Seat 3: Spid1 ($100 in chips) 
Seat 4: cap. marb ($38.50 in chips) 
Seat 5: koksskrt ($100 in chips) 
Seat 6: JimineyCrik ($170.56 in chips) 
Seat 7: terrytsui111 ($120.78 in chips) 
Seat 8: ApkawaDavit ($106.90 in chips) 
ApkawaDavit: posts small blind $0.50
matiko09: posts big blind $1
*** HOLE CARDS ***
Dealt to matiko09 [2c 5c]
Khaine_CM: folds 
Spid1: folds 
cap. marb: folds 
koksskrt: folds 
JimineyCrik: folds 
terrytsui111: raises $2 to $3
ApkawaDavit: folds 
matiko09: folds 
Uncalled bet ($2) returned to terrytsui111
terrytsui111 collected $2.50 from pot
terrytsui111: doesn't show hand 
*** SUMMARY ***
Total pot $2.50 | Rake $0 
Seat 1: matiko09 (big blind) folded before Flop
Seat 2: Khaine_CM folded before Flop (didn't bet)
Seat 3: Spid1 folded before Flop (didn't bet)
Seat 4: cap. marb folded before Flop (didn't bet)
Seat 5: koksskrt folded before Flop (didn't bet)
Seat 6: JimineyCrik folded before Flop (didn't bet)
Seat 7: terrytsui111 (button) collected ($2.50)
Seat 8: ApkawaDavit (small blind) folded before Flop





PokerStars Hand #152660592735:  Hold'em No Limit ($0.50/$1.00 USD) - 2016/04/30 17:56:41 CET [2016/04/30 11:56:41 ET]
Table 'Tamariwa' 9-max Seat #5 is the button
Seat 1: matiko09 ($101.50 in chips) 
Seat 2: ilaviiitech ($100 in chips) 
Seat 3: Spid1 ($100 in chips) 
Seat 4: cap. marb ($40 in chips) 
Seat 5: Lobbyist98 ($92.55 in chips) 
Seat 7: azqanaz ($104.80 in chips) 
Seat 8: R1aki ($109.05 in chips) 
Seat 9: ApkawaDavit ($204.62 in chips) 
El tourist will be allowed to play after the button
azqanaz: posts small blind $0.50
R1aki: posts big blind $1
*** HOLE CARDS ***
Dealt to matiko09 [5d 9c]
ApkawaDavit: folds 
matiko09: folds 
ilaviiitech: folds 
Spid1: folds 
cap. marb: folds 
Lobbyist98: raises $2 to $3
azqanaz: calls $2.50
R1aki: folds 
*** FLOP *** [As 4s 2d]
azqanaz: checks 
Lobbyist98: bets $4
azqanaz: calls $4
*** TURN *** [As 4s 2d] [5s]
azqanaz: checks 
Lobbyist98: checks 
*** RIVER *** [As 4s 2d 5s] [5h]
azqanaz: bets $7.12
Lobbyist98: folds 
Uncalled bet ($7.12) returned to azqanaz
azqanaz collected $14.25 from pot
*** SUMMARY ***
Total pot $15 | Rake $0.75 
Board [As 4s 2d 5s 5h]
Seat 1: matiko09 folded before Flop (didn't bet)
Seat 2: ilaviiitech folded before Flop (didn't bet)
Seat 3: Spid1 folded before Flop (didn't bet)
Seat 4: cap. marb folded before Flop (didn't bet)
Seat 5: Lobbyist98 (button) folded on the River
Seat 7: azqanaz (small blind) collected ($14.25)
Seat 8: R1aki (big blind) folded before Flop
Seat 9: ApkawaDavit folded before Flop (didn't bet)





PokerStars Hand #152660595197:  Hold'em No Limit (€0.50/€1.00 EUR) - 2016/04/30 17:56:45 CET [2016/04/30 11:56:45 ET]
Table 'Benda' 9-max Seat #7 is the button
Seat 1: aquarua7 (€215.38 in chips) 
Seat 2: cap. marb (€38.50 in chips) 
Seat 3: R1aki (€107.25 in chips) 
Seat 4: fireball2112 (€73.12 in chips) 
Seat 6: Nunzio1985ct (€36.11 in chips) 
Seat 7: Fivez (€108.12 in chips) 
Seat 8: matiko09 (€100.50 in chips) 
matiko09: posts small blind €0.50
aquarua7: posts big blind €1
Spid1: sits out 
*** HOLE CARDS ***
Dealt to matiko09 [3h 9d]
cap. marb: folds 
R1aki: folds 
fireball2112: raises €2 to €3
Nunzio1985ct has timed out
Nunzio1985ct: folds 
Fivez: folds 
matiko09: folds 
aquarua7: folds 
Uncalled bet (€2) returned to fireball2112
fireball2112 collected €2.50 from pot
fireball2112: doesn't show hand 
*** SUMMARY ***
Total pot €2.50 | Rake €0 
Seat 1: aquarua7 (big blind) folded before Flop
Seat 2: cap. marb folded before Flop (didn't bet)
Seat 3: R1aki folded before Flop (didn't bet)
Seat 4: fireball2112 collected (€2.50)
Seat 6: Nunzio1985ct folded before Flop (didn't bet)
Seat 7: Fivez (button) folded before Flop (didn't bet)
Seat 8: matiko09 (small blind) folded before Flop





PokerStars Hand #152660595425:  Hold'em No Limit (€0.50/€1.00 EUR) - 2016/04/30 17:56:45 CET [2016/04/30 11:56:45 ET]
Table 'Oceax II' 9-max Seat #5 is the button
Seat 1: Fivez (€151.85 in chips) 
Seat 2: Algarra1 (€61.28 in chips) 
Seat 5: Spid1 (€110.40 in chips) 
Seat 7: chijara (€100 in chips) 
Seat 8: matiko09 (€101 in chips) 
Seat 9: sinkgraven (€140.20 in chips) 
chijara: posts small blind €0.50
matiko09: posts big blind €1
*** HOLE CARDS ***
Dealt to matiko09 [9h Tc]
sinkgraven: folds 
Fivez: folds 
Sitech lehne leaves the table
Algarra1: calls €1
Spid1: raises €4 to €5
sinkgraven said, "lol?"
chijara: folds 
cap. marb joins the table at seat #6 
matiko09: folds 
Algarra1: folds 
Uncalled bet (€4) returned to Spid1
Spid1 collected €3.50 from pot
Spid1: doesn't show hand 
*** SUMMARY ***
Total pot €3.50 | Rake €0 
Seat 1: Fivez folded before Flop (didn't bet)
Seat 2: Algarra1 folded before Flop
Seat 5: Spid1 (button) collected (€3.50)
Seat 7: chijara (small blind) folded before Flop
Seat 8: matiko09 (big blind) folded before Flop
Seat 9: sinkgraven folded before Flop (didn't bet)





PokerStars Hand #152660606231:  Hold'em No Limit ($0.50/$1.00 USD) - 2016/04/30 17:57:05 CET [2016/04/30 11:57:05 ET]
Table 'Arcturus' 9-max Seat #8 is the button
Seat 1: matiko09 ($100 in chips) 
Seat 2: Khaine_CM ($106.85 in chips) 
Seat 3: Spid1 ($100 in chips) 
Seat 4: cap. marb ($38.50 in chips) 
Seat 5: koksskrt ($100 in chips) 
Seat 6: JimineyCrik ($170.56 in chips) 
Seat 7: terrytsui111 ($122.28 in chips) 
Seat 8: ApkawaDavit ($106.40 in chips) 
matiko09: posts small blind $0.50
Khaine_CM: posts big blind $1
*** HOLE CARDS ***
Dealt to matiko09 [7h 2c]
Spid1: folds 
cap. marb: folds 
koksskrt: raises $2 to $3
JimineyCrik: folds 
terrytsui111: folds 
ApkawaDavit: folds 
matiko09: folds 
Khaine_CM: folds 
Uncalled bet ($2) returned to koksskrt
koksskrt collected $2.50 from pot
koksskrt: doesn't show hand 
*** SUMMARY ***
Total pot $2.50 | Rake $0 
Seat 1: matiko09 (small blind) folded before Flop
Seat 2: Khaine_CM (big blind) folded before Flop
Seat 3: Spid1 folded before Flop (didn't bet)
Seat 4: cap. marb folded before Flop (didn't bet)
Seat 5: koksskrt collected ($2.50)
Seat 6: JimineyCrik folded before Flop (didn't bet)
Seat 7: terrytsui111 folded before Flop (didn't bet)
Seat 8: ApkawaDavit (button) folded before Flop (didn't bet)





PokerStars Hand #152660607608:  Hold'em No Limit (€0.50/€1.00 EUR) - 2016/04/30 17:57:07 CET [2016/04/30 11:57:07 ET]
Table 'Oceax II' 9-max Seat #7 is the button
Seat 1: Fivez (€151.85 in chips) 
Seat 2: Algarra1 (€60.28 in chips) 
Seat 5: Spid1 (€112.90 in chips) 
Seat 7: chijara (€100 in chips) 
Seat 8: matiko09 (€100 in chips) 
matiko09: posts small blind €0.50
sinkgraven: is sitting out 
Fivez: posts big blind €1
cap. marb: sits out 
*** HOLE CARDS ***
Dealt to matiko09 [Qc 4h]
Algarra1: folds 
Spid1: folds 
sinkgraven leaves the table
azzad2007 joins the table at seat #9 
chijara: raises €1.20 to €2.20
azzad2007 leaves the table
matiko09: folds 
Fivez: folds 
Uncalled bet (€1.20) returned to chijara
chijara collected €2.50 from pot
chijara: doesn't show hand 
*** SUMMARY ***
Total pot €2.50 | Rake €0 
Seat 1: Fivez (big blind) folded before Flop
Seat 2: Algarra1 folded before Flop (didn't bet)
Seat 5: Spid1 folded before Flop (didn't bet)
Seat 7: chijara (button) collected (€2.50)
Seat 8: matiko09 (small blind) folded before Flop





PokerStars Hand #152660614140:  Hold'em No Limit ($0.50/$1.00 USD) - 2016/04/30 17:57:19 CET [2016/04/30 11:57:19 ET]
Table 'Goto' 9-max Seat #8 is the button
Seat 1: naaaate_diaz ($106.23 in chips) 
Seat 3: matiko09 ($100 in chips) 
Seat 4: koksskrt ($100 in chips) 
Seat 5: hotsoo ($50.25 in chips) 
Seat 6: puszi77 ($278.26 in chips) 
Seat 7: Spid1 ($100 in chips) 
Seat 8: R1aki ($100 in chips) 
naaaate_diaz: posts small blind $0.50
chijara: is sitting out 
matiko09: posts big blind $1
*** HOLE CARDS ***
Dealt to matiko09 [Qs Js]
chijara leaves the table
koksskrt: raises $2 to $3
Khaine_CM joins the table at seat #2 
hotsoo: folds 
puszi77: calls $3
Spid1: folds 
R1aki: folds 
naaaate_diaz: folds 
matiko09: calls $2
*** FLOP *** [9s 4d 7s]
matiko09: checks 
koksskrt: checks 
puszi77: checks 
*** TURN *** [9s 4d 7s] [Qh]
matiko09: bets $5.86
koksskrt: raises $10.14 to $16
puszi77: folds 
matiko09: raises $33 to $49
koksskrt: folds 
Uncalled bet ($33) returned to matiko09
matiko09 collected $39.42 from pot
matiko09: doesn't show hand 
*** SUMMARY ***
Total pot $41.50 | Rake $2.08 
Board [9s 4d 7s Qh]
Seat 1: naaaate_diaz (small blind) folded before Flop
Seat 3: matiko09 (big blind) collected ($39.42)
Seat 4: koksskrt folded on the Turn
Seat 5: hotsoo folded before Flop (didn't bet)
Seat 6: puszi77 folded on the Turn
Seat 7: Spid1 folded before Flop (didn't bet)
Seat 8: R1aki (button) folded before Flop (didn't bet)





PokerStars Hand #152660619364:  Hold'em No Limit ($0.50/$1.00 USD) - 2016/04/30 17:57:28 CET [2016/04/30 11:57:28 ET]
Table 'Arcturus' 9-max Seat #1 is the button
Seat 1: matiko09 ($100 in chips) 
Seat 2: Khaine_CM ($105.85 in chips) 
Seat 3: Spid1 ($100 in chips) 
Seat 4: cap. marb ($38.50 in chips) 
Seat 5: koksskrt ($101.50 in chips) 
Seat 6: JimineyCrik ($170.56 in chips) 
Seat 7: terrytsui111 ($122.28 in chips) 
Seat 8: ApkawaDavit ($106.40 in chips) 
Khaine_CM: posts small blind $0.50
Spid1: posts big blind $1
*** HOLE CARDS ***
Dealt to matiko09 [Ah 8h]
cap. marb: folds 
koksskrt: folds 
JimineyCrik: folds 
terrytsui111: folds 
ApkawaDavit: folds 
matiko09: raises $1.27 to $2.27
Khaine_CM: folds 
Spid1: folds 
Uncalled bet ($1.27) returned to matiko09
matiko09 collected $2.50 from pot
matiko09: doesn't show hand 
*** SUMMARY ***
Total pot $2.50 | Rake $0 
Seat 1: matiko09 (button) collected ($2.50)
Seat 2: Khaine_CM (small blind) folded before Flop
Seat 3: Spid1 (big blind) folded before Flop
Seat 4: cap. marb folded before Flop (didn't bet)
Seat 5: koksskrt folded before Flop (didn't bet)
Seat 6: JimineyCrik folded before Flop (didn't bet)
Seat 7: terrytsui111 folded before Flop (didn't bet)
Seat 8: ApkawaDavit folded before Flop (didn't bet)





PokerStars Hand #152660620205:  Hold'em No Limit (€0.50/€1.00 EUR) - 2016/04/30 17:57:29 CET [2016/04/30 11:57:29 ET]
Table 'Oceax II' 9-max Seat #8 is the button
Seat 1: Fivez (€150.85 in chips) 
Seat 2: Algarra1 (€60.28 in chips) 
Seat 5: Spid1 (€112.90 in chips) 
Seat 7: chijara (€101.50 in chips) 
Seat 8: matiko09 (€100 in chips) 
Fivez: posts small blind €0.50
Algarra1: posts big blind €1
cap. marb: sits out 
*** HOLE CARDS ***
Dealt to matiko09 [8s 2s]
Spid1: folds 
chijara: folds 
matiko09: folds 
Fivez: folds 
Uncalled bet (€0.50) returned to Algarra1
Algarra1 collected €1 from pot
Algarra1: doesn't show hand 
*** SUMMARY ***
Total pot €1 | Rake €0 
Seat 1: Fivez (small blind) folded before Flop
Seat 2: Algarra1 (big blind) collected (€1)
Seat 5: Spid1 folded before Flop (didn't bet)
Seat 7: chijara folded before Flop (didn't bet)
Seat 8: matiko09 (button) folded before Flop (didn't bet)





PokerStars Hand #152660621855:  Hold'em No Limit ($0.50/$1.00 USD) - 2016/04/30 17:57:32 CET [2016/04/30 11:57:32 ET]
Table 'Raissa II' 9-max Seat #5 is the button
Seat 1: cap. marb ($40.88 in chips) 
Seat 3: Kelvin sai ($39.57 in chips) 
Seat 4: koksskrt ($122.05 in chips) 
Seat 5: Jess7jay ($86.85 in chips) 
Seat 6: ilaviiitech ($100 in chips) 
Seat 7: matiko09 ($100 in chips) 
Seat 8: R1aki ($114 in chips) 
Seat 9: ApkawaDavit ($100 in chips) 
ilaviiitech: posts small blind $0.50
matiko09: posts big blind $1
azzad2007: sits out 
*** HOLE CARDS ***
Dealt to matiko09 [7h 8c]
R1aki: folds 
ApkawaDavit: raises $2 to $3
cap. marb: folds 
Kelvin sai: folds 
koksskrt: folds 
Jess7jay: folds 
ilaviiitech: calls $2.50
matiko09: folds 
*** FLOP *** [5d 6d Ts]
ilaviiitech: bets $4.43
ApkawaDavit: folds 
Uncalled bet ($4.43) returned to ilaviiitech
ilaviiitech collected $6.65 from pot
ilaviiitech: doesn't show hand 
*** SUMMARY ***
Total pot $7 | Rake $0.35 
Board [5d 6d Ts]
Seat 1: cap. marb folded before Flop (didn't bet)
Seat 3: Kelvin sai folded before Flop (didn't bet)
Seat 4: koksskrt folded before Flop (didn't bet)
Seat 5: Jess7jay (button) folded before Flop (didn't bet)
Seat 6: ilaviiitech (small blind) collected ($6.65)
Seat 7: matiko09 (big blind) folded before Flop
Seat 8: R1aki folded before Flop (didn't bet)
Seat 9: ApkawaDavit folded on the Flop





PokerStars Hand #152660625938:  Hold'em No Limit (€0.50/€1.00 EUR) - 2016/04/30 17:57:39 CET [2016/04/30 11:57:39 ET]
Table 'Benda' 9-max Seat #8 is the button
Seat 1: aquarua7 (€214.38 in chips) 
Seat 2: cap. marb (€38.50 in chips) 
Seat 3: R1aki (€107.25 in chips) 
Seat 4: fireball2112 (€74.62 in chips) 
Seat 7: Fivez (€108.12 in chips) 
Seat 8: matiko09 (€100 in chips) 
aquarua7: posts small blind €0.50
cap. marb: posts big blind €1
Spid1: sits out 
*** HOLE CARDS ***
Dealt to matiko09 [7s Tc]
R1aki: folds 
fireball2112: folds 
Fivez: folds 
matiko09: folds 
aquarua7: folds 
Uncalled bet (€0.50) returned to cap. marb
cap. marb collected €1 from pot
cap. marb: doesn't show hand 
*** SUMMARY ***
Total pot €1 | Rake €0 
Seat 1: aquarua7 (small blind) folded before Flop
Seat 2: cap. marb (big blind) collected (€1)
Seat 3: R1aki folded before Flop (didn't bet)
Seat 4: fireball2112 folded before Flop (didn't bet)
Seat 7: Fivez folded before Flop (didn't bet)
Seat 8: matiko09 (button) folded before Flop (didn't bet)





PokerStars Hand #152660627191:  Hold'em No Limit (€0.50/€1.00 EUR) - 2016/04/30 17:57:42 CET [2016/04/30 11:57:42 ET]
Table 'Oceax II' 9-max Seat #1 is the button
Seat 1: Fivez (€150.35 in chips) 
Seat 2: Algarra1 (€60.78 in chips) 
Seat 5: Spid1 (€112.90 in chips) 
Seat 7: chijara (€101.50 in chips) 
Seat 8: matiko09 (€100 in chips) 
Algarra1: posts small blind €0.50
Spid1: posts big blind €1
cap. marb: sits out 
*** HOLE CARDS ***
Dealt to matiko09 [Ac 9c]
chijara: raises €2 to €3
matiko09: raises €6.59 to €9.59
Fivez: folds 
Algarra1: folds 
Spid1: folds 
chijara: calls €6.59
*** FLOP *** [9d 5d As]
chijara: checks 
matiko09: bets €10.50
chijara: folds 
Uncalled bet (€10.50) returned to matiko09
matiko09 collected €19.65 from pot
matiko09: doesn't show hand 
*** SUMMARY ***
Total pot €20.68 | Rake €1.03 
Board [9d 5d As]
Seat 1: Fivez (button) folded before Flop (didn't bet)
Seat 2: Algarra1 (small blind) folded before Flop
Seat 5: Spid1 (big blind) folded before Flop
Seat 7: chijara folded on the Flop
Seat 8: matiko09 collected (€19.65)





PokerStars Hand #152660628638:  Hold'em No Limit ($0.50/$1.00 USD) - 2016/04/30 17:57:44 CET [2016/04/30 11:57:44 ET]
Table 'Tamariwa' 9-max Seat #7 is the button
Seat 1: matiko09 ($101.50 in chips) 
Seat 2: ilaviiitech ($100 in chips) 
Seat 3: Spid1 ($100 in chips) 
Seat 4: cap. marb ($40 in chips) 
Seat 5: Lobbyist98 ($85.55 in chips) 
Seat 6: El tourist ($60 in chips) 
Seat 7: azqanaz ($112.05 in chips) 
Seat 8: R1aki ($108.05 in chips) 
Seat 9: ApkawaDavit ($204.62 in chips) 
R1aki: posts small blind $0.50
ApkawaDavit: posts big blind $1
El tourist: posts big blind $1
*** HOLE CARDS ***
Dealt to matiko09 [Qc As]
matiko09: raises $3 to $4
ilaviiitech: folds 
Spid1: folds 
cap. marb: folds 
Lobbyist98: folds 
El tourist: folds 
azqanaz: folds 
R1aki: folds 
ApkawaDavit: folds 
Uncalled bet ($3) returned to matiko09
matiko09 collected $3.50 from pot
matiko09: doesn't show hand 
*** SUMMARY ***
Total pot $3.50 | Rake $0 
Seat 1: matiko09 collected ($3.50)
Seat 2: ilaviiitech folded before Flop (didn't bet)
Seat 3: Spid1 folded before Flop (didn't bet)
Seat 4: cap. marb folded before Flop (didn't bet)
Seat 5: Lobbyist98 folded before Flop (didn't bet)
Seat 6: El tourist folded before Flop
Seat 7: azqanaz (button) folded before Flop (didn't bet)
Seat 8: R1aki (small blind) folded before Flop
Seat 9: ApkawaDavit (big blind) folded before Flop





PokerStars Hand #152660628725:  Hold'em No Limit ($0.50/$1.00 USD) - 2016/04/30 17:57:44 CET [2016/04/30 11:57:44 ET]
Table 'Arcturus' 9-max Seat #2 is the button
Seat 1: matiko09 ($101.50 in chips) 
Seat 2: Khaine_CM ($105.35 in chips) 
Seat 3: Spid1 ($100 in chips) 
Seat 4: cap. marb ($38.50 in chips) 
Seat 5: koksskrt ($101.50 in chips) 
Seat 6: JimineyCrik ($170.56 in chips) 
Seat 7: terrytsui111 ($122.28 in chips) 
Seat 8: ApkawaDavit ($106.40 in chips) 
Spid1: posts small blind $0.50
cap. marb: posts big blind $1
*** HOLE CARDS ***
Dealt to matiko09 [Qh 8c]
koksskrt: folds 
JimineyCrik: folds 
terrytsui111: folds 
ApkawaDavit: folds 
matiko09: folds 
Khaine_CM: raises $1 to $2
Spid1: folds 
cap. marb: folds 
Uncalled bet ($1) returned to Khaine_CM
Khaine_CM collected $2.50 from pot
Khaine_CM: doesn't show hand 
*** SUMMARY ***
Total pot $2.50 | Rake $0 
Seat 1: matiko09 folded before Flop (didn't bet)
Seat 2: Khaine_CM (button) collected ($2.50)
Seat 3: Spid1 (small blind) folded before Flop
Seat 4: cap. marb (big blind) folded before Flop
Seat 5: koksskrt folded before Flop (didn't bet)
Seat 6: JimineyCrik folded before Flop (didn't bet)
Seat 7: terrytsui111 folded before Flop (didn't bet)
Seat 8: ApkawaDavit folded before Flop (didn't bet)





PokerStars Hand #152660636603:  Hold'em No Limit (€0.50/€1.00 EUR) - 2016/04/30 17:57:58 CET [2016/04/30 11:57:58 ET]
Table 'Benda' 9-max Seat #1 is the button
Seat 1: aquarua7 (€213.88 in chips) 
Seat 2: cap. marb (€39 in chips) 
Seat 3: R1aki (€107.25 in chips) 
Seat 4: fireball2112 (€74.62 in chips) 
Seat 7: Fivez (€108.12 in chips) 
Seat 8: matiko09 (€100 in chips) 
cap. marb: posts small blind €0.50
R1aki: posts big blind €1
Spid1: sits out 
*** HOLE CARDS ***
Dealt to matiko09 [5c Qs]
fireball2112: folds 
Fivez: folds 
matiko09: folds 
aquarua7: folds 
cap. marb: folds 
Uncalled bet (€0.50) returned to R1aki
R1aki collected €1 from pot
R1aki: doesn't show hand 
*** SUMMARY ***
Total pot €1 | Rake €0 
Seat 1: aquarua7 (button) folded before Flop (didn't bet)
Seat 2: cap. marb (small blind) folded before Flop
Seat 3: R1aki (big blind) collected (€1)
Seat 4: fireball2112 folded before Flop (didn't bet)
Seat 7: Fivez folded before Flop (didn't bet)
Seat 8: matiko09 folded before Flop (didn't bet)





PokerStars Hand #152660646350:  Hold'em No Limit ($0.50/$1.00 USD) - 2016/04/30 17:58:11 CET [2016/04/30 11:58:11 ET]
Table 'Arcturus' 9-max Seat #3 is the button
Seat 1: matiko09 ($101.50 in chips) 
Seat 2: Khaine_CM ($106.85 in chips) 
Seat 3: Spid1 ($100 in chips) 
Seat 4: cap. marb ($37.50 in chips) 
Seat 5: koksskrt ($101.50 in chips) 
Seat 6: JimineyCrik ($170.56 in chips) 
Seat 7: terrytsui111 ($122.28 in chips) 
Seat 8: ApkawaDavit ($106.40 in chips) 
cap. marb: posts small blind $0.50
koksskrt: posts big blind $1
*** HOLE CARDS ***
Dealt to matiko09 [Kh 7s]
JimineyCrik: folds 
terrytsui111: folds 
ApkawaDavit: folds 
matiko09: folds 
Khaine_CM: folds 
Spid1: raises $1.50 to $2.50
cap. marb: folds 
koksskrt: calls $1.50
*** FLOP *** [3d 8s 9h]
koksskrt: checks 
Spid1: checks 
*** TURN *** [3d 8s 9h] [3h]
koksskrt: checks 
Spid1: bets $3.50
koksskrt: folds 
Uncalled bet ($3.50) returned to Spid1
Spid1 collected $5.22 from pot
*** SUMMARY ***
Total pot $5.50 | Rake $0.28 
Board [3d 8s 9h 3h]
Seat 1: matiko09 folded before Flop (didn't bet)
Seat 2: Khaine_CM folded before Flop (didn't bet)
Seat 3: Spid1 (button) collected ($5.22)
Seat 4: cap. marb (small blind) folded before Flop
Seat 5: koksskrt (big blind) folded on the Turn
Seat 6: JimineyCrik folded before Flop (didn't bet)
Seat 7: terrytsui111 folded before Flop (didn't bet)
Seat 8: ApkawaDavit folded before Flop (didn't bet)





PokerStars Hand #152660650890:  Hold'em No Limit (€0.50/€1.00 EUR) - 2016/04/30 17:58:18 CET [2016/04/30 11:58:18 ET]
Table 'Benda' 9-max Seat #2 is the button
Seat 1: aquarua7 (€213.88 in chips) 
Seat 2: cap. marb (€38.50 in chips) 
Seat 3: R1aki (€107.75 in chips) 
Seat 4: fireball2112 (€74.62 in chips) 
Seat 7: Fivez (€108.12 in chips) 
Seat 8: matiko09 (€100 in chips) 
R1aki: posts small blind €0.50
fireball2112: posts big blind €1
Spid1: sits out 
*** HOLE CARDS ***
Dealt to matiko09 [7d Th]
Fivez: folds 
matiko09: folds 
aquarua7: folds 
cap. marb: folds 
R1aki: folds 
Uncalled bet (€0.50) returned to fireball2112
fireball2112 collected €1 from pot
fireball2112: doesn't show hand 
*** SUMMARY ***
Total pot €1 | Rake €0 
Seat 1: aquarua7 folded before Flop (didn't bet)
Seat 2: cap. marb (button) folded before Flop (didn't bet)
Seat 3: R1aki (small blind) folded before Flop
Seat 4: fireball2112 (big blind) collected (€1)
Seat 7: Fivez folded before Flop (didn't bet)
Seat 8: matiko09 folded before Flop (didn't bet)





PokerStars Hand #152660654138:  Hold'em No Limit ($0.50/$1.00 USD) - 2016/04/30 17:58:24 CET [2016/04/30 11:58:24 ET]
Table 'Tamariwa' 9-max Seat #8 is the button
Seat 1: matiko09 ($104 in chips) 
Seat 2: ilaviiitech ($100 in chips) 
Seat 3: Spid1 ($100 in chips) 
Seat 4: cap. marb ($40 in chips) 
Seat 5: Lobbyist98 ($85.55 in chips) 
Seat 6: El tourist ($59 in chips) 
Seat 7: azqanaz ($112.05 in chips) 
Seat 8: R1aki ($107.55 in chips) 
Seat 9: ApkawaDavit ($203.62 in chips) 
ApkawaDavit: posts small blind $0.50
matiko09: posts big blind $1
*** HOLE CARDS ***
Dealt to matiko09 [7d 9s]
ilaviiitech: folds 
Spid1: folds 
cap. marb: folds 
Lobbyist98: folds 
El tourist: folds 
azqanaz: folds 
R1aki: raises $1.50 to $2.50
ApkawaDavit: folds 
matiko09: folds 
Uncalled bet ($1.50) returned to R1aki
R1aki collected $2.50 from pot
R1aki: doesn't show hand 
*** SUMMARY ***
Total pot $2.50 | Rake $0 
Seat 1: matiko09 (big blind) folded before Flop
Seat 2: ilaviiitech folded before Flop (didn't bet)
Seat 3: Spid1 folded before Flop (didn't bet)
Seat 4: cap. marb folded before Flop (didn't bet)
Seat 5: Lobbyist98 folded before Flop (didn't bet)
Seat 6: El tourist folded before Flop (didn't bet)
Seat 7: azqanaz folded before Flop (didn't bet)
Seat 8: R1aki (button) collected ($2.50)
Seat 9: ApkawaDavit (small blind) folded before Flop





PokerStars Hand #152660653703:  Hold'em No Limit ($0.50/$1.00 USD) - 2016/04/30 17:58:24 CET [2016/04/30 11:58:24 ET]
Table 'Raissa II' 9-max Seat #6 is the button
Seat 1: cap. marb ($40.88 in chips) 
Seat 3: Kelvin sai ($39.57 in chips) 
Seat 4: koksskrt ($122.05 in chips) 
Seat 5: Jess7jay ($86.85 in chips) 
Seat 6: ilaviiitech ($103.65 in chips) 
Seat 7: matiko09 ($100 in chips) 
Seat 8: R1aki ($114 in chips) 
Seat 9: ApkawaDavit ($100 in chips) 
matiko09: posts small blind $0.50
R1aki: posts big blind $1
azzad2007: sits out 
*** HOLE CARDS ***
Dealt to matiko09 [4c 7c]
ApkawaDavit: raises $2 to $3
cap. marb: folds 
Kelvin sai: folds 
koksskrt: folds 
Jess7jay: folds 
ilaviiitech: folds 
matiko09: folds 
R1aki: folds 
Uncalled bet ($2) returned to ApkawaDavit
ApkawaDavit collected $2.50 from pot
ApkawaDavit: doesn't show hand 
*** SUMMARY ***
Total pot $2.50 | Rake $0 
Seat 1: cap. marb folded before Flop (didn't bet)
Seat 3: Kelvin sai folded before Flop (didn't bet)
Seat 4: koksskrt folded before Flop (didn't bet)
Seat 5: Jess7jay folded before Flop (didn't bet)
Seat 6: ilaviiitech (button) folded before Flop (didn't bet)
Seat 7: matiko09 (small blind) folded before Flop
Seat 8: R1aki (big blind) folded before Flop
Seat 9: ApkawaDavit collected ($2.50)





PokerStars Hand #152660658634:  Hold'em No Limit (€0.50/€1.00 EUR) - 2016/04/30 17:58:32 CET [2016/04/30 11:58:32 ET]
Table 'Benda' 9-max Seat #3 is the button
Seat 1: aquarua7 (€213.88 in chips) 
Seat 2: cap. marb (€38.50 in chips) 
Seat 3: R1aki (€107.25 in chips) 
Seat 4: fireball2112 (€75.12 in chips) 
Seat 5: Spid1 (€104 in chips) 
Seat 7: Fivez (€108.12 in chips) 
Seat 8: matiko09 (€100 in chips) 
fireball2112: posts small blind €0.50
Spid1: posts big blind €1
*** HOLE CARDS ***
Dealt to matiko09 [Kd 9s]
Fivez: folds 
matiko09: folds 
aquarua7: raises €1.50 to €2.50
cap. marb: folds 
R1aki: folds 
fireball2112: folds 
Spid1: folds 
Uncalled bet (€1.50) returned to aquarua7
aquarua7 collected €2.50 from pot
aquarua7: doesn't show hand 
*** SUMMARY ***
Total pot €2.50 | Rake €0 
Seat 1: aquarua7 collected (€2.50)
Seat 2: cap. marb folded before Flop (didn't bet)
Seat 3: R1aki (button) folded before Flop (didn't bet)
Seat 4: fireball2112 (small blind) folded before Flop
Seat 5: Spid1 (big blind) folded before Flop
Seat 7: Fivez folded before Flop (didn't bet)
Seat 8: matiko09 folded before Flop (didn't bet)





PokerStars Hand #152660660068:  Hold'em No Limit (€0.50/€1.00 EUR) - 2016/04/30 17:58:35 CET [2016/04/30 11:58:35 ET]
Table 'Oceax II' 9-max Seat #2 is the button
Seat 1: Fivez (€150.35 in chips) 
Seat 2: Algarra1 (€60.28 in chips) 
Seat 5: Spid1 (€111.90 in chips) 
Seat 6: cap. marb (€40 in chips) 
Seat 7: chijara (€100 in chips) 
Seat 8: matiko09 (€110.06 in chips) 
Spid1: posts small blind €0.50
cap. marb: posts big blind €1
*** HOLE CARDS ***
Dealt to matiko09 [Th 7c]
chijara: folds 
matiko09: folds 
Fivez: folds 
Algarra1: calls €1
Spid1: folds 
cap. marb: checks 
*** FLOP *** [8h Kc 4c]
cap. marb: checks 
Algarra1: checks 
*** TURN *** [8h Kc 4c] [5c]
cap. marb: bets €1.57
Algarra1: folds 
Uncalled bet (€1.57) returned to cap. marb
cap. marb collected €2.38 from pot
cap. marb: doesn't show hand 
*** SUMMARY ***
Total pot €2.50 | Rake €0.12 
Board [8h Kc 4c 5c]
Seat 1: Fivez folded before Flop (didn't bet)
Seat 2: Algarra1 (button) folded on the Turn
Seat 5: Spid1 (small blind) folded before Flop
Seat 6: cap. marb (big blind) collected (€2.38)
Seat 7: chijara folded before Flop (didn't bet)
Seat 8: matiko09 folded before Flop (didn't bet)





PokerStars Hand #152660670289:  Hold'em No Limit ($0.50/$1.00 USD) - 2016/04/30 17:58:46 CET [2016/04/30 11:58:46 ET]
Table 'Tamariwa' 9-max Seat #9 is the button
Seat 1: matiko09 ($103 in chips) 
Seat 2: ilaviiitech ($100 in chips) 
Seat 3: Spid1 ($100 in chips) 
Seat 4: cap. marb ($40 in chips) 
Seat 5: Lobbyist98 ($85.55 in chips) 
Seat 6: El tourist ($59 in chips) 
Seat 7: azqanaz ($112.05 in chips) 
Seat 8: R1aki ($109.05 in chips) 
Seat 9: ApkawaDavit ($203.12 in chips) 
matiko09: posts small blind $0.50
ilaviiitech: posts big blind $1
*** HOLE CARDS ***
Dealt to matiko09 [6d 4d]
Spid1: folds 
cap. marb: raises $1.12 to $2.12
Lobbyist98: folds 
El tourist: folds 
azqanaz: folds 
R1aki: folds 
ApkawaDavit: folds 
matiko09: folds 
ilaviiitech: folds 
Uncalled bet ($1.12) returned to cap. marb
cap. marb collected $2.50 from pot
cap. marb: doesn't show hand 
*** SUMMARY ***
Total pot $2.50 | Rake $0 
Seat 1: matiko09 (small blind) folded before Flop
Seat 2: ilaviiitech (big blind) folded before Flop
Seat 3: Spid1 folded before Flop (didn't bet)
Seat 4: cap. marb collected ($2.50)
Seat 5: Lobbyist98 folded before Flop (didn't bet)
Seat 6: El tourist folded before Flop (didn't bet)
Seat 7: azqanaz folded before Flop (didn't bet)
Seat 8: R1aki folded before Flop (didn't bet)
Seat 9: ApkawaDavit (button) folded before Flop (didn't bet)





PokerStars Hand #152660674468:  Hold'em No Limit ($0.50/$1.00 USD) - 2016/04/30 17:58:53 CET [2016/04/30 11:58:53 ET]
Table 'Raissa II' 9-max Seat #7 is the button
Seat 1: cap. marb ($40.88 in chips) 
Seat 3: Kelvin sai ($39.57 in chips) 
Seat 4: koksskrt ($122.05 in chips) 
Seat 5: Jess7jay ($86.85 in chips) 
Seat 6: ilaviiitech ($103.65 in chips) 
Seat 7: matiko09 ($100 in chips) 
Seat 8: R1aki ($113 in chips) 
Seat 9: ApkawaDavit ($101.50 in chips) 
R1aki: posts small blind $0.50
ApkawaDavit: posts big blind $1
azzad2007: sits out 
*** HOLE CARDS ***
Dealt to matiko09 [Kc Qs]
cap. marb: folds 
Kelvin sai: raises $1 to $2
koksskrt: folds 
Jess7jay: calls $2
ilaviiitech: raises $10 to $12
matiko09: folds 
R1aki: folds 
ApkawaDavit: folds 
Kelvin sai: folds 
Jess7jay: folds 
Uncalled bet ($10) returned to ilaviiitech
ilaviiitech collected $7.50 from pot
ilaviiitech: doesn't show hand 
*** SUMMARY ***
Total pot $7.50 | Rake $0 
Seat 1: cap. marb folded before Flop (didn't bet)
Seat 3: Kelvin sai folded before Flop
Seat 4: koksskrt folded before Flop (didn't bet)
Seat 5: Jess7jay folded before Flop
Seat 6: ilaviiitech collected ($7.50)
Seat 7: matiko09 (button) folded before Flop (didn't bet)
Seat 8: R1aki (small blind) folded before Flop
Seat 9: ApkawaDavit (big blind) folded before Flop





PokerStars Hand #152660684405:  Hold'em No Limit (€0.50/€1.00 EUR) - 2016/04/30 17:59:10 CET [2016/04/30 11:59:10 ET]
Table 'Benda' 9-max Seat #4 is the button
Seat 1: aquarua7 (€215.38 in chips) 
Seat 2: cap. marb (€38.50 in chips) 
Seat 3: R1aki (€107.25 in chips) 
Seat 4: fireball2112 (€74.62 in chips) 
Seat 5: Spid1 (€103 in chips) 
Seat 8: matiko09 (€100 in chips) 
Spid1: posts small blind €0.50
Fivez: is sitting out 
matiko09: posts big blind €1
*** HOLE CARDS ***
Dealt to matiko09 [3s 6h]
aquarua7: raises €1.50 to €2.50
cap. marb: folds 
Fivez leaves the table
Ouga Buga joins the table at seat #7 
R1aki has timed out
R1aki: folds 
fireball2112: folds 
Spid1: raises €7 to €9.50
matiko09: folds 
aquarua7: folds 
Uncalled bet (€7) returned to Spid1
Spid1 collected €6 from pot
Spid1: doesn't show hand 
*** SUMMARY ***
Total pot €6 | Rake €0 
Seat 1: aquarua7 folded before Flop
Seat 2: cap. marb folded before Flop (didn't bet)
Seat 3: R1aki folded before Flop (didn't bet)
Seat 4: fireball2112 (button) folded before Flop (didn't bet)
Seat 5: Spid1 (small blind) collected (€6)
Seat 8: matiko09 (big blind) folded before Flop





PokerStars Hand #152660685633:  Hold'em No Limit ($0.50/$1.00 USD) - 2016/04/30 17:59:13 CET [2016/04/30 11:59:13 ET]
Table 'Tamariwa' 9-max Seat #1 is the button
Seat 1: matiko09 ($102.50 in chips) 
Seat 2: ilaviiitech ($100 in chips) 
Seat 3: Spid1 ($100 in chips) 
Seat 4: cap. marb ($41.50 in chips) 
Seat 5: Lobbyist98 ($85.55 in chips) 
Seat 6: El tourist ($59 in chips) 
Seat 7: azqanaz ($112.05 in chips) 
Seat 8: R1aki ($109.05 in chips) 
Seat 9: ApkawaDavit ($203.12 in chips) 
ilaviiitech: posts small blind $0.50
Spid1: posts big blind $1
*** HOLE CARDS ***
Dealt to matiko09 [Ac 2h]
cap. marb: raises $1.12 to $2.12
Lobbyist98: folds 
El tourist: folds 
azqanaz: folds 
R1aki has timed out
R1aki: folds 
ApkawaDavit: folds 
matiko09: folds 
ilaviiitech: folds 
Spid1: folds 
Uncalled bet ($1.12) returned to cap. marb
cap. marb collected $2.50 from pot
cap. marb: doesn't show hand 
*** SUMMARY ***
Total pot $2.50 | Rake $0 
Seat 1: matiko09 (button) folded before Flop (didn't bet)
Seat 2: ilaviiitech (small blind) folded before Flop
Seat 3: Spid1 (big blind) folded before Flop
Seat 4: cap. marb collected ($2.50)
Seat 5: Lobbyist98 folded before Flop (didn't bet)
Seat 6: El tourist folded before Flop (didn't bet)
Seat 7: azqanaz folded before Flop (didn't bet)
Seat 8: R1aki folded before Flop (didn't bet)
Seat 9: ApkawaDavit folded before Flop (didn't bet)





PokerStars Hand #152660691137:  Hold'em No Limit ($0.50/$1.00 USD) - 2016/04/30 17:59:19 CET [2016/04/30 11:59:19 ET]
Table 'Goto' 9-max Seat #1 is the button
Seat 1: naaaate_diaz ($105.73 in chips) 
Seat 3: matiko09 ($120.42 in chips) 
Seat 4: koksskrt ($100 in chips) 
Seat 5: hotsoo ($50.25 in chips) 
Seat 6: puszi77 ($275.26 in chips) 
Seat 7: Spid1 ($100 in chips) 
Seat 8: R1aki ($100 in chips) 
Khaine_CM will be allowed to play after the button
matiko09: posts small blind $0.50
koksskrt: posts big blind $1
*** HOLE CARDS ***
Dealt to matiko09 [Jc Qc]
hotsoo: calls $1
puszi77: folds 
Spid1: raises $4 to $5
R1aki: folds 
naaaate_diaz: folds 
matiko09: folds 
koksskrt: folds 
hotsoo: raises $11.50 to $16.50
Spid1: folds 
Uncalled bet ($11.50) returned to hotsoo
hotsoo collected $11.50 from pot
*** SUMMARY ***
Total pot $11.50 | Rake $0 
Seat 1: naaaate_diaz (button) folded before Flop (didn't bet)
Seat 3: matiko09 (small blind) folded before Flop
Seat 4: koksskrt (big blind) folded before Flop
Seat 5: hotsoo collected ($11.50)
Seat 6: puszi77 folded before Flop (didn't bet)
Seat 7: Spid1 folded before Flop
Seat 8: R1aki folded before Flop (didn't bet)





PokerStars Hand #152660692183:  Hold'em No Limit ($0.50/$1.00 USD) - 2016/04/30 17:59:21 CET [2016/04/30 11:59:21 ET]
Table 'Arcturus' 9-max Seat #4 is the button
Seat 1: matiko09 ($101.50 in chips) 
Seat 2: Khaine_CM ($106.85 in chips) 
Seat 3: Spid1 ($102.72 in chips) 
Seat 4: cap. marb ($37 in chips) 
Seat 5: koksskrt ($100 in chips) 
Seat 6: JimineyCrik ($170.56 in chips) 
Seat 7: terrytsui111 ($122.28 in chips) 
Seat 8: ApkawaDavit ($106.40 in chips) 
koksskrt: posts small blind $0.50
JimineyCrik: posts big blind $1
*** HOLE CARDS ***
Dealt to matiko09 [Td 5s]
terrytsui111: raises $1 to $2
ApkawaDavit: folds 
matiko09: folds 
Khaine_CM: folds 
Spid1: folds 
cap. marb: folds 
koksskrt: folds 
JimineyCrik: calls $1
*** FLOP *** [Jc 3c 7s]
JimineyCrik: checks 
terrytsui111: bets $3
JimineyCrik: calls $3
*** TURN *** [Jc 3c 7s] [6h]
JimineyCrik: checks 
terrytsui111: checks 
*** RIVER *** [Jc 3c 7s 6h] [Kd]
JimineyCrik: checks 
terrytsui111: checks 
*** SHOW DOWN ***
JimineyCrik: shows [8h Qh] (high card King)
terrytsui111: shows [Ad 4h] (high card Ace)
terrytsui111 collected $9.98 from pot
*** SUMMARY ***
Total pot $10.50 | Rake $0.52 
Board [Jc 3c 7s 6h Kd]
Seat 1: matiko09 folded before Flop (didn't bet)
Seat 2: Khaine_CM folded before Flop (didn't bet)
Seat 3: Spid1 folded before Flop (didn't bet)
Seat 4: cap. marb (button) folded before Flop (didn't bet)
Seat 5: koksskrt (small blind) folded before Flop
Seat 6: JimineyCrik (big blind) showed [8h Qh] and lost with high card King
Seat 7: terrytsui111 showed [Ad 4h] and won ($9.98) with high card Ace
Seat 8: ApkawaDavit folded before Flop (didn't bet)





PokerStars Hand #152660715704:  Hold'em No Limit (€0.50/€1.00 EUR) - 2016/04/30 18:00:00 CET [2016/04/30 12:00:00 ET]
Table 'Benda' 9-max Seat #5 is the button
Seat 1: aquarua7 (€212.88 in chips) 
Seat 2: cap. marb (€38.50 in chips) 
Seat 3: R1aki (€107.25 in chips) 
Seat 4: fireball2112 (€74.62 in chips) 
Seat 5: Spid1 (€106.50 in chips) 
Seat 8: matiko09 (€100 in chips) 
Ouga Buga will be allowed to play after the button
matiko09: posts small blind €0.50
aquarua7: posts big blind €1
*** HOLE CARDS ***
Dealt to matiko09 [8s 4c]
cap. marb: folds 
R1aki: folds 
fireball2112: folds 
Spid1: raises €1.50 to €2.50
matiko09: folds 
aquarua7: folds 
Uncalled bet (€1.50) returned to Spid1
Spid1 collected €2.50 from pot
Spid1: doesn't show hand 
*** SUMMARY ***
Total pot €2.50 | Rake €0 
Seat 1: aquarua7 (big blind) folded before Flop
Seat 2: cap. marb folded before Flop (didn't bet)
Seat 3: R1aki folded before Flop (didn't bet)
Seat 4: fireball2112 folded before Flop (didn't bet)
Seat 5: Spid1 (button) collected (€2.50)
Seat 8: matiko09 (small blind) folded before Flop





PokerStars Hand #152660716364:  Hold'em No Limit ($0.50/$1.00 USD) - 2016/04/30 18:00:01 CET [2016/04/30 12:00:01 ET]
Table 'Tamariwa' 9-max Seat #2 is the button
Seat 1: matiko09 ($102.50 in chips) 
Seat 2: ilaviiitech ($100 in chips) 
Seat 3: Spid1 ($100 in chips) 
Seat 4: cap. marb ($43 in chips) 
Seat 5: Lobbyist98 ($85.55 in chips) 
Seat 6: El tourist ($59 in chips) 
Seat 7: azqanaz ($112.05 in chips) 
Seat 8: R1aki ($109.05 in chips) 
Seat 9: ApkawaDavit ($203.12 in chips) 
Spid1: posts small blind $0.50
cap. marb: posts big blind $1
*** HOLE CARDS ***
Dealt to matiko09 [4h Ah]
Lobbyist98: calls $1
El tourist: folds 
azqanaz: folds 
R1aki: folds 
ApkawaDavit: folds 
matiko09: raises $3 to $4
ilaviiitech: folds 
Spid1: folds 
cap. marb: folds 
Lobbyist98: calls $3
*** FLOP *** [Jd 3h Td]
Lobbyist98: bets $4
matiko09: calls $4
*** TURN *** [Jd 3h Td] [9c]
Lobbyist98: bets $12
matiko09: folds 
Uncalled bet ($12) returned to Lobbyist98
Lobbyist98 collected $16.62 from pot
Lobbyist98: doesn't show hand 
*** SUMMARY ***
Total pot $17.50 | Rake $0.88 
Board [Jd 3h Td 9c]
Seat 1: matiko09 folded on the Turn
Seat 2: ilaviiitech (button) folded before Flop (didn't bet)
Seat 3: Spid1 (small blind) folded before Flop
Seat 4: cap. marb (big blind) folded before Flop
Seat 5: Lobbyist98 collected ($16.62)
Seat 6: El tourist folded before Flop (didn't bet)
Seat 7: azqanaz folded before Flop (didn't bet)
Seat 8: R1aki folded before Flop (didn't bet)
Seat 9: ApkawaDavit folded before Flop (didn't bet)





PokerStars Hand #152660720279:  Hold'em No Limit ($0.50/$1.00 USD) - 2016/04/30 18:00:06 CET [2016/04/30 12:00:06 ET]
Table 'Arcturus' 9-max Seat #5 is the button
Seat 1: matiko09 ($101.50 in chips) 
Seat 2: Khaine_CM ($106.85 in chips) 
Seat 3: Spid1 ($102.72 in chips) 
Seat 4: cap. marb ($37 in chips) 
Seat 5: koksskrt ($100 in chips) 
Seat 6: JimineyCrik ($165.56 in chips) 
Seat 7: terrytsui111 ($127.26 in chips) 
Seat 8: ApkawaDavit ($106.40 in chips) 
JimineyCrik: posts small blind $0.50
terrytsui111: posts big blind $1
*** HOLE CARDS ***
Dealt to matiko09 [9d 2s]
ApkawaDavit: folds 
matiko09: folds 
Khaine_CM: raises $2 to $3
Spid1: folds 
cap. marb: folds 
koksskrt: calls $3
JimineyCrik: calls $2.50
terrytsui111: calls $2
*** FLOP *** [Ah Ks 7c]
JimineyCrik: checks 
terrytsui111: checks 
Khaine_CM: checks 
koksskrt: checks 
*** TURN *** [Ah Ks 7c] [8s]
JimineyCrik: bets $5.81
terrytsui111: folds 
Khaine_CM: folds 
koksskrt: folds 
Uncalled bet ($5.81) returned to JimineyCrik
JimineyCrik collected $11.40 from pot
JimineyCrik: doesn't show hand 
*** SUMMARY ***
Total pot $12 | Rake $0.60 
Board [Ah Ks 7c 8s]
Seat 1: matiko09 folded before Flop (didn't bet)
Seat 2: Khaine_CM folded on the Turn
Seat 3: Spid1 folded before Flop (didn't bet)
Seat 4: cap. marb folded before Flop (didn't bet)
Seat 5: koksskrt (button) folded on the Turn
Seat 6: JimineyCrik (small blind) collected ($11.40)
Seat 7: terrytsui111 (big blind) folded on the Turn
Seat 8: ApkawaDavit folded before Flop (didn't bet)





PokerStars Hand #152660728746:  Hold'em No Limit ($0.50/$1.00 USD) - 2016/04/30 18:00:20 CET [2016/04/30 12:00:20 ET]
Table 'Raissa II' 9-max Seat #8 is the button
Seat 1: cap. marb ($40.88 in chips) 
Seat 3: Kelvin sai ($37.57 in chips) 
Seat 4: koksskrt ($122.05 in chips) 
Seat 5: Jess7jay ($84.85 in chips) 
Seat 6: ilaviiitech ($109.15 in chips) 
Seat 7: matiko09 ($100 in chips) 
Seat 8: R1aki ($112.50 in chips) 
Seat 9: ApkawaDavit ($100.50 in chips) 
ApkawaDavit: posts small blind $0.50
cap. marb: posts big blind $1
azzad2007: sits out 
*** HOLE CARDS ***
Dealt to matiko09 [Qs 3h]
Kelvin sai: folds 
koksskrt: folds 
Jess7jay: calls $1
ilaviiitech: folds 
matiko09: folds 
R1aki: folds 
ApkawaDavit: folds 
cap. marb: checks 
*** FLOP *** [Ad 8h Kd]
cap. marb: checks 
Jess7jay: bets $1.50
cap. marb: folds 
Uncalled bet ($1.50) returned to Jess7jay
Jess7jay collected $2.38 from pot
Jess7jay: doesn't show hand 
*** SUMMARY ***
Total pot $2.50 | Rake $0.12 
Board [Ad 8h Kd]
Seat 1: cap. marb (big blind) folded on the Flop
Seat 3: Kelvin sai folded before Flop (didn't bet)
Seat 4: koksskrt folded before Flop (didn't bet)
Seat 5: Jess7jay collected ($2.38)
Seat 6: ilaviiitech folded before Flop (didn't bet)
Seat 7: matiko09 folded before Flop (didn't bet)
Seat 8: R1aki (button) folded before Flop (didn't bet)
Seat 9: ApkawaDavit (small blind) folded before Flop





PokerStars Hand #152660733227:  Hold'em No Limit (€0.50/€1.00 EUR) - 2016/04/30 18:00:27 CET [2016/04/30 12:00:27 ET]
Table 'Benda' 9-max Seat #8 is the button
Seat 1: aquarua7 (€211.88 in chips) 
Seat 2: cap. marb (€38.50 in chips) 
Seat 3: R1aki (€107.25 in chips) 
Seat 4: fireball2112 (€74.62 in chips) 
Seat 5: Spid1 (€108 in chips) 
Seat 8: matiko09 (€100 in chips) 
aquarua7: posts small blind €0.50
cap. marb: posts big blind €1
Ouga Buga: sits out 
*** HOLE CARDS ***
Dealt to matiko09 [Th 5h]
R1aki: folds 
fireball2112: folds 
Spid1: raises €1.50 to €2.50
matiko09: folds 
aquarua7: raises €6 to €8.50
cap. marb: folds 
Spid1: folds 
Uncalled bet (€6) returned to aquarua7
aquarua7 collected €6 from pot
aquarua7: doesn't show hand 
*** SUMMARY ***
Total pot €6 | Rake €0 
Seat 1: aquarua7 (small blind) collected (€6)
Seat 2: cap. marb (big blind) folded before Flop
Seat 3: R1aki folded before Flop (didn't bet)
Seat 4: fireball2112 folded before Flop (didn't bet)
Seat 5: Spid1 folded before Flop
Seat 8: matiko09 (button) folded before Flop (didn't bet)





PokerStars Hand #152660733942:  Hold'em No Limit ($0.50/$1.00 USD) - 2016/04/30 18:00:28 CET [2016/04/30 12:00:28 ET]
Table 'Goto' 9-max Seat #3 is the button
Seat 1: naaaate_diaz ($105.73 in chips) 
Seat 3: matiko09 ($119.92 in chips) 
Seat 4: koksskrt ($100 in chips) 
Seat 5: hotsoo ($56.75 in chips) 
Seat 6: puszi77 ($275.26 in chips) 
Seat 7: Spid1 ($100 in chips) 
Seat 8: R1aki ($100 in chips) 
koksskrt: posts small blind $0.50
hotsoo: posts big blind $1
Khaine_CM: sits out 
*** HOLE CARDS ***
Dealt to matiko09 [Ad 7h]
puszi77 has timed out
puszi77: folds 
Spid1: folds 
R1aki: folds 
naaaate_diaz: folds 
matiko09: raises $1.50 to $2.50
koksskrt: folds 
hotsoo: raises $5.50 to $8
matiko09: folds 
Uncalled bet ($5.50) returned to hotsoo
hotsoo collected $5.50 from pot
*** SUMMARY ***
Total pot $5.50 | Rake $0 
Seat 1: naaaate_diaz folded before Flop (didn't bet)
Seat 3: matiko09 (button) folded before Flop
Seat 4: koksskrt (small blind) folded before Flop
Seat 5: hotsoo (big blind) collected ($5.50)
Seat 6: puszi77 folded before Flop (didn't bet)
Seat 7: Spid1 folded before Flop (didn't bet)
Seat 8: R1aki folded before Flop (didn't bet)





PokerStars Hand #152660750263:  Hold'em No Limit ($0.50/$1.00 USD) - 2016/04/30 18:00:54 CET [2016/04/30 12:00:54 ET]
Table 'Raissa II' 9-max Seat #9 is the button
Seat 1: cap. marb ($39.88 in chips) 
Seat 2: azzad2007 ($100 in chips) 
Seat 3: Kelvin sai ($37.57 in chips) 
Seat 4: koksskrt ($122.05 in chips) 
Seat 5: Jess7jay ($86.23 in chips) 
Seat 6: ilaviiitech ($109.15 in chips) 
Seat 7: matiko09 ($100 in chips) 
Seat 8: R1aki ($112.50 in chips) 
Seat 9: ApkawaDavit ($100 in chips) 
cap. marb: posts small blind $0.50
azzad2007: posts big blind $1
*** HOLE CARDS ***
Dealt to matiko09 [7d 5s]
Kelvin sai: folds 
koksskrt: folds 
Jess7jay: folds 
ilaviiitech: folds 
matiko09: folds 
R1aki: folds 
ApkawaDavit: folds 
cap. marb: raises $1.50 to $2.50
azzad2007: folds 
Uncalled bet ($1.50) returned to cap. marb
cap. marb collected $2 from pot
cap. marb: doesn't show hand 
*** SUMMARY ***
Total pot $2 | Rake $0 
Seat 1: cap. marb (small blind) collected ($2)
Seat 2: azzad2007 (big blind) folded before Flop
Seat 3: Kelvin sai folded before Flop (didn't bet)
Seat 4: koksskrt folded before Flop (didn't bet)
Seat 5: Jess7jay folded before Flop (didn't bet)
Seat 6: ilaviiitech folded before Flop (didn't bet)
Seat 7: matiko09 folded before Flop (didn't bet)
Seat 8: R1aki folded before Flop (didn't bet)
Seat 9: ApkawaDavit (button) folded before Flop (didn't bet)





PokerStars Hand #152660750967:  Hold'em No Limit (€0.50/€1.00 EUR) - 2016/04/30 18:00:55 CET [2016/04/30 12:00:55 ET]
Table 'Benda' 9-max Seat #1 is the button
Seat 1: aquarua7 (€215.38 in chips) 
Seat 2: cap. marb (€37.50 in chips) 
Seat 3: R1aki (€107.25 in chips) 
Seat 4: fireball2112 (€74.62 in chips) 
Seat 5: Spid1 (€105.50 in chips) 
Seat 8: matiko09 (€100 in chips) 
cap. marb: posts small blind €0.50
R1aki: posts big blind €1
Ouga Buga: sits out 
*** HOLE CARDS ***
Dealt to matiko09 [Qs Tc]
fireball2112: folds 
Spid1: folds 
matiko09: raises €1.50 to €2.50
aquarua7: folds 
cap. marb: folds 
R1aki: folds 
Uncalled bet (€1.50) returned to matiko09
matiko09 collected €2.50 from pot
matiko09: doesn't show hand 
*** SUMMARY ***
Total pot €2.50 | Rake €0 
Seat 1: aquarua7 (button) folded before Flop (didn't bet)
Seat 2: cap. marb (small blind) folded before Flop
Seat 3: R1aki (big blind) folded before Flop
Seat 4: fireball2112 folded before Flop (didn't bet)
Seat 5: Spid1 folded before Flop (didn't bet)
Seat 8: matiko09 collected (€2.50)





PokerStars Hand #152660756160:  Hold'em No Limit ($0.50/$1.00 USD) - 2016/04/30 18:01:03 CET [2016/04/30 12:01:03 ET]
Table 'Tamariwa' 9-max Seat #3 is the button
Seat 1: matiko09 ($100 in chips) 
Seat 2: ilaviiitech ($100 in chips) 
Seat 3: Spid1 ($100 in chips) 
Seat 4: cap. marb ($42 in chips) 
Seat 5: Lobbyist98 ($94.17 in chips) 
Seat 6: El tourist ($59 in chips) 
Seat 7: azqanaz ($112.05 in chips) 
Seat 8: R1aki ($109.05 in chips) 
Seat 9: ApkawaDavit ($203.12 in chips) 
cap. marb: posts small blind $0.50
Lobbyist98: posts big blind $1
*** HOLE CARDS ***
Dealt to matiko09 [6c Js]
El tourist: folds 
azqanaz: raises $2 to $3
R1aki: folds 
ApkawaDavit: folds 
matiko09: folds 
ilaviiitech: folds 
Spid1: folds 
cap. marb: folds 
Lobbyist98: folds 
Uncalled bet ($2) returned to azqanaz
azqanaz collected $2.50 from pot
*** SUMMARY ***
Total pot $2.50 | Rake $0 
Seat 1: matiko09 folded before Flop (didn't bet)
Seat 2: ilaviiitech folded before Flop (didn't bet)
Seat 3: Spid1 (button) folded before Flop (didn't bet)
Seat 4: cap. marb (small blind) folded before Flop
Seat 5: Lobbyist98 (big blind) folded before Flop
Seat 6: El tourist folded before Flop (didn't bet)
Seat 7: azqanaz collected ($2.50)
Seat 8: R1aki folded before Flop (didn't bet)
Seat 9: ApkawaDavit folded before Flop (didn't bet)





PokerStars Hand #152660763974:  Hold'em No Limit ($0.50/$1.00 USD) - 2016/04/30 18:01:16 CET [2016/04/30 12:01:16 ET]
Table 'Arcturus' 9-max Seat #6 is the button
Seat 1: matiko09 ($101.50 in chips) 
Seat 2: Khaine_CM ($103.85 in chips) 
Seat 3: Spid1 ($102.72 in chips) 
Seat 4: cap. marb ($37 in chips) 
Seat 5: koksskrt ($100 in chips) 
Seat 6: JimineyCrik ($173.96 in chips) 
Seat 7: terrytsui111 ($124.26 in chips) 
Seat 8: ApkawaDavit ($106.40 in chips) 
terrytsui111: posts small blind $0.50
ApkawaDavit: posts big blind $1
*** HOLE CARDS ***
Dealt to matiko09 [9c 5h]
matiko09: folds 
Khaine_CM: folds 
Spid1: raises $2 to $3
cap. marb: folds 
koksskrt: calls $3
JimineyCrik: folds 
terrytsui111: calls $2.50
ApkawaDavit: folds 
*** FLOP *** [6c Kd 2c]
terrytsui111: bets $4
Spid1: folds 
koksskrt: calls $4
*** TURN *** [6c Kd 2c] [Tc]
terrytsui111: checks 
koksskrt: checks 
*** RIVER *** [6c Kd 2c Tc] [Qc]
terrytsui111: bets $5
koksskrt: folds 
Uncalled bet ($5) returned to terrytsui111
terrytsui111 collected $17.10 from pot
terrytsui111: doesn't show hand 
*** SUMMARY ***
Total pot $18 | Rake $0.90 
Board [6c Kd 2c Tc Qc]
Seat 1: matiko09 folded before Flop (didn't bet)
Seat 2: Khaine_CM folded before Flop (didn't bet)
Seat 3: Spid1 folded on the Flop
Seat 4: cap. marb folded before Flop (didn't bet)
Seat 5: koksskrt folded on the River
Seat 6: JimineyCrik (button) folded before Flop (didn't bet)
Seat 7: terrytsui111 (small blind) collected ($17.10)
Seat 8: ApkawaDavit (big blind) folded before Flop





PokerStars Hand #152660764356:  Hold'em No Limit (€0.50/€1.00 EUR) - 2016/04/30 18:01:16 CET [2016/04/30 12:01:16 ET]
Table 'Benda' 9-max Seat #2 is the button
Seat 1: aquarua7 (€215.38 in chips) 
Seat 2: cap. marb (€37 in chips) 
Seat 3: R1aki (€106.25 in chips) 
Seat 4: fireball2112 (€74.62 in chips) 
Seat 5: Spid1 (€105.50 in chips) 
Seat 8: matiko09 (€101.50 in chips) 
R1aki: posts small blind €0.50
fireball2112: posts big blind €1
Ouga Buga: sits out 
*** HOLE CARDS ***
Dealt to matiko09 [5c 5d]
Spid1: folds 
matiko09: raises €2 to €3
aquarua7: folds 
cap. marb: folds 
R1aki: folds 
fireball2112: folds 
Uncalled bet (€2) returned to matiko09
matiko09 collected €2.50 from pot
matiko09: doesn't show hand 
*** SUMMARY ***
Total pot €2.50 | Rake €0 
Seat 1: aquarua7 folded before Flop (didn't bet)
Seat 2: cap. marb (button) folded before Flop (didn't bet)
Seat 3: R1aki (small blind) folded before Flop
Seat 4: fireball2112 (big blind) folded before Flop
Seat 5: Spid1 folded before Flop (didn't bet)
Seat 8: matiko09 collected (€2.50)





PokerStars Hand #152660764491:  Hold'em No Limit ($0.50/$1.00 USD) - 2016/04/30 18:01:16 CET [2016/04/30 12:01:16 ET]
Table 'Raissa II' 9-max Seat #1 is the button
Seat 1: cap. marb ($40.88 in chips) 
Seat 2: azzad2007 ($100 in chips) 
Seat 3: Kelvin sai ($37.57 in chips) 
Seat 4: koksskrt ($122.05 in chips) 
Seat 5: Jess7jay ($86.23 in chips) 
Seat 6: ilaviiitech ($109.15 in chips) 
Seat 7: matiko09 ($100 in chips) 
Seat 8: R1aki ($112.50 in chips) 
Seat 9: ApkawaDavit ($100 in chips) 
azzad2007: posts small blind $0.50
Kelvin sai: posts big blind $1
*** HOLE CARDS ***
Dealt to matiko09 [Js 2d]
koksskrt: folds 
Jess7jay: calls $1
ilaviiitech: folds 
matiko09: folds 
R1aki: folds 
ApkawaDavit: raises $2.50 to $3.50
cap. marb: folds 
azzad2007: folds 
Kelvin sai: folds 
Jess7jay: calls $2.50
*** FLOP *** [Jh Ad Kc]
Jess7jay: bets $2.50
ApkawaDavit: folds 
Uncalled bet ($2.50) returned to Jess7jay
Jess7jay collected $8.08 from pot
Jess7jay: doesn't show hand 
*** SUMMARY ***
Total pot $8.50 | Rake $0.42 
Board [Jh Ad Kc]
Seat 1: cap. marb (button) folded before Flop (didn't bet)
Seat 2: azzad2007 (small blind) folded before Flop
Seat 3: Kelvin sai (big blind) folded before Flop
Seat 4: koksskrt folded before Flop (didn't bet)
Seat 5: Jess7jay collected ($8.08)
Seat 6: ilaviiitech folded before Flop (didn't bet)
Seat 7: matiko09 folded before Flop (didn't bet)
Seat 8: R1aki folded before Flop (didn't bet)
Seat 9: ApkawaDavit folded on the Flop





PokerStars Hand #152660765093:  Hold'em No Limit ($0.50/$1.00 USD) - 2016/04/30 18:01:17 CET [2016/04/30 12:01:17 ET]
Table 'Goto' 9-max Seat #4 is the button
Seat 1: naaaate_diaz ($105.73 in chips) 
Seat 3: matiko09 ($117.42 in chips) 
Seat 4: koksskrt ($100 in chips) 
Seat 5: hotsoo ($59.75 in chips) 
Seat 7: Spid1 ($100 in chips) 
Seat 8: R1aki ($100 in chips) 
hotsoo: posts small blind $0.50
Spid1: posts big blind $1
Khaine_CM: sits out 
*** HOLE CARDS ***
Dealt to matiko09 [Js 7d]
R1aki: folds 
naaaate_diaz: raises $2 to $3
matiko09: folds 
koksskrt: folds 
hotsoo: folds 
Spid1: folds 
Uncalled bet ($2) returned to naaaate_diaz
naaaate_diaz collected $2.50 from pot
naaaate_diaz: doesn't show hand 
*** SUMMARY ***
Total pot $2.50 | Rake $0 
Seat 1: naaaate_diaz collected ($2.50)
Seat 3: matiko09 folded before Flop (didn't bet)
Seat 4: koksskrt (button) folded before Flop (didn't bet)
Seat 5: hotsoo (small blind) folded before Flop
Seat 7: Spid1 (big blind) folded before Flop
Seat 8: R1aki folded before Flop (didn't bet)





PokerStars Hand #152660777257:  Hold'em No Limit ($0.50/$1.00 USD) - 2016/04/30 18:01:35 CET [2016/04/30 12:01:35 ET]
Table 'Tamariwa' 9-max Seat #4 is the button
Seat 1: matiko09 ($100 in chips) 
Seat 2: ilaviiitech ($100 in chips) 
Seat 3: Spid1 ($100 in chips) 
Seat 4: cap. marb ($41.50 in chips) 
Seat 5: Lobbyist98 ($93.17 in chips) 
Seat 6: El tourist ($59 in chips) 
Seat 7: azqanaz ($113.55 in chips) 
Seat 8: R1aki ($109.05 in chips) 
Seat 9: ApkawaDavit ($203.12 in chips) 
Lobbyist98: posts small blind $0.50
El tourist: posts big blind $1
*** HOLE CARDS ***
Dealt to matiko09 [5c Js]
azqanaz: folds 
R1aki: raises $1.50 to $2.50
ApkawaDavit: calls $2.50
matiko09: folds 
azqanaz leaves the table
ilaviiitech: folds 
Spid1: folds 
Khaine_CM joins the table at seat #7 
cap. marb: folds 
Lobbyist98: folds 
El tourist: calls $1.50
*** FLOP *** [9d 9h 9s]
El tourist: checks 
R1aki: checks 
ApkawaDavit: bets $6.50
El tourist: folds 
R1aki: calls $6.50
*** TURN *** [9d 9h 9s] [4c]
R1aki: checks 
ApkawaDavit: bets $14.50
R1aki: calls $14.50
*** RIVER *** [9d 9h 9s 4c] [Qs]
R1aki: checks 
ApkawaDavit: checks 
*** SHOW DOWN ***
R1aki: shows [Ah Ad] (a full house, Nines full of Aces)
ApkawaDavit: mucks hand 
R1aki collected $47.50 from pot
*** SUMMARY ***
Total pot $50 | Rake $2.50 
Board [9d 9h 9s 4c Qs]
Seat 1: matiko09 folded before Flop (didn't bet)
Seat 2: ilaviiitech folded before Flop (didn't bet)
Seat 3: Spid1 folded before Flop (didn't bet)
Seat 4: cap. marb (button) folded before Flop (didn't bet)
Seat 5: Lobbyist98 (small blind) folded before Flop
Seat 6: El tourist (big blind) folded on the Flop
Seat 7: azqanaz folded before Flop (didn't bet)
Seat 8: R1aki showed [Ah Ad] and won ($47.50) with a full house, Nines full of Aces
Seat 9: ApkawaDavit mucked [Kd Ks]





PokerStars Hand #152660778100:  Hold'em No Limit (€0.50/€1.00 EUR) - 2016/04/30 18:01:37 CET [2016/04/30 12:01:37 ET]
Table 'Benda' 9-max Seat #3 is the button
Seat 1: aquarua7 (€215.38 in chips) 
Seat 2: cap. marb (€37 in chips) 
Seat 3: R1aki (€105.75 in chips) 
Seat 4: fireball2112 (€73.62 in chips) 
Seat 5: Spid1 (€105.50 in chips) 
Seat 8: matiko09 (€103 in chips) 
fireball2112: posts small blind €0.50
Spid1: posts big blind €1
Ouga Buga: sits out 
*** HOLE CARDS ***
Dealt to matiko09 [As 4h]
matiko09: folds 
aquarua7: folds 
cap. marb: folds 
R1aki: raises €1.50 to €2.50
fireball2112: folds 
Spid1: folds 
Uncalled bet (€1.50) returned to R1aki
R1aki collected €2.50 from pot
R1aki: doesn't show hand 
*** SUMMARY ***
Total pot €2.50 | Rake €0 
Seat 1: aquarua7 folded before Flop (didn't bet)
Seat 2: cap. marb folded before Flop (didn't bet)
Seat 3: R1aki (button) collected (€2.50)
Seat 4: fireball2112 (small blind) folded before Flop
Seat 5: Spid1 (big blind) folded before Flop
Seat 8: matiko09 folded before Flop (didn't bet)





PokerStars Hand #152660779268:  Hold'em No Limit ($0.50/$1.00 USD) - 2016/04/30 18:01:38 CET [2016/04/30 12:01:38 ET]
Table 'Goto' 9-max Seat #5 is the button
Seat 1: naaaate_diaz ($107.23 in chips) 
Seat 3: matiko09 ($117.42 in chips) 
Seat 4: koksskrt ($100 in chips) 
Seat 5: hotsoo ($59.25 in chips) 
Seat 7: Spid1 ($100 in chips) 
Seat 8: R1aki ($100 in chips) 
Spid1: posts small blind $0.50
R1aki: posts big blind $1
Khaine_CM: sits out 
*** HOLE CARDS ***
Dealt to matiko09 [9s 3d]
naaaate_diaz: folds 
matiko09: folds 
koksskrt: folds 
hotsoo: raises $1 to $2
Spid1: folds 
R1aki: calls $1
*** FLOP *** [9h Jd Qc]
R1aki: checks 
hotsoo: bets $3
R1aki: folds 
Uncalled bet ($3) returned to hotsoo
hotsoo collected $4.28 from pot
*** SUMMARY ***
Total pot $4.50 | Rake $0.22 
Board [9h Jd Qc]
Seat 1: naaaate_diaz folded before Flop (didn't bet)
Seat 3: matiko09 folded before Flop (didn't bet)
Seat 4: koksskrt folded before Flop (didn't bet)
Seat 5: hotsoo (button) collected ($4.28)
Seat 7: Spid1 (small blind) folded before Flop
Seat 8: R1aki (big blind) folded on the Flop





PokerStars Hand #152660781973:  Hold'em No Limit ($0.50/$1.00 USD) - 2016/04/30 18:01:43 CET [2016/04/30 12:01:43 ET]
Table 'Malautra II' 9-max Seat #3 is the button
Seat 1: Fivez ($166.19 in chips) 
Seat 2: koksskrt ($101 in chips) 
Seat 3: t.sneijder ($57.28 in chips) 
Seat 4: Khaine_CM ($103.98 in chips) 
Seat 6: matiko09 ($100 in chips) 
Seat 7: poker-rat95 ($46.78 in chips) 
Seat 9: kblkxls ($127.33 in chips) 
Khaine_CM: posts small blind $0.50
matiko09: posts big blind $1
*** HOLE CARDS ***
Dealt to matiko09 [Kd Qh]
poker-rat95: folds 
kblkxls: folds 
Fivez: folds 
koksskrt: folds 
t.sneijder: raises $1 to $2
Khaine_CM: folds 
matiko09: raises $4 to $6
t.sneijder: calls $4
*** FLOP *** [As 4c 2h]
matiko09: bets $6.17
t.sneijder: calls $6.17
*** TURN *** [As 4c 2h] [6s]
matiko09: checks 
t.sneijder: bets $9
matiko09: folds 
Uncalled bet ($9) returned to t.sneijder
t.sneijder collected $23.60 from pot
t.sneijder: doesn't show hand 
*** SUMMARY ***
Total pot $24.84 | Rake $1.24 
Board [As 4c 2h 6s]
Seat 1: Fivez folded before Flop (didn't bet)
Seat 2: koksskrt folded before Flop (didn't bet)
Seat 3: t.sneijder (button) collected ($23.60)
Seat 4: Khaine_CM (small blind) folded before Flop
Seat 6: matiko09 (big blind) folded on the Turn
Seat 7: poker-rat95 folded before Flop (didn't bet)
Seat 9: kblkxls folded before Flop (didn't bet)





PokerStars Hand #152660792768:  Hold'em No Limit ($0.50/$1.00 USD) - 2016/04/30 18:01:59 CET [2016/04/30 12:01:59 ET]
Table 'Raissa II' 9-max Seat #2 is the button
Seat 1: cap. marb ($40.88 in chips) 
Seat 2: azzad2007 ($100 in chips) 
Seat 3: Kelvin sai ($36.57 in chips) 
Seat 4: koksskrt ($122.05 in chips) 
Seat 5: Jess7jay ($90.81 in chips) 
Seat 6: ilaviiitech ($109.15 in chips) 
Seat 7: matiko09 ($100 in chips) 
Seat 8: R1aki ($112.50 in chips) 
Seat 9: ApkawaDavit ($100 in chips) 
Kelvin sai: posts small blind $0.50
koksskrt: posts big blind $1
*** HOLE CARDS ***
Dealt to matiko09 [6h 4c]
Jess7jay: folds 
ilaviiitech: folds 
matiko09: folds 
R1aki: folds 
ApkawaDavit: folds 
cap. marb: folds 
azzad2007: folds 
Kelvin sai: folds 
Uncalled bet ($0.50) returned to koksskrt
koksskrt collected $1 from pot
koksskrt: doesn't show hand 
*** SUMMARY ***
Total pot $1 | Rake $0 
Seat 1: cap. marb folded before Flop (didn't bet)
Seat 2: azzad2007 (button) folded before Flop (didn't bet)
Seat 3: Kelvin sai (small blind) folded before Flop
Seat 4: koksskrt (big blind) collected ($1)
Seat 5: Jess7jay folded before Flop (didn't bet)
Seat 6: ilaviiitech folded before Flop (didn't bet)
Seat 7: matiko09 folded before Flop (didn't bet)
Seat 8: R1aki folded before Flop (didn't bet)
Seat 9: ApkawaDavit folded before Flop (didn't bet)





PokerStars Hand #152660798893:  Hold'em No Limit (€0.50/€1.00 EUR) - 2016/04/30 18:02:07 CET [2016/04/30 12:02:07 ET]
Table 'Benda' 9-max Seat #4 is the button
Seat 1: aquarua7 (€215.38 in chips) 
Seat 2: cap. marb (€37 in chips) 
Seat 3: R1aki (€107.25 in chips) 
Seat 4: fireball2112 (€73.12 in chips) 
Seat 5: Spid1 (€104.50 in chips) 
Seat 7: Ouga Buga (€100 in chips) 
Seat 8: matiko09 (€103 in chips) 
Spid1: posts small blind €0.50
Ouga Buga: posts big blind €1
*** HOLE CARDS ***
Dealt to matiko09 [3c 9h]
matiko09: folds 
aquarua7: folds 
cap. marb: folds 
R1aki: raises €1.50 to €2.50
fireball2112: calls €2.50
Spid1: folds 
Ouga Buga: folds 
*** FLOP *** [9s Jc 4c]
R1aki: bets €4
fireball2112: calls €4
*** TURN *** [9s Jc 4c] [Kd]
R1aki: checks 
fireball2112: bets €7
R1aki: calls €7
*** RIVER *** [9s Jc 4c Kd] [Ah]
R1aki: checks 
fireball2112: bets €10
R1aki: folds 
Uncalled bet (€10) returned to fireball2112
fireball2112 collected €27.08 from pot
fireball2112: doesn't show hand 
*** SUMMARY ***
Total pot €28.50 | Rake €1.42 
Board [9s Jc 4c Kd Ah]
Seat 1: aquarua7 folded before Flop (didn't bet)
Seat 2: cap. marb folded before Flop (didn't bet)
Seat 3: R1aki folded on the River
Seat 4: fireball2112 (button) collected (€27.08)
Seat 5: Spid1 (small blind) folded before Flop
Seat 7: Ouga Buga (big blind) folded before Flop
Seat 8: matiko09 folded before Flop (didn't bet)





PokerStars Hand #152660804763:  Hold'em No Limit ($0.50/$1.00 USD) - 2016/04/30 18:02:16 CET [2016/04/30 12:02:16 ET]
Table 'Goto' 9-max Seat #7 is the button
Seat 1: naaaate_diaz ($107.23 in chips) 
Seat 3: matiko09 ($117.42 in chips) 
Seat 4: koksskrt ($100 in chips) 
Seat 5: hotsoo ($61.53 in chips) 
Seat 7: Spid1 ($100 in chips) 
Seat 8: R1aki ($100 in chips) 
Seat 9: maxxmeister ($100 in chips) 
R1aki: posts small blind $0.50
maxxmeister: posts big blind $1
Khaine_CM: sits out 
*** HOLE CARDS ***
Dealt to matiko09 [Kd 6s]
naaaate_diaz: folds 
matiko09: folds 
koksskrt: folds 
hotsoo: folds 
Spid1: raises $1.50 to $2.50
R1aki: folds 
maxxmeister: calls $1.50
*** FLOP *** [Js 4s Jd]
maxxmeister: checks 
Spid1: checks 
*** TURN *** [Js 4s Jd] [As]
maxxmeister: checks 
Spid1: checks 
*** RIVER *** [Js 4s Jd As] [Ks]
maxxmeister: checks 
Spid1: checks 
*** SHOW DOWN ***
maxxmeister: shows [Ad 6d] (two pair, Aces and Jacks)
Spid1: mucks hand 
maxxmeister collected $5.22 from pot
*** SUMMARY ***
Total pot $5.50 | Rake $0.28 
Board [Js 4s Jd As Ks]
Seat 1: naaaate_diaz folded before Flop (didn't bet)
Seat 3: matiko09 folded before Flop (didn't bet)
Seat 4: koksskrt folded before Flop (didn't bet)
Seat 5: hotsoo folded before Flop (didn't bet)
Seat 7: Spid1 (button) mucked [Kc 5c]
Seat 8: R1aki (small blind) folded before Flop
Seat 9: maxxmeister (big blind) showed [Ad 6d] and won ($5.22) with two pair, Aces and Jacks





PokerStars Hand #152660806589:  Hold'em No Limit ($0.50/$1.00 USD) - 2016/04/30 18:02:18 CET [2016/04/30 12:02:18 ET]
Table 'Malautra II' 9-max Seat #4 is the button
Seat 1: Fivez ($166.19 in chips) 
Seat 2: koksskrt ($101 in chips) 
Seat 3: t.sneijder ($68.71 in chips) 
Seat 4: Khaine_CM ($103.48 in chips) 
Seat 6: matiko09 ($100 in chips) 
Seat 7: poker-rat95 ($46.78 in chips) 
Seat 9: kblkxls ($127.33 in chips) 
matiko09: posts small blind $0.50
poker-rat95: posts big blind $1
maxxmeister: sits out 
*** HOLE CARDS ***
Dealt to matiko09 [4s Th]
kblkxls: calls $1
Fivez: folds 
koksskrt: folds 
t.sneijder: raises $2 to $3
Khaine_CM: folds 
matiko09: folds 
poker-rat95: calls $2
kblkxls: calls $2
*** FLOP *** [6h Ah Td]
poker-rat95: checks 
kblkxls: checks 
t.sneijder: bets $6
poker-rat95: calls $6
kblkxls: folds 
*** TURN *** [6h Ah Td] [7d]
poker-rat95: checks 
t.sneijder: bets $9
poker-rat95: folds 
Uncalled bet ($9) returned to t.sneijder
t.sneijder collected $20.42 from pot
t.sneijder: doesn't show hand 
*** SUMMARY ***
Total pot $21.50 | Rake $1.08 
Board [6h Ah Td 7d]
Seat 1: Fivez folded before Flop (didn't bet)
Seat 2: koksskrt folded before Flop (didn't bet)
Seat 3: t.sneijder collected ($20.42)
Seat 4: Khaine_CM (button) folded before Flop (didn't bet)
Seat 6: matiko09 (small blind) folded before Flop
Seat 7: poker-rat95 (big blind) folded on the Turn
Seat 9: kblkxls folded on the Flop





PokerStars Hand #152660811101:  Hold'em No Limit ($0.50/$1.00 USD) - 2016/04/30 18:02:24 CET [2016/04/30 12:02:24 ET]
Table 'Raissa II' 9-max Seat #3 is the button
Seat 1: cap. marb ($40.88 in chips) 
Seat 2: azzad2007 ($100 in chips) 
Seat 3: Kelvin sai ($36.07 in chips) 
Seat 4: koksskrt ($122.55 in chips) 
Seat 5: Jess7jay ($90.81 in chips) 
Seat 6: ilaviiitech ($109.15 in chips) 
Seat 7: matiko09 ($100 in chips) 
Seat 8: R1aki ($112.50 in chips) 
Seat 9: ApkawaDavit ($100 in chips) 
koksskrt: posts small blind $0.50
Jess7jay: posts big blind $1
*** HOLE CARDS ***
Dealt to matiko09 [3h As]
ilaviiitech: folds 
matiko09: folds 
R1aki: folds 
ApkawaDavit: folds 
cap. marb: folds 
azzad2007: folds 
Kelvin sai: folds 
koksskrt: folds 
Uncalled bet ($0.50) returned to Jess7jay
Jess7jay collected $1 from pot
Jess7jay: doesn't show hand 
*** SUMMARY ***
Total pot $1 | Rake $0 
Seat 1: cap. marb folded before Flop (didn't bet)
Seat 2: azzad2007 folded before Flop (didn't bet)
Seat 3: Kelvin sai (button) folded before Flop (didn't bet)
Seat 4: koksskrt (small blind) folded before Flop
Seat 5: Jess7jay (big blind) collected ($1)
Seat 6: ilaviiitech folded before Flop (didn't bet)
Seat 7: matiko09 folded before Flop (didn't bet)
Seat 8: R1aki folded before Flop (didn't bet)
Seat 9: ApkawaDavit folded before Flop (didn't bet)





PokerStars Hand #152660820472:  Hold'em No Limit ($0.50/$1.00 USD) - 2016/04/30 18:02:38 CET [2016/04/30 12:02:38 ET]
Table 'Arcturus' 9-max Seat #7 is the button
Seat 1: matiko09 ($101.50 in chips) 
Seat 2: Khaine_CM ($103.85 in chips) 
Seat 3: Spid1 ($100 in chips) 
Seat 4: cap. marb ($37 in chips) 
Seat 5: koksskrt ($100 in chips) 
Seat 6: JimineyCrik ($173.96 in chips) 
Seat 7: terrytsui111 ($134.36 in chips) 
Seat 8: ApkawaDavit ($105.40 in chips) 
ApkawaDavit: posts small blind $0.50
matiko09: posts big blind $1
*** HOLE CARDS ***
Dealt to matiko09 [Qd Th]
Khaine_CM: folds 
Spid1: raises $2 to $3
cap. marb: folds 
koksskrt: folds 
JimineyCrik: raises $2 to $5
terrytsui111: folds 
ApkawaDavit: folds 
matiko09: folds 
Spid1: calls $2
*** FLOP *** [8s Ts 8c]
Spid1: checks 
JimineyCrik: checks 
*** TURN *** [8s Ts 8c] [5s]
Spid1: bets $7.50
JimineyCrik: folds 
Uncalled bet ($7.50) returned to Spid1
Spid1 collected $10.92 from pot
Spid1: doesn't show hand 
*** SUMMARY ***
Total pot $11.50 | Rake $0.58 
Board [8s Ts 8c 5s]
Seat 1: matiko09 (big blind) folded before Flop
Seat 2: Khaine_CM folded before Flop (didn't bet)
Seat 3: Spid1 collected ($10.92)
Seat 4: cap. marb folded before Flop (didn't bet)
Seat 5: koksskrt folded before Flop (didn't bet)
Seat 6: JimineyCrik folded on the Turn
Seat 7: terrytsui111 (button) folded before Flop (didn't bet)
Seat 8: ApkawaDavit (small blind) folded before Flop





PokerStars Hand #152660825704:  Hold'em No Limit ($0.50/$1.00 USD) - 2016/04/30 18:02:45 CET [2016/04/30 12:02:45 ET]
Table 'Raissa II' 9-max Seat #4 is the button
Seat 1: cap. marb ($40.88 in chips) 
Seat 2: azzad2007 ($100 in chips) 
Seat 3: Kelvin sai ($36.07 in chips) 
Seat 4: koksskrt ($122.05 in chips) 
Seat 5: Jess7jay ($91.31 in chips) 
Seat 6: ilaviiitech ($109.15 in chips) 
Seat 7: matiko09 ($100 in chips) 
Seat 8: R1aki ($112.50 in chips) 
Seat 9: ApkawaDavit ($100 in chips) 
Jess7jay: posts small blind $0.50
ilaviiitech: posts big blind $1
*** HOLE CARDS ***
Dealt to matiko09 [Th Qs]
matiko09: folds 
R1aki: folds 
ApkawaDavit: folds 
cap. marb: folds 
azzad2007: folds 
Kelvin sai: folds 
koksskrt: folds 
Jess7jay: raises $1 to $2
ilaviiitech: calls $1
*** FLOP *** [Qh Ah Tc]
Jess7jay: bets $2
ilaviiitech: folds 
Uncalled bet ($2) returned to Jess7jay
Jess7jay collected $3.80 from pot
Jess7jay: doesn't show hand 
*** SUMMARY ***
Total pot $4 | Rake $0.20 
Board [Qh Ah Tc]
Seat 1: cap. marb folded before Flop (didn't bet)
Seat 2: azzad2007 folded before Flop (didn't bet)
Seat 3: Kelvin sai folded before Flop (didn't bet)
Seat 4: koksskrt (button) folded before Flop (didn't bet)
Seat 5: Jess7jay (small blind) collected ($3.80)
Seat 6: ilaviiitech (big blind) folded on the Flop
Seat 7: matiko09 folded before Flop (didn't bet)
Seat 8: R1aki folded before Flop (didn't bet)
Seat 9: ApkawaDavit folded before Flop (didn't bet)





PokerStars Hand #152660829795:  Hold'em No Limit ($0.50/$1.00 USD) - 2016/04/30 18:02:48 CET [2016/04/30 12:02:48 ET]
Table 'Tamariwa' 9-max Seat #5 is the button
Seat 1: matiko09 ($100 in chips) 
Seat 2: ilaviiitech ($100 in chips) 
Seat 3: Spid1 ($100 in chips) 
Seat 4: cap. marb ($41.50 in chips) 
Seat 5: Lobbyist98 ($92.67 in chips) 
Seat 6: El tourist ($56.50 in chips) 
Seat 7: Khaine_CM ($100 in chips) 
Seat 8: R1aki ($133.05 in chips) 
Seat 9: ApkawaDavit ($179.62 in chips) 
El tourist: posts small blind $0.50
Khaine_CM: posts big blind $1
*** HOLE CARDS ***
Dealt to matiko09 [Th 5s]
R1aki: folds 
R1aki leaves the table
ApkawaDavit: folds 
hurtNCYDE joins the table at seat #8 
matiko09: folds 
hurtNCYDE leaves the table
ilaviiitech: folds 
Spid1: folds 
cap. marb: folds 
Lobbyist98: folds 
El tourist: folds 
Uncalled bet ($0.50) returned to Khaine_CM
Khaine_CM collected $1 from pot
Khaine_CM: doesn't show hand 
*** SUMMARY ***
Total pot $1 | Rake $0 
Seat 1: matiko09 folded before Flop (didn't bet)
Seat 2: ilaviiitech folded before Flop (didn't bet)
Seat 3: Spid1 folded before Flop (didn't bet)
Seat 4: cap. marb folded before Flop (didn't bet)
Seat 5: Lobbyist98 (button) folded before Flop (didn't bet)
Seat 6: El tourist (small blind) folded before Flop
Seat 7: Khaine_CM (big blind) collected ($1)
Seat 8: R1aki folded before Flop (didn't bet)
Seat 9: ApkawaDavit folded before Flop (didn't bet)





PokerStars Hand #152660844791:  Hold'em No Limit ($0.50/$1.00 USD) - 2016/04/30 18:03:09 CET [2016/04/30 12:03:09 ET]
Table 'Malautra II' 9-max Seat #6 is the button
Seat 1: Fivez ($166.19 in chips) 
Seat 2: koksskrt ($101 in chips) 
Seat 3: t.sneijder ($80.13 in chips) 
Seat 4: Khaine_CM ($103.48 in chips) 
Seat 6: matiko09 ($100 in chips) 
Seat 7: poker-rat95 ($37.78 in chips) 
Seat 8: maxxmeister ($168.38 in chips) 
Seat 9: kblkxls ($124.33 in chips) 
poker-rat95: posts small blind $0.50
maxxmeister: posts big blind $1
*** HOLE CARDS ***
Dealt to matiko09 [5h Jc]
kblkxls: folds 
Fivez: folds 
koksskrt: folds 
t.sneijder: folds 
Khaine_CM: raises $1.50 to $2.50
matiko09: folds 
poker-rat95: folds 
maxxmeister: folds 
Uncalled bet ($1.50) returned to Khaine_CM
Khaine_CM collected $2.50 from pot
Khaine_CM: doesn't show hand 
*** SUMMARY ***
Total pot $2.50 | Rake $0 
Seat 1: Fivez folded before Flop (didn't bet)
Seat 2: koksskrt folded before Flop (didn't bet)
Seat 3: t.sneijder folded before Flop (didn't bet)
Seat 4: Khaine_CM collected ($2.50)
Seat 6: matiko09 (button) folded before Flop (didn't bet)
Seat 7: poker-rat95 (small blind) folded before Flop
Seat 8: maxxmeister (big blind) folded before Flop
Seat 9: kblkxls folded before Flop (didn't bet)





PokerStars Hand #152660848018:  Hold'em No Limit ($0.50/$1.00 USD) - 2016/04/30 18:03:14 CET [2016/04/30 12:03:14 ET]
Table 'Arcturus' 9-max Seat #8 is the button
Seat 1: matiko09 ($100.50 in chips) 
Seat 2: Khaine_CM ($103.85 in chips) 
Seat 3: Spid1 ($105.92 in chips) 
Seat 4: cap. marb ($37 in chips) 
Seat 5: koksskrt ($100 in chips) 
Seat 6: JimineyCrik ($168.96 in chips) 
Seat 7: terrytsui111 ($134.36 in chips) 
Seat 8: ApkawaDavit ($104.90 in chips) 
matiko09: posts small blind $0.50
Khaine_CM: posts big blind $1
*** HOLE CARDS ***
Dealt to matiko09 [8s 7h]
Spid1: folds 
cap. marb: folds 
koksskrt: raises $2 to $3
JimineyCrik: folds 
terrytsui111: calls $3
ApkawaDavit: raises $9.50 to $12.50
matiko09: folds 
Khaine_CM: raises $11.50 to $24
koksskrt: folds 
terrytsui111: folds 
ApkawaDavit: folds 
Uncalled bet ($11.50) returned to Khaine_CM
Khaine_CM collected $31.50 from pot
Khaine_CM: doesn't show hand 
*** SUMMARY ***
Total pot $31.50 | Rake $0 
Seat 1: matiko09 (small blind) folded before Flop
Seat 2: Khaine_CM (big blind) collected ($31.50)
Seat 3: Spid1 folded before Flop (didn't bet)
Seat 4: cap. marb folded before Flop (didn't bet)
Seat 5: koksskrt folded before Flop
Seat 6: JimineyCrik folded before Flop (didn't bet)
Seat 7: terrytsui111 folded before Flop
Seat 8: ApkawaDavit (button) folded before Flop





PokerStars Hand #152660858078:  Hold'em No Limit ($0.50/$1.00 USD) - 2016/04/30 18:03:28 CET [2016/04/30 12:03:28 ET]
Table 'Raissa II' 9-max Seat #5 is the button
Seat 1: cap. marb ($40.88 in chips) 
Seat 2: azzad2007 ($100 in chips) 
Seat 3: Kelvin sai ($36.07 in chips) 
Seat 4: koksskrt ($122.05 in chips) 
Seat 5: Jess7jay ($93.11 in chips) 
Seat 6: ilaviiitech ($107.15 in chips) 
Seat 7: matiko09 ($100 in chips) 
Seat 8: R1aki ($112.50 in chips) 
Seat 9: ApkawaDavit ($100 in chips) 
ilaviiitech: posts small blind $0.50
matiko09: posts big blind $1
*** HOLE CARDS ***
Dealt to matiko09 [4h 7d]
R1aki: folds 
R1aki leaves the table
ApkawaDavit: raises $2 to $3
cap. marb: folds 
azzad2007: folds 
Kelvin sai: folds 
Khaine_CM joins the table at seat #8 
koksskrt: raises $6 to $9
Jess7jay: folds 
ilaviiitech: folds 
matiko09: folds 
ApkawaDavit: calls $6
*** FLOP *** [6s 3h As]
ApkawaDavit: checks 
koksskrt: bets $9.63
ApkawaDavit: calls $9.63
*** TURN *** [6s 3h As] [9h]
ApkawaDavit: checks 
koksskrt: bets $22
ApkawaDavit: raises $59.37 to $81.37 and is all-in
koksskrt: folds 
Uncalled bet ($59.37) returned to ApkawaDavit
ApkawaDavit collected $80.26 from pot
ApkawaDavit: doesn't show hand 
*** SUMMARY ***
Total pot $82.76 | Rake $2.50 
Board [6s 3h As 9h]
Seat 1: cap. marb folded before Flop (didn't bet)
Seat 2: azzad2007 folded before Flop (didn't bet)
Seat 3: Kelvin sai folded before Flop (didn't bet)
Seat 4: koksskrt folded on the Turn
Seat 5: Jess7jay (button) folded before Flop (didn't bet)
Seat 6: ilaviiitech (small blind) folded before Flop
Seat 7: matiko09 (big blind) folded before Flop
Seat 8: R1aki folded before Flop (didn't bet)
Seat 9: ApkawaDavit collected ($80.26)





PokerStars Hand #152660859175:  Hold'em No Limit ($0.50/$1.00 USD) - 2016/04/30 18:03:29 CET [2016/04/30 12:03:29 ET]
Table 'Goto' 9-max Seat #8 is the button
Seat 1: naaaate_diaz ($107.23 in chips) 
Seat 3: matiko09 ($117.42 in chips) 
Seat 4: koksskrt ($100 in chips) 
Seat 5: hotsoo ($61.53 in chips) 
Seat 7: Spid1 ($100 in chips) 
Seat 8: R1aki ($100 in chips) 
Seat 9: maxxmeister ($102.72 in chips) 
maxxmeister: posts small blind $0.50
naaaate_diaz: posts big blind $1
Khaine_CM: sits out 
*** HOLE CARDS ***
Dealt to matiko09 [Js Qs]
matiko09: raises $2 to $3
koksskrt: folds 
hotsoo: folds 
Spid1: raises $6 to $9
R1aki: folds 
maxxmeister: folds 
naaaate_diaz: folds 
matiko09: folds 
Uncalled bet ($6) returned to Spid1
Spid1 collected $7.50 from pot
Spid1: doesn't show hand 
*** SUMMARY ***
Total pot $7.50 | Rake $0 
Seat 1: naaaate_diaz (big blind) folded before Flop
Seat 3: matiko09 folded before Flop
Seat 4: koksskrt folded before Flop (didn't bet)
Seat 5: hotsoo folded before Flop (didn't bet)
Seat 7: Spid1 collected ($7.50)
Seat 8: R1aki (button) folded before Flop (didn't bet)
Seat 9: maxxmeister (small blind) folded before Flop





PokerStars Hand #152660862153:  Hold'em No Limit (€0.50/€1.00 EUR) - 2016/04/30 18:03:33 CET [2016/04/30 12:03:33 ET]
Table 'Benda' 9-max Seat #5 is the button
Seat 1: aquarua7 (€215.38 in chips) 
Seat 2: cap. marb (€37 in chips) 
Seat 3: R1aki (€100 in chips) 
Seat 4: fireball2112 (€86.70 in chips) 
Seat 5: Spid1 (€104 in chips) 
Seat 7: Ouga Buga (€100 in chips) 
Seat 8: matiko09 (€103 in chips) 
Ouga Buga: posts small blind €0.50
matiko09: posts big blind €1
*** HOLE CARDS ***
Dealt to matiko09 [8d 8h]
aquarua7: folds 
cap. marb: folds 
R1aki: raises €1.50 to €2.50
fireball2112: folds 
Spid1: folds 
Ouga Buga: folds 
matiko09: calls €1.50
*** FLOP *** [9c Kc Jh]
matiko09: checks 
R1aki: checks 
*** TURN *** [9c Kc Jh] [5s]
matiko09: checks 
R1aki: checks 
*** RIVER *** [9c Kc Jh 5s] [Qc]
matiko09: checks 
R1aki: checks 
*** SHOW DOWN ***
matiko09: shows [8d 8h] (a pair of Eights)
R1aki: mucks hand 
matiko09 collected €5.22 from pot
*** SUMMARY ***
Total pot €5.50 | Rake €0.28 
Board [9c Kc Jh 5s Qc]
Seat 1: aquarua7 folded before Flop (didn't bet)
Seat 2: cap. marb folded before Flop (didn't bet)
Seat 3: R1aki mucked [7s 7d]
Seat 4: fireball2112 folded before Flop (didn't bet)
Seat 5: Spid1 (button) folded before Flop (didn't bet)
Seat 7: Ouga Buga (small blind) folded before Flop
Seat 8: matiko09 (big blind) showed [8d 8h] and won (€5.22) with a pair of Eights





PokerStars Hand #152660866660:  Hold'em No Limit ($0.50/$1.00 USD) - 2016/04/30 18:03:39 CET [2016/04/30 12:03:39 ET]
Table 'Malautra II' 9-max Seat #7 is the button
Seat 1: Fivez ($166.19 in chips) 
Seat 2: koksskrt ($101 in chips) 
Seat 3: t.sneijder ($80.13 in chips) 
Seat 4: Khaine_CM ($104.98 in chips) 
Seat 6: matiko09 ($100 in chips) 
Seat 7: poker-rat95 ($37.28 in chips) 
Seat 8: maxxmeister ($167.38 in chips) 
Seat 9: kblkxls ($124.33 in chips) 
maxxmeister: posts small blind $0.50
kblkxls: posts big blind $1
*** HOLE CARDS ***
Dealt to matiko09 [7h 3d]
Fivez: folds 
koksskrt: folds 
t.sneijder: folds 
Khaine_CM: folds 
matiko09: folds 
poker-rat95: folds 
maxxmeister: raises $3 to $4
kblkxls: folds 
Uncalled bet ($3) returned to maxxmeister
maxxmeister collected $2 from pot
maxxmeister: doesn't show hand 
*** SUMMARY ***
Total pot $2 | Rake $0 
Seat 1: Fivez folded before Flop (didn't bet)
Seat 2: koksskrt folded before Flop (didn't bet)
Seat 3: t.sneijder folded before Flop (didn't bet)
Seat 4: Khaine_CM folded before Flop (didn't bet)
Seat 6: matiko09 folded before Flop (didn't bet)
Seat 7: poker-rat95 (button) folded before Flop (didn't bet)
Seat 8: maxxmeister (small blind) collected ($2)
Seat 9: kblkxls (big blind) folded before Flop





PokerStars Hand #152660887351:  Hold'em No Limit ($0.50/$1.00 USD) - 2016/04/30 18:04:07 CET [2016/04/30 12:04:07 ET]
Table 'Malautra II' 9-max Seat #8 is the button
Seat 1: Fivez ($166.19 in chips) 
Seat 2: koksskrt ($101 in chips) 
Seat 3: t.sneijder ($80.13 in chips) 
Seat 4: Khaine_CM ($104.98 in chips) 
Seat 6: matiko09 ($100 in chips) 
Seat 7: poker-rat95 ($37.28 in chips) 
Seat 8: maxxmeister ($168.38 in chips) 
Seat 9: kblkxls ($123.33 in chips) 
kblkxls: posts small blind $0.50
Fivez: posts big blind $1
*** HOLE CARDS ***
Dealt to matiko09 [8d 6s]
koksskrt: folds 
t.sneijder: calls $1
Khaine_CM: folds 
matiko09: folds 
poker-rat95: folds 
maxxmeister: calls $1
kblkxls: calls $0.50
Fivez: checks 
*** FLOP *** [4h Kc 9c]
kblkxls: checks 
Fivez: checks 
t.sneijder: checks 
maxxmeister: bets $3
kblkxls: folds 
Fivez: folds 
t.sneijder: calls $3
*** TURN *** [4h Kc 9c] [Kh]
t.sneijder: checks 
maxxmeister: checks 
*** RIVER *** [4h Kc 9c Kh] [5d]
t.sneijder: checks 
maxxmeister: checks 
*** SHOW DOWN ***
t.sneijder: shows [3s 5c] (two pair, Kings and Fives)
maxxmeister: shows [Js 9d] (two pair, Kings and Nines)
maxxmeister collected $9.50 from pot
*** SUMMARY ***
Total pot $10 | Rake $0.50 
Board [4h Kc 9c Kh 5d]
Seat 1: Fivez (big blind) folded on the Flop
Seat 2: koksskrt folded before Flop (didn't bet)
Seat 3: t.sneijder showed [3s 5c] and lost with two pair, Kings and Fives
Seat 4: Khaine_CM folded before Flop (didn't bet)
Seat 6: matiko09 folded before Flop (didn't bet)
Seat 7: poker-rat95 folded before Flop (didn't bet)
Seat 8: maxxmeister (button) showed [Js 9d] and won ($9.50) with two pair, Kings and Nines
Seat 9: kblkxls (small blind) folded on the Flop





PokerStars Hand #152660893514:  Hold'em No Limit ($0.50/$1.00 USD) - 2016/04/30 18:04:15 CET [2016/04/30 12:04:15 ET]
Table 'Lova II' 9-max Seat #1 is the button
Seat 1: koksskrt ($106.50 in chips) 
Seat 2: bilukm ($281.20 in chips) 
Seat 3: matiko09 ($100 in chips) 
Seat 4: 9lKBXKTT6 ($108.80 in chips) 
Seat 5: R1aki ($100 in chips) 
Seat 6: di0d80 ($117.17 in chips) 
Seat 7: meysam270 ($46.55 in chips) 
Seat 8: cap. marb ($38.50 in chips) 
bilukm: posts small blind $0.50
matiko09: posts big blind $1
hurtNCYDE: sits out 
*** HOLE CARDS ***
Dealt to matiko09 [7h 6d]
9lKBXKTT6: folds 
9lKBXKTT6 leaves the table
VanDobeln joins the table at seat #4 
R1aki: folds 
R1aki leaves the table
Ilov3NBA joins the table at seat #5 
di0d80: folds 
meysam270: raises $2 to $3
cap. marb: calls $3
koksskrt: folds 
bilukm: folds 
matiko09: folds 
*** FLOP *** [7s 3d Ad]
meysam270: bets $4.62
Ilov3NBA is disconnected 
cap. marb: raises $5.88 to $10.50
meysam270: folds 
Uncalled bet ($5.88) returned to cap. marb
cap. marb collected $15.90 from pot
cap. marb: doesn't show hand 
*** SUMMARY ***
Total pot $16.74 | Rake $0.84 
Board [7s 3d Ad]
Seat 1: koksskrt (button) folded before Flop (didn't bet)
Seat 2: bilukm (small blind) folded before Flop
Seat 3: matiko09 (big blind) folded before Flop
Seat 4: 9lKBXKTT6 folded before Flop (didn't bet)
Seat 5: R1aki folded before Flop (didn't bet)
Seat 6: di0d80 folded before Flop (didn't bet)
Seat 7: meysam270 folded on the Flop
Seat 8: cap. marb collected ($15.90)





PokerStars Hand #152660897180:  Hold'em No Limit ($0.50/$1.00 USD) - 2016/04/30 18:04:20 CET [2016/04/30 12:04:20 ET]
Table 'Arcturus' 9-max Seat #1 is the button
Seat 1: matiko09 ($100 in chips) 
Seat 2: Khaine_CM ($122.85 in chips) 
Seat 3: Spid1 ($105.92 in chips) 
Seat 4: cap. marb ($37 in chips) 
Seat 5: koksskrt ($100 in chips) 
Seat 6: JimineyCrik ($168.96 in chips) 
Seat 7: terrytsui111 ($131.36 in chips) 
Seat 8: ApkawaDavit ($100 in chips) 
Khaine_CM: posts small blind $0.50
Spid1: posts big blind $1
*** HOLE CARDS ***
Dealt to matiko09 [9d Js]
cap. marb: folds 
koksskrt: folds 
JimineyCrik: folds 
terrytsui111: folds 
ApkawaDavit: folds 
matiko09: raises $1.27 to $2.27
Khaine_CM: folds 
Spid1: calls $1.27
*** FLOP *** [Ac 6h Qs]
Spid1: checks 
matiko09: bets $2.49
Spid1: calls $2.49
*** TURN *** [Ac 6h Qs] [Qc]
Spid1: checks 
matiko09: checks 
*** RIVER *** [Ac 6h Qs Qc] [3h]
Spid1: bets $9.50
matiko09: folds 
Uncalled bet ($9.50) returned to Spid1
Spid1 collected $9.52 from pot
Spid1: doesn't show hand 
*** SUMMARY ***
Total pot $10.02 | Rake $0.50 
Board [Ac 6h Qs Qc 3h]
Seat 1: matiko09 (button) folded on the River
Seat 2: Khaine_CM (small blind) folded before Flop
Seat 3: Spid1 (big blind) collected ($9.52)
Seat 4: cap. marb folded before Flop (didn't bet)
Seat 5: koksskrt folded before Flop (didn't bet)
Seat 6: JimineyCrik folded before Flop (didn't bet)
Seat 7: terrytsui111 folded before Flop (didn't bet)
Seat 8: ApkawaDavit folded before Flop (didn't bet)





PokerStars Hand #152660912594:  Hold'em No Limit (€0.50/€1.00 EUR) - 2016/04/30 18:04:40 CET [2016/04/30 12:04:40 ET]
Table 'Benda' 9-max Seat #7 is the button
Seat 1: aquarua7 (€215.38 in chips) 
Seat 2: cap. marb (€37 in chips) 
Seat 3: R1aki (€100 in chips) 
Seat 4: fireball2112 (€86.70 in chips) 
Seat 5: Spid1 (€104 in chips) 
Seat 7: Ouga Buga (€100 in chips) 
Seat 8: matiko09 (€105.72 in chips) 
matiko09: posts small blind €0.50
aquarua7: posts big blind €1
*** HOLE CARDS ***
Dealt to matiko09 [9c Ah]
cap. marb: folds 
R1aki: folds 
fireball2112: folds 
Spid1: folds 
Ouga Buga: folds 
matiko09: raises €1.50 to €2.50
aquarua7: calls €1.50
*** FLOP *** [2h 7c 3c]
matiko09: bets €3.09
aquarua7: calls €3.09
*** TURN *** [2h 7c 3c] [Jh]
matiko09: checks 
aquarua7: checks 
*** RIVER *** [2h 7c 3c Jh] [Qc]
matiko09: checks 
aquarua7: bets €7.07
matiko09: folds 
Uncalled bet (€7.07) returned to aquarua7
aquarua7 collected €10.62 from pot
aquarua7: doesn't show hand 
*** SUMMARY ***
Total pot €11.18 | Rake €0.56 
Board [2h 7c 3c Jh Qc]
Seat 1: aquarua7 (big blind) collected (€10.62)
Seat 2: cap. marb folded before Flop (didn't bet)
Seat 3: R1aki folded before Flop (didn't bet)
Seat 4: fireball2112 folded before Flop (didn't bet)
Seat 5: Spid1 folded before Flop (didn't bet)
Seat 7: Ouga Buga (button) folded before Flop (didn't bet)
Seat 8: matiko09 (small blind) folded on the River





PokerStars Hand #152660939717:  Hold'em No Limit ($0.50/$1.00 USD) - 2016/04/30 18:05:05 CET [2016/04/30 12:05:05 ET]
Table 'Raissa II' 9-max Seat #6 is the button
Seat 1: cap. marb ($40.88 in chips) 
Seat 2: azzad2007 ($100 in chips) 
Seat 3: Kelvin sai ($36.07 in chips) 
Seat 4: koksskrt ($100 in chips) 
Seat 5: Jess7jay ($93.11 in chips) 
Seat 6: ilaviiitech ($106.65 in chips) 
Seat 7: matiko09 ($100 in chips) 
Seat 8: Khaine_CM ($100 in chips) 
Seat 9: ApkawaDavit ($139.63 in chips) 
matiko09: posts small blind $0.50
Khaine_CM: posts big blind $1
*** HOLE CARDS ***
Dealt to matiko09 [2d 3s]
ApkawaDavit: folds 
cap. marb: folds 
azzad2007: folds 
Kelvin sai: raises $1 to $2
koksskrt: folds 
Jess7jay: folds 
ilaviiitech: folds 
matiko09: folds 
Khaine_CM: folds 
Uncalled bet ($1) returned to Kelvin sai
Kelvin sai collected $2.50 from pot
Kelvin sai: doesn't show hand 
*** SUMMARY ***
Total pot $2.50 | Rake $0 
Seat 1: cap. marb folded before Flop (didn't bet)
Seat 2: azzad2007 folded before Flop (didn't bet)
Seat 3: Kelvin sai collected ($2.50)
Seat 4: koksskrt folded before Flop (didn't bet)
Seat 5: Jess7jay folded before Flop (didn't bet)
Seat 6: ilaviiitech (button) folded before Flop (didn't bet)
Seat 7: matiko09 (small blind) folded before Flop
Seat 8: Khaine_CM (big blind) folded before Flop
Seat 9: ApkawaDavit folded before Flop (didn't bet)





PokerStars Hand #152660941655:  Hold'em No Limit ($0.50/$1.00 USD) - 2016/04/30 18:05:08 CET [2016/04/30 12:05:08 ET]
Table 'Malautra II' 9-max Seat #9 is the button
Seat 1: Fivez ($165.19 in chips) 
Seat 2: koksskrt ($101 in chips) 
Seat 3: t.sneijder ($76.13 in chips) 
Seat 4: Khaine_CM ($104.98 in chips) 
Seat 6: matiko09 ($100 in chips) 
Seat 7: poker-rat95 ($37.28 in chips) 
Seat 8: maxxmeister ($173.88 in chips) 
Seat 9: kblkxls ($122.33 in chips) 
Fivez: posts small blind $0.50
koksskrt: posts big blind $1
*** HOLE CARDS ***
Dealt to matiko09 [4c 3s]
t.sneijder: folds 
Khaine_CM: folds 
matiko09: folds 
poker-rat95: folds 
maxxmeister: folds 
kblkxls: raises $1.50 to $2.50
Fivez: calls $2
koksskrt: folds 
*** FLOP *** [8d Kh 7d]
Fivez: checks 
kblkxls: checks 
*** TURN *** [8d Kh 7d] [9s]
Fivez: checks 
kblkxls: bets $3
Fivez: folds 
Uncalled bet ($3) returned to kblkxls
kblkxls collected $5.70 from pot
kblkxls: doesn't show hand 
*** SUMMARY ***
Total pot $6 | Rake $0.30 
Board [8d Kh 7d 9s]
Seat 1: Fivez (small blind) folded on the Turn
Seat 2: koksskrt (big blind) folded before Flop
Seat 3: t.sneijder folded before Flop (didn't bet)
Seat 4: Khaine_CM folded before Flop (didn't bet)
Seat 6: matiko09 folded before Flop (didn't bet)
Seat 7: poker-rat95 folded before Flop (didn't bet)
Seat 8: maxxmeister folded before Flop (didn't bet)
Seat 9: kblkxls (button) collected ($5.70)





PokerStars Hand #152660947455:  Hold'em No Limit ($0.50/$1.00 USD) - 2016/04/30 18:05:15 CET [2016/04/30 12:05:15 ET]
Table 'Arcturus' 9-max Seat #2 is the button
Seat 1: matiko09 ($100 in chips) 
Seat 2: Khaine_CM ($122.35 in chips) 
Seat 3: Spid1 ($110.68 in chips) 
Seat 4: cap. marb ($37 in chips) 
Seat 5: koksskrt ($100 in chips) 
Seat 6: JimineyCrik ($168.96 in chips) 
Seat 7: terrytsui111 ($131.36 in chips) 
Seat 8: ApkawaDavit ($100 in chips) 
Spid1: posts small blind $0.50
cap. marb: posts big blind $1
*** HOLE CARDS ***
Dealt to matiko09 [4d Js]
koksskrt: folds 
JimineyCrik: folds 
terrytsui111: folds 
ApkawaDavit: folds 
matiko09: folds 
Khaine_CM: folds 
Spid1: folds 
Uncalled bet ($0.50) returned to cap. marb
cap. marb collected $1 from pot
cap. marb: doesn't show hand 
*** SUMMARY ***
Total pot $1 | Rake $0 
Seat 1: matiko09 folded before Flop (didn't bet)
Seat 2: Khaine_CM (button) folded before Flop (didn't bet)
Seat 3: Spid1 (small blind) folded before Flop
Seat 4: cap. marb (big blind) collected ($1)
Seat 5: koksskrt folded before Flop (didn't bet)
Seat 6: JimineyCrik folded before Flop (didn't bet)
Seat 7: terrytsui111 folded before Flop (didn't bet)
Seat 8: ApkawaDavit folded before Flop (didn't bet)





PokerStars Hand #152660958097:  Hold'em No Limit ($0.50/$1.00 USD) - 2016/04/30 18:05:29 CET [2016/04/30 12:05:29 ET]
Table 'Lova II' 9-max Seat #2 is the button
Seat 1: koksskrt ($106.50 in chips) 
Seat 2: bilukm ($280.70 in chips) 
Seat 3: matiko09 ($100 in chips) 
Seat 4: VanDobeln ($100 in chips) 
Seat 6: di0d80 ($117.17 in chips) 
Seat 7: meysam270 ($38.93 in chips) 
Seat 8: cap. marb ($46.78 in chips) 
matiko09: posts small blind $0.50
VanDobeln: posts big blind $1
Ilov3NBA: sits out 
hurtNCYDE: sits out 
*** HOLE CARDS ***
Dealt to matiko09 [3h 8c]
di0d80: folds 
meysam270: folds 
cap. marb: folds 
koksskrt: folds 
bilukm: folds 
matiko09: folds 
Uncalled bet ($0.50) returned to VanDobeln
VanDobeln collected $1 from pot
VanDobeln: doesn't show hand 
*** SUMMARY ***
Total pot $1 | Rake $0 
Seat 1: koksskrt folded before Flop (didn't bet)
Seat 2: bilukm (button) folded before Flop (didn't bet)
Seat 3: matiko09 (small blind) folded before Flop
Seat 4: VanDobeln (big blind) collected ($1)
Seat 6: di0d80 folded before Flop (didn't bet)
Seat 7: meysam270 folded before Flop (didn't bet)
Seat 8: cap. marb folded before Flop (didn't bet)





PokerStars Hand #152660963380:  Hold'em No Limit ($0.50/$1.00 USD) - 2016/04/30 18:05:36 CET [2016/04/30 12:05:36 ET]
Table 'Arcturus' 9-max Seat #3 is the button
Seat 1: matiko09 ($100 in chips) 
Seat 2: Khaine_CM ($122.35 in chips) 
Seat 3: Spid1 ($110.18 in chips) 
Seat 4: cap. marb ($37.50 in chips) 
Seat 5: koksskrt ($100 in chips) 
Seat 6: JimineyCrik ($168.96 in chips) 
Seat 7: terrytsui111 ($131.36 in chips) 
Seat 8: ApkawaDavit ($100 in chips) 
cap. marb: posts small blind $0.50
koksskrt: posts big blind $1
*** HOLE CARDS ***
Dealt to matiko09 [Ah 6c]
JimineyCrik: raises $1 to $2
terrytsui111: calls $2
ApkawaDavit: folds 
matiko09: folds 
Khaine_CM: folds 
Spid1: folds 
cap. marb: folds 
koksskrt: raises $9 to $11
JimineyCrik: folds 
terrytsui111: folds 
Uncalled bet ($9) returned to koksskrt
koksskrt collected $6.50 from pot
koksskrt: doesn't show hand 
*** SUMMARY ***
Total pot $6.50 | Rake $0 
Seat 1: matiko09 folded before Flop (didn't bet)
Seat 2: Khaine_CM folded before Flop (didn't bet)
Seat 3: Spid1 (button) folded before Flop (didn't bet)
Seat 4: cap. marb (small blind) folded before Flop
Seat 5: koksskrt (big blind) collected ($6.50)
Seat 6: JimineyCrik folded before Flop
Seat 7: terrytsui111 folded before Flop
Seat 8: ApkawaDavit folded before Flop (didn't bet)





PokerStars Hand #152660965911:  Hold'em No Limit (€0.50/€1.00 EUR) - 2016/04/30 18:05:39 CET [2016/04/30 12:05:39 ET]
Table 'Benda' 9-max Seat #8 is the button
Seat 1: aquarua7 (€220.41 in chips) 
Seat 2: cap. marb (€37 in chips) 
Seat 3: R1aki (€100 in chips) 
Seat 4: fireball2112 (€86.70 in chips) 
Seat 5: Spid1 (€104 in chips) 
Seat 7: Ouga Buga (€100 in chips) 
Seat 8: matiko09 (€100.13 in chips) 
aquarua7: posts small blind €0.50
cap. marb: posts big blind €1
*** HOLE CARDS ***
Dealt to matiko09 [7d 8h]
R1aki: folds 
fireball2112: folds 
R1aki leaves the table
Spid1: folds 
Ouga Buga: folds 
ApkawaDavit joins the table at seat #3 
matiko09: folds 
aquarua7: folds 
Uncalled bet (€0.50) returned to cap. marb
cap. marb collected €1 from pot
cap. marb: doesn't show hand 
*** SUMMARY ***
Total pot €1 | Rake €0 
Seat 1: aquarua7 (small blind) folded before Flop
Seat 2: cap. marb (big blind) collected (€1)
Seat 3: R1aki folded before Flop (didn't bet)
Seat 4: fireball2112 folded before Flop (didn't bet)
Seat 5: Spid1 folded before Flop (didn't bet)
Seat 7: Ouga Buga folded before Flop (didn't bet)
Seat 8: matiko09 (button) folded before Flop (didn't bet)





PokerStars Hand #152660967359:  Hold'em No Limit ($0.50/$1.00 USD) - 2016/04/30 18:05:41 CET [2016/04/30 12:05:41 ET]
Table 'Raissa II' 9-max Seat #7 is the button
Seat 1: cap. marb ($40.88 in chips) 
Seat 2: azzad2007 ($100 in chips) 
Seat 3: Kelvin sai ($37.57 in chips) 
Seat 4: koksskrt ($100 in chips) 
Seat 5: Jess7jay ($93.11 in chips) 
Seat 6: ilaviiitech ($106.65 in chips) 
Seat 7: matiko09 ($100 in chips) 
Seat 8: Khaine_CM ($100 in chips) 
Seat 9: ApkawaDavit ($139.63 in chips) 
Khaine_CM: posts small blind $0.50
ApkawaDavit: posts big blind $1
*** HOLE CARDS ***
Dealt to matiko09 [4d Ts]
cap. marb: folds 
azzad2007: folds 
Kelvin sai: folds 
koksskrt: folds 
Jess7jay: raises $1 to $2
ilaviiitech: folds 
matiko09: folds 
Khaine_CM: folds 
ApkawaDavit: folds 
Uncalled bet ($1) returned to Jess7jay
Jess7jay collected $2.50 from pot
Jess7jay: doesn't show hand 
*** SUMMARY ***
Total pot $2.50 | Rake $0 
Seat 1: cap. marb folded before Flop (didn't bet)
Seat 2: azzad2007 folded before Flop (didn't bet)
Seat 3: Kelvin sai folded before Flop (didn't bet)
Seat 4: koksskrt folded before Flop (didn't bet)
Seat 5: Jess7jay collected ($2.50)
Seat 6: ilaviiitech folded before Flop (didn't bet)
Seat 7: matiko09 (button) folded before Flop (didn't bet)
Seat 8: Khaine_CM (small blind) folded before Flop
Seat 9: ApkawaDavit (big blind) folded before Flop





PokerStars Hand #152660968965:  Hold'em No Limit ($0.50/$1.00 USD) - 2016/04/30 18:05:43 CET [2016/04/30 12:05:43 ET]
Table 'Lova II' 9-max Seat #3 is the button
Seat 1: koksskrt ($106.50 in chips) 
Seat 2: bilukm ($280.70 in chips) 
Seat 3: matiko09 ($100 in chips) 
Seat 4: VanDobeln ($100.50 in chips) 
Seat 5: Ilov3NBA ($100 in chips) 
Seat 6: di0d80 ($117.17 in chips) 
Seat 7: meysam270 ($38.93 in chips) 
Seat 8: cap. marb ($46.78 in chips) 
VanDobeln: posts small blind $0.50
Ilov3NBA: posts big blind $1
hurtNCYDE: sits out 
*** HOLE CARDS ***
Dealt to matiko09 [7s 2c]
di0d80: folds 
meysam270: raises $2 to $3
cap. marb: folds 
koksskrt: folds 
bilukm: folds 
matiko09: folds 
VanDobeln: folds 
Ilov3NBA: folds 
Uncalled bet ($2) returned to meysam270
meysam270 collected $2.50 from pot
meysam270: doesn't show hand 
*** SUMMARY ***
Total pot $2.50 | Rake $0 
Seat 1: koksskrt folded before Flop (didn't bet)
Seat 2: bilukm folded before Flop (didn't bet)
Seat 3: matiko09 (button) folded before Flop (didn't bet)
Seat 4: VanDobeln (small blind) folded before Flop
Seat 5: Ilov3NBA (big blind) folded before Flop
Seat 6: di0d80 folded before Flop (didn't bet)
Seat 7: meysam270 collected ($2.50)
Seat 8: cap. marb folded before Flop (didn't bet)





PokerStars Hand #152660974579:  Hold'em No Limit ($0.50/$1.00 USD) - 2016/04/30 18:05:51 CET [2016/04/30 12:05:51 ET]
Table 'Malautra II' 9-max Seat #1 is the button
Seat 1: Fivez ($162.69 in chips) 
Seat 2: koksskrt ($100 in chips) 
Seat 3: t.sneijder ($76.13 in chips) 
Seat 4: Khaine_CM ($104.98 in chips) 
Seat 6: matiko09 ($100 in chips) 
Seat 7: poker-rat95 ($37.28 in chips) 
Seat 8: maxxmeister ($173.88 in chips) 
Seat 9: kblkxls ($125.53 in chips) 
koksskrt: posts small blind $0.50
t.sneijder: posts big blind $1
*** HOLE CARDS ***
Dealt to matiko09 [5c 2h]
Khaine_CM: folds 
matiko09: folds 
poker-rat95: folds 
maxxmeister: folds 
kblkxls: folds 
Fivez: raises $1.50 to $2.50
koksskrt: folds 
t.sneijder: calls $1.50
*** FLOP *** [Ks 5s 7c]
t.sneijder: bets $2
Fivez: calls $2
*** TURN *** [Ks 5s 7c] [6h]
t.sneijder: bets $3
Fivez: calls $3
*** RIVER *** [Ks 5s 7c 6h] [Kh]
t.sneijder: bets $7
Fivez: raises $16 to $23
t.sneijder: calls $16
*** SHOW DOWN ***
Fivez: shows [Td 8h] (a pair of Kings)
t.sneijder: shows [Qs Kc] (three of a kind, Kings)
t.sneijder collected $59 from pot
*** SUMMARY ***
Total pot $61.50 | Rake $2.50 
Board [Ks 5s 7c 6h Kh]
Seat 1: Fivez (button) showed [Td 8h] and lost with a pair of Kings
Seat 2: koksskrt (small blind) folded before Flop
Seat 3: t.sneijder (big blind) showed [Qs Kc] and won ($59) with three of a kind, Kings
Seat 4: Khaine_CM folded before Flop (didn't bet)
Seat 6: matiko09 folded before Flop (didn't bet)
Seat 7: poker-rat95 folded before Flop (didn't bet)
Seat 8: maxxmeister folded before Flop (didn't bet)
Seat 9: kblkxls folded before Flop (didn't bet)





PokerStars Hand #152660988599:  Hold'em No Limit ($0.50/$1.00 USD) - 2016/04/30 18:06:09 CET [2016/04/30 12:06:09 ET]
Table 'Raissa II' 9-max Seat #8 is the button
Seat 1: cap. marb ($40.88 in chips) 
Seat 2: azzad2007 ($100 in chips) 
Seat 3: Kelvin sai ($37.57 in chips) 
Seat 4: koksskrt ($100 in chips) 
Seat 5: Jess7jay ($94.61 in chips) 
Seat 6: ilaviiitech ($106.65 in chips) 
Seat 7: matiko09 ($100 in chips) 
Seat 8: Khaine_CM ($100 in chips) 
Seat 9: ApkawaDavit ($138.63 in chips) 
ApkawaDavit: posts small blind $0.50
cap. marb: posts big blind $1
*** HOLE CARDS ***
Dealt to matiko09 [9s 4c]
azzad2007: folds 
Kelvin sai: folds 
koksskrt: folds 
Jess7jay: folds 
ilaviiitech: folds 
matiko09: folds 
Khaine_CM: raises $1 to $2
ApkawaDavit: folds 
cap. marb: folds 
Uncalled bet ($1) returned to Khaine_CM
Khaine_CM collected $2.50 from pot
Khaine_CM: doesn't show hand 
*** SUMMARY ***
Total pot $2.50 | Rake $0 
Seat 1: cap. marb (big blind) folded before Flop
Seat 2: azzad2007 folded before Flop (didn't bet)
Seat 3: Kelvin sai folded before Flop (didn't bet)
Seat 4: koksskrt folded before Flop (didn't bet)
Seat 5: Jess7jay folded before Flop (didn't bet)
Seat 6: ilaviiitech folded before Flop (didn't bet)
Seat 7: matiko09 folded before Flop (didn't bet)
Seat 8: Khaine_CM (button) collected ($2.50)
Seat 9: ApkawaDavit (small blind) folded before Flop





PokerStars Hand #152660995174:  Hold'em No Limit (€0.50/€1.00 EUR) - 2016/04/30 18:06:18 CET [2016/04/30 12:06:18 ET]
Table 'Benda' 9-max Seat #1 is the button
Seat 1: aquarua7 (€219.91 in chips) 
Seat 2: cap. marb (€37.50 in chips) 
Seat 3: ApkawaDavit (€100 in chips) 
Seat 4: fireball2112 (€86.70 in chips) 
Seat 5: Spid1 (€104 in chips) 
Seat 7: Ouga Buga (€100 in chips) 
Seat 8: matiko09 (€100.13 in chips) 
cap. marb: posts small blind €0.50
ApkawaDavit: posts big blind €1
*** HOLE CARDS ***
Dealt to matiko09 [3d Ts]
fireball2112: raises €2 to €3
Spid1: folds 
Ouga Buga: folds 
matiko09: folds 
aquarua7: folds 
cap. marb: folds 
ApkawaDavit: folds 
Uncalled bet (€2) returned to fireball2112
fireball2112 collected €2.50 from pot
fireball2112: doesn't show hand 
*** SUMMARY ***
Total pot €2.50 | Rake €0 
Seat 1: aquarua7 (button) folded before Flop (didn't bet)
Seat 2: cap. marb (small blind) folded before Flop
Seat 3: ApkawaDavit (big blind) folded before Flop
Seat 4: fireball2112 collected (€2.50)
Seat 5: Spid1 folded before Flop (didn't bet)
Seat 7: Ouga Buga folded before Flop (didn't bet)
Seat 8: matiko09 folded before Flop (didn't bet)





PokerStars Hand #152660996334:  Hold'em No Limit ($0.50/$1.00 USD) - 2016/04/30 18:06:19 CET [2016/04/30 12:06:19 ET]
Table 'Lova II' 9-max Seat #4 is the button
Seat 1: koksskrt ($106.50 in chips) 
Seat 2: bilukm ($280.70 in chips) 
Seat 3: matiko09 ($100 in chips) 
Seat 4: VanDobeln ($100 in chips) 
Seat 5: Ilov3NBA ($100 in chips) 
Seat 6: di0d80 ($117.17 in chips) 
Seat 7: meysam270 ($40.43 in chips) 
Seat 8: cap. marb ($46.78 in chips) 
Ilov3NBA: posts small blind $0.50
di0d80: posts big blind $1
hurtNCYDE: sits out 
*** HOLE CARDS ***
Dealt to matiko09 [Qd 3s]
meysam270: folds 
cap. marb: folds 
koksskrt: folds 
bilukm: raises $1 to $2
matiko09: folds 
VanDobeln: folds 
Ilov3NBA: folds 
di0d80: folds 
Uncalled bet ($1) returned to bilukm
bilukm collected $2.50 from pot
bilukm: doesn't show hand 
*** SUMMARY ***
Total pot $2.50 | Rake $0 
Seat 1: koksskrt folded before Flop (didn't bet)
Seat 2: bilukm collected ($2.50)
Seat 3: matiko09 folded before Flop (didn't bet)
Seat 4: VanDobeln (button) folded before Flop (didn't bet)
Seat 5: Ilov3NBA (small blind) folded before Flop
Seat 6: di0d80 (big blind) folded before Flop
Seat 7: meysam270 folded before Flop (didn't bet)
Seat 8: cap. marb folded before Flop (didn't bet)





PokerStars Hand #152661012915:  Hold'em No Limit ($0.50/$1.00 USD) - 2016/04/30 18:06:41 CET [2016/04/30 12:06:41 ET]
Table 'Malautra II' 9-max Seat #2 is the button
Seat 1: Fivez ($132.19 in chips) 
Seat 2: koksskrt ($100 in chips) 
Seat 3: t.sneijder ($104.63 in chips) 
Seat 4: Khaine_CM ($104.98 in chips) 
Seat 6: matiko09 ($100 in chips) 
Seat 7: poker-rat95 ($37.28 in chips) 
Seat 8: maxxmeister ($173.88 in chips) 
Seat 9: kblkxls ($125.53 in chips) 
t.sneijder: posts small blind $0.50
Khaine_CM: posts big blind $1
*** HOLE CARDS ***
Dealt to matiko09 [Kd Ts]
matiko09: folds 
poker-rat95: folds 
maxxmeister: folds 
kblkxls: raises $2 to $3
Fivez: folds 
koksskrt: folds 
t.sneijder: folds 
Khaine_CM: folds 
Uncalled bet ($2) returned to kblkxls
kblkxls collected $2.50 from pot
kblkxls: doesn't show hand 
*** SUMMARY ***
Total pot $2.50 | Rake $0 
Seat 1: Fivez folded before Flop (didn't bet)
Seat 2: koksskrt (button) folded before Flop (didn't bet)
Seat 3: t.sneijder (small blind) folded before Flop
Seat 4: Khaine_CM (big blind) folded before Flop
Seat 6: matiko09 folded before Flop (didn't bet)
Seat 7: poker-rat95 folded before Flop (didn't bet)
Seat 8: maxxmeister folded before Flop (didn't bet)
Seat 9: kblkxls collected ($2.50)





PokerStars Hand #152661014884:  Hold'em No Limit ($0.50/$1.00 USD) - 2016/04/30 18:06:44 CET [2016/04/30 12:06:44 ET]
Table 'Lova II' 9-max Seat #5 is the button
Seat 1: koksskrt ($106.50 in chips) 
Seat 2: bilukm ($282.20 in chips) 
Seat 3: matiko09 ($100 in chips) 
Seat 4: VanDobeln ($100 in chips) 
Seat 5: Ilov3NBA ($100 in chips) 
Seat 6: di0d80 ($116.17 in chips) 
Seat 7: meysam270 ($40.43 in chips) 
Seat 8: cap. marb ($46.78 in chips) 
di0d80: posts small blind $0.50
meysam270: posts big blind $1
hurtNCYDE: sits out 
*** HOLE CARDS ***
Dealt to matiko09 [3s 7s]
cap. marb: folds 
koksskrt: folds 
bilukm: folds 
matiko09: folds 
VanDobeln: raises $2 to $3
Ilov3NBA: raises $5.50 to $8.50
di0d80: folds 
meysam270: folds 
VanDobeln: calls $5.50
*** FLOP *** [8d 8s Ks]
VanDobeln: checks 
Ilov3NBA: bets $9.66
VanDobeln: calls $9.66
*** TURN *** [8d 8s Ks] [2s]
VanDobeln: checks 
Ilov3NBA: checks 
*** RIVER *** [8d 8s Ks 2s] [Qh]
VanDobeln: checks 
Ilov3NBA: bets $21
VanDobeln: calls $21
*** SHOW DOWN ***
Ilov3NBA: shows [4d 5d] (a pair of Eights)
VanDobeln: shows [As Kc] (two pair, Kings and Eights)
VanDobeln collected $77.32 from pot
*** SUMMARY ***
Total pot $79.82 | Rake $2.50 
Board [8d 8s Ks 2s Qh]
Seat 1: koksskrt folded before Flop (didn't bet)
Seat 2: bilukm folded before Flop (didn't bet)
Seat 3: matiko09 folded before Flop (didn't bet)
Seat 4: VanDobeln showed [As Kc] and won ($77.32) with two pair, Kings and Eights
Seat 5: Ilov3NBA (button) showed [4d 5d] and lost with a pair of Eights
Seat 6: di0d80 (small blind) folded before Flop
Seat 7: meysam270 (big blind) folded before Flop
Seat 8: cap. marb folded before Flop (didn't bet)





PokerStars Hand #152661018920:  Hold'em No Limit ($0.50/$1.00 USD) - 2016/04/30 18:06:49 CET [2016/04/30 12:06:49 ET]
Table 'Arcturus' 9-max Seat #4 is the button
Seat 1: matiko09 ($100 in chips) 
Seat 2: Khaine_CM ($122.35 in chips) 
Seat 3: Spid1 ($110.18 in chips) 
Seat 4: cap. marb ($37 in chips) 
Seat 5: koksskrt ($104.50 in chips) 
Seat 6: JimineyCrik ($166.96 in chips) 
Seat 7: terrytsui111 ($129.36 in chips) 
Seat 8: ApkawaDavit ($100 in chips) 
koksskrt: posts small blind $0.50
JimineyCrik: posts big blind $1
*** HOLE CARDS ***
Dealt to matiko09 [6s 3c]
terrytsui111: raises $1 to $2
ApkawaDavit: folds 
matiko09: folds 
Khaine_CM: folds 
Spid1: folds 
cap. marb: folds 
koksskrt: folds 
JimineyCrik: calls $1
*** FLOP *** [7s 5c Kd]
JimineyCrik: checks 
terrytsui111: bets $3
JimineyCrik: calls $3
*** TURN *** [7s 5c Kd] [Kc]
JimineyCrik: checks 
fishkida is disconnected 
terrytsui111: checks 
*** RIVER *** [7s 5c Kd Kc] [3d]
JimineyCrik: checks 
terrytsui111: bets $6
JimineyCrik: calls $6
*** SHOW DOWN ***
terrytsui111: shows [Ts Jc] (a pair of Kings)
JimineyCrik: shows [5h Jh] (two pair, Kings and Fives)
JimineyCrik collected $21.38 from pot
*** SUMMARY ***
Total pot $22.50 | Rake $1.12 
Board [7s 5c Kd Kc 3d]
Seat 1: matiko09 folded before Flop (didn't bet)
Seat 2: Khaine_CM folded before Flop (didn't bet)
Seat 3: Spid1 folded before Flop (didn't bet)
Seat 4: cap. marb (button) folded before Flop (didn't bet)
Seat 5: koksskrt (small blind) folded before Flop
Seat 6: JimineyCrik (big blind) showed [5h Jh] and won ($21.38) with two pair, Kings and Fives
Seat 7: terrytsui111 showed [Ts Jc] and lost with a pair of Kings
Seat 8: ApkawaDavit folded before Flop (didn't bet)





PokerStars Hand #152661018985:  Hold'em No Limit ($0.50/$1.00 USD) - 2016/04/30 18:06:49 CET [2016/04/30 12:06:49 ET]
Table 'Raissa II' 9-max Seat #9 is the button
Seat 1: cap. marb ($39.88 in chips) 
Seat 2: azzad2007 ($100 in chips) 
Seat 3: Kelvin sai ($37.57 in chips) 
Seat 4: koksskrt ($100 in chips) 
Seat 5: Jess7jay ($94.61 in chips) 
Seat 6: ilaviiitech ($106.65 in chips) 
Seat 7: matiko09 ($100 in chips) 
Seat 8: Khaine_CM ($101.50 in chips) 
Seat 9: ApkawaDavit ($138.13 in chips) 
cap. marb: posts small blind $0.50
azzad2007: posts big blind $1
*** HOLE CARDS ***
Dealt to matiko09 [3c 7d]
Kelvin sai: folds 
koksskrt: raises $2 to $3
Jess7jay: folds 
ilaviiitech: folds 
matiko09: folds 
Khaine_CM: folds 
ApkawaDavit: folds 
cap. marb: folds 
azzad2007: folds 
Uncalled bet ($2) returned to koksskrt
koksskrt collected $2.50 from pot
koksskrt: doesn't show hand 
*** SUMMARY ***
Total pot $2.50 | Rake $0 
Seat 1: cap. marb (small blind) folded before Flop
Seat 2: azzad2007 (big blind) folded before Flop
Seat 3: Kelvin sai folded before Flop (didn't bet)
Seat 4: koksskrt collected ($2.50)
Seat 5: Jess7jay folded before Flop (didn't bet)
Seat 6: ilaviiitech folded before Flop (didn't bet)
Seat 7: matiko09 folded before Flop (didn't bet)
Seat 8: Khaine_CM folded before Flop (didn't bet)
Seat 9: ApkawaDavit (button) folded before Flop (didn't bet)





PokerStars Hand #152661019628:  Hold'em No Limit (€0.50/€1.00 EUR) - 2016/04/30 18:06:50 CET [2016/04/30 12:06:50 ET]
Table 'Benda' 9-max Seat #2 is the button
Seat 1: aquarua7 (€219.91 in chips) 
Seat 2: cap. marb (€37 in chips) 
Seat 3: ApkawaDavit (€100 in chips) 
Seat 4: fireball2112 (€88.20 in chips) 
Seat 5: Spid1 (€104 in chips) 
Seat 7: Ouga Buga (€100 in chips) 
Seat 8: matiko09 (€100.13 in chips) 
ApkawaDavit: posts small blind €0.50
fireball2112: posts big blind €1
*** HOLE CARDS ***
Dealt to matiko09 [Qh Kd]
Spid1: folds 
Ouga Buga: raises €1.50 to €2.50
matiko09: folds 
aquarua7: raises €6.50 to €9
cap. marb: folds 
ApkawaDavit: folds 
fireball2112: folds 
Ouga Buga: folds 
Uncalled bet (€6.50) returned to aquarua7
aquarua7 collected €6.50 from pot
aquarua7: doesn't show hand 
*** SUMMARY ***
Total pot €6.50 | Rake €0 
Seat 1: aquarua7 collected (€6.50)
Seat 2: cap. marb (button) folded before Flop (didn't bet)
Seat 3: ApkawaDavit (small blind) folded before Flop
Seat 4: fireball2112 (big blind) folded before Flop
Seat 5: Spid1 folded before Flop (didn't bet)
Seat 7: Ouga Buga folded before Flop
Seat 8: matiko09 folded before Flop (didn't bet)





PokerStars Hand #152661024179:  Hold'em No Limit ($0.50/$1.00 USD) - 2016/04/30 18:06:56 CET [2016/04/30 12:06:56 ET]
Table 'Malautra II' 9-max Seat #3 is the button
Seat 1: Fivez ($132.19 in chips) 
Seat 2: koksskrt ($100 in chips) 
Seat 3: t.sneijder ($104.13 in chips) 
Seat 4: Khaine_CM ($103.98 in chips) 
Seat 6: matiko09 ($100 in chips) 
Seat 7: poker-rat95 ($37.28 in chips) 
Seat 8: maxxmeister ($173.88 in chips) 
Seat 9: kblkxls ($127.03 in chips) 
Khaine_CM: posts small blind $0.50
matiko09: posts big blind $1
*** HOLE CARDS ***
Dealt to matiko09 [Kh As]
poker-rat95: folds 
maxxmeister: folds 
kblkxls: folds 
Fivez: folds 
koksskrt: folds 
t.sneijder: calls $1
Khaine_CM: folds 
matiko09: raises $3.50 to $4.50
t.sneijder: calls $3.50
*** FLOP *** [6c Ac Js]
matiko09: bets $6
t.sneijder: folds 
Uncalled bet ($6) returned to matiko09
matiko09 collected $9.02 from pot
matiko09: doesn't show hand 
*** SUMMARY ***
Total pot $9.50 | Rake $0.48 
Board [6c Ac Js]
Seat 1: Fivez folded before Flop (didn't bet)
Seat 2: koksskrt folded before Flop (didn't bet)
Seat 3: t.sneijder (button) folded on the Flop
Seat 4: Khaine_CM (small blind) folded before Flop
Seat 6: matiko09 (big blind) collected ($9.02)
Seat 7: poker-rat95 folded before Flop (didn't bet)
Seat 8: maxxmeister folded before Flop (didn't bet)
Seat 9: kblkxls folded before Flop (didn't bet)





PokerStars Hand #152661043177:  Hold'em No Limit ($0.50/$1.00 USD) - 2016/04/30 18:07:21 CET [2016/04/30 12:07:21 ET]
Table 'Raissa II' 9-max Seat #1 is the button
Seat 1: cap. marb ($39.38 in chips) 
Seat 2: azzad2007 ($100 in chips) 
Seat 3: Kelvin sai ($37.57 in chips) 
Seat 4: koksskrt ($101.50 in chips) 
Seat 5: Jess7jay ($94.61 in chips) 
Seat 6: ilaviiitech ($106.65 in chips) 
Seat 7: matiko09 ($100 in chips) 
Seat 8: Khaine_CM ($101.50 in chips) 
Seat 9: ApkawaDavit ($138.13 in chips) 
azzad2007: posts small blind $0.50
Kelvin sai: posts big blind $1
*** HOLE CARDS ***
Dealt to matiko09 [8c 6s]
koksskrt: folds 
Jess7jay: calls $1
ilaviiitech: folds 
matiko09: folds 
Khaine_CM: folds 
ApkawaDavit: raises $2.50 to $3.50
cap. marb: folds 
azzad2007: folds 
Kelvin sai: calls $2.50
Jess7jay: calls $2.50
*** FLOP *** [Ac 9c Qs]
Kelvin sai: checks 
Jess7jay: checks 
ApkawaDavit: checks 
*** TURN *** [Ac 9c Qs] [5d]
Kelvin sai: bets $4
Jess7jay: calls $4
ApkawaDavit: folds 
*** RIVER *** [Ac 9c Qs 5d] [Qc]
Kelvin sai: bets $8
Jess7jay: calls $8
*** SHOW DOWN ***
Kelvin sai: shows [Kd Qd] (three of a kind, Queens)
Jess7jay: shows [4c 6c] (a flush, Ace high)
Jess7jay collected $33.25 from pot
*** SUMMARY ***
Total pot $35 | Rake $1.75 
Board [Ac 9c Qs 5d Qc]
Seat 1: cap. marb (button) folded before Flop (didn't bet)
Seat 2: azzad2007 (small blind) folded before Flop
Seat 3: Kelvin sai (big blind) showed [Kd Qd] and lost with three of a kind, Queens
Seat 4: koksskrt folded before Flop (didn't bet)
Seat 5: Jess7jay showed [4c 6c] and won ($33.25) with a flush, Ace high
Seat 6: ilaviiitech folded before Flop (didn't bet)
Seat 7: matiko09 folded before Flop (didn't bet)
Seat 8: Khaine_CM folded before Flop (didn't bet)
Seat 9: ApkawaDavit folded on the Turn





PokerStars Hand #152661046211:  Hold'em No Limit (€0.50/€1.00 EUR) - 2016/04/30 18:07:25 CET [2016/04/30 12:07:25 ET]
Table 'Benda' 9-max Seat #3 is the button
Seat 1: aquarua7 (€223.91 in chips) 
Seat 2: cap. marb (€37 in chips) 
Seat 3: ApkawaDavit (€100 in chips) 
Seat 4: fireball2112 (€87.20 in chips) 
Seat 5: Spid1 (€104 in chips) 
Seat 7: Ouga Buga (€100 in chips) 
Seat 8: matiko09 (€100.13 in chips) 
fireball2112: posts small blind €0.50
Spid1: posts big blind €1
*** HOLE CARDS ***
Dealt to matiko09 [4d 2c]
Ouga Buga: folds 
matiko09: folds 
aquarua7: folds 
cap. marb: folds 
ApkawaDavit: folds 
fireball2112: raises €1 to €2
Spid1: raises €6 to €8
fireball2112: calls €6
*** FLOP *** [Ks Jh 6h]
fireball2112: bets €5
Spid1: folds 
Uncalled bet (€5) returned to fireball2112
fireball2112 collected €15.20 from pot
fireball2112: doesn't show hand 
*** SUMMARY ***
Total pot €16 | Rake €0.80 
Board [Ks Jh 6h]
Seat 1: aquarua7 folded before Flop (didn't bet)
Seat 2: cap. marb folded before Flop (didn't bet)
Seat 3: ApkawaDavit (button) folded before Flop (didn't bet)
Seat 4: fireball2112 (small blind) collected (€15.20)
Seat 5: Spid1 (big blind) folded on the Flop
Seat 7: Ouga Buga folded before Flop (didn't bet)
Seat 8: matiko09 folded before Flop (didn't bet)





PokerStars Hand #152661046549:  Hold'em No Limit ($0.50/$1.00 USD) - 2016/04/30 18:07:26 CET [2016/04/30 12:07:26 ET]
Table 'Malautra II' 9-max Seat #4 is the button
Seat 1: Fivez ($132.19 in chips) 
Seat 2: koksskrt ($100 in chips) 
Seat 3: t.sneijder ($99.63 in chips) 
Seat 4: Khaine_CM ($103.48 in chips) 
Seat 6: matiko09 ($104.52 in chips) 
Seat 7: poker-rat95 ($37.28 in chips) 
Seat 8: maxxmeister ($173.88 in chips) 
Seat 9: kblkxls ($127.03 in chips) 
matiko09: posts small blind $0.50
poker-rat95: posts big blind $1
*** HOLE CARDS ***
Dealt to matiko09 [8h 7h]
maxxmeister: folds 
kblkxls: raises $2 to $3
Fivez: folds 
koksskrt: calls $3
t.sneijder: calls $3
Khaine_CM: calls $3
matiko09: calls $2.50
poker-rat95: calls $2
*** FLOP *** [Jh As 2d]
matiko09: checks 
poker-rat95: checks 
kblkxls: bets $5
koksskrt: calls $5
t.sneijder: folds 
Khaine_CM: calls $5
matiko09: folds 
poker-rat95: calls $5
*** TURN *** [Jh As 2d] [7d]
poker-rat95: checks 
kblkxls: bets $25
koksskrt: folds 
Khaine_CM: folds 
poker-rat95: folds 
Uncalled bet ($25) returned to kblkxls
kblkxls collected $36.10 from pot
kblkxls: doesn't show hand 
*** SUMMARY ***
Total pot $38 | Rake $1.90 
Board [Jh As 2d 7d]
Seat 1: Fivez folded before Flop (didn't bet)
Seat 2: koksskrt folded on the Turn
Seat 3: t.sneijder folded on the Flop
Seat 4: Khaine_CM (button) folded on the Turn
Seat 6: matiko09 (small blind) folded on the Flop
Seat 7: poker-rat95 (big blind) folded on the Turn
Seat 8: maxxmeister folded before Flop (didn't bet)
Seat 9: kblkxls collected ($36.10)





PokerStars Hand #152661065641:  Hold'em No Limit ($0.50/$1.00 USD) - 2016/04/30 18:07:51 CET [2016/04/30 12:07:51 ET]
Table 'Arcturus' 9-max Seat #5 is the button
Seat 1: matiko09 ($100 in chips) 
Seat 2: Khaine_CM ($122.35 in chips) 
Seat 3: Spid1 ($110.18 in chips) 
Seat 4: cap. marb ($37 in chips) 
Seat 5: koksskrt ($104 in chips) 
Seat 6: JimineyCrik ($177.34 in chips) 
Seat 7: terrytsui111 ($118.36 in chips) 
Seat 8: ApkawaDavit ($100 in chips) 
JimineyCrik: posts small blind $0.50
terrytsui111: posts big blind $1
*** HOLE CARDS ***
Dealt to matiko09 [4c Ac]
ApkawaDavit: folds 
matiko09: raises $2 to $3
Khaine_CM: calls $3
Spid1: folds 
cap. marb: folds 
koksskrt: folds 
JimineyCrik: folds 
terrytsui111: folds 
*** FLOP *** [Ks Js As]
matiko09: checks 
Khaine_CM: bets $5
matiko09: calls $5
*** TURN *** [Ks Js As] [9h]
matiko09: checks 
Khaine_CM: bets $12
matiko09: folds 
Uncalled bet ($12) returned to Khaine_CM
Khaine_CM collected $16.62 from pot
Khaine_CM: doesn't show hand 
*** SUMMARY ***
Total pot $17.50 | Rake $0.88 
Board [Ks Js As 9h]
Seat 1: matiko09 folded on the Turn
Seat 2: Khaine_CM collected ($16.62)
Seat 3: Spid1 folded before Flop (didn't bet)
Seat 4: cap. marb folded before Flop (didn't bet)
Seat 5: koksskrt (button) folded before Flop (didn't bet)
Seat 6: JimineyCrik (small blind) folded before Flop
Seat 7: terrytsui111 (big blind) folded before Flop
Seat 8: ApkawaDavit folded before Flop (didn't bet)





PokerStars Hand #152661079774:  Hold'em No Limit ($0.50/$1.00 USD) - 2016/04/30 18:08:09 CET [2016/04/30 12:08:09 ET]
Table 'Lova II' 9-max Seat #6 is the button
Seat 1: koksskrt ($106.50 in chips) 
Seat 2: bilukm ($282.20 in chips) 
Seat 3: matiko09 ($100 in chips) 
Seat 4: VanDobeln ($138.16 in chips) 
Seat 5: Ilov3NBA ($100 in chips) 
Seat 6: di0d80 ($115.67 in chips) 
Seat 7: meysam270 ($39.43 in chips) 
Seat 8: cap. marb ($46.78 in chips) 
meysam270: posts small blind $0.50
cap. marb: posts big blind $1
hurtNCYDE: sits out 
*** HOLE CARDS ***
Dealt to matiko09 [6c Jd]
koksskrt: folds 
bilukm: folds 
matiko09: folds 
VanDobeln: folds 
Ilov3NBA: folds 
di0d80: folds 
meysam270: calls $0.50
cap. marb: checks 
*** FLOP *** [Tc Td 3c]
meysam270: checks 
cap. marb: bets $1
meysam270: folds 
Uncalled bet ($1) returned to cap. marb
cap. marb collected $1.90 from pot
cap. marb: doesn't show hand 
*** SUMMARY ***
Total pot $2 | Rake $0.10 
Board [Tc Td 3c]
Seat 1: koksskrt folded before Flop (didn't bet)
Seat 2: bilukm folded before Flop (didn't bet)
Seat 3: matiko09 folded before Flop (didn't bet)
Seat 4: VanDobeln folded before Flop (didn't bet)
Seat 5: Ilov3NBA folded before Flop (didn't bet)
Seat 6: di0d80 (button) folded before Flop (didn't bet)
Seat 7: meysam270 (small blind) folded on the Flop
Seat 8: cap. marb (big blind) collected ($1.90)





PokerStars Hand #152661082150:  Hold'em No Limit (€0.50/€1.00 EUR) - 2016/04/30 18:08:12 CET [2016/04/30 12:08:12 ET]
Table 'Benda' 9-max Seat #4 is the button
Seat 1: aquarua7 (€223.91 in chips) 
Seat 2: cap. marb (€37 in chips) 
Seat 3: ApkawaDavit (€100 in chips) 
Seat 4: fireball2112 (€94.40 in chips) 
Seat 5: Spid1 (€100 in chips) 
Seat 7: Ouga Buga (€100 in chips) 
Seat 8: matiko09 (€100.13 in chips) 
Spid1: posts small blind €0.50
Ouga Buga: posts big blind €1
*** HOLE CARDS ***
Dealt to matiko09 [7d 5c]
matiko09: folds 
aquarua7: folds 
cap. marb: folds 
ApkawaDavit: folds 
fireball2112: folds 
Spid1: raises €1.50 to €2.50
Ouga Buga: calls €1.50
*** FLOP *** [5d Jc Js]
Spid1: checks 
Ouga Buga: checks 
*** TURN *** [5d Jc Js] [7s]
Spid1: checks 
Ouga Buga: checks 
*** RIVER *** [5d Jc Js 7s] [Ts]
Spid1: checks 
Ouga Buga: checks 
*** SHOW DOWN ***
Spid1: shows [Kh Td] (two pair, Jacks and Tens)
Ouga Buga: mucks hand 
Spid1 collected €4.75 from pot
*** SUMMARY ***
Total pot €5 | Rake €0.25 
Board [5d Jc Js 7s Ts]
Seat 1: aquarua7 folded before Flop (didn't bet)
Seat 2: cap. marb folded before Flop (didn't bet)
Seat 3: ApkawaDavit folded before Flop (didn't bet)
Seat 4: fireball2112 (button) folded before Flop (didn't bet)
Seat 5: Spid1 (small blind) showed [Kh Td] and won (€4.75) with two pair, Jacks and Tens
Seat 7: Ouga Buga (big blind) mucked [8s Ac]
Seat 8: matiko09 folded before Flop (didn't bet)





PokerStars Hand #152661098985:  Hold'em No Limit ($0.50/$1.00 USD) - 2016/04/30 18:08:34 CET [2016/04/30 12:08:34 ET]
Table 'Arcturus' 9-max Seat #6 is the button
Seat 1: matiko09 ($100 in chips) 
Seat 2: Khaine_CM ($130.97 in chips) 
Seat 3: Spid1 ($110.18 in chips) 
Seat 4: cap. marb ($37 in chips) 
Seat 5: koksskrt ($104 in chips) 
Seat 6: JimineyCrik ($176.84 in chips) 
Seat 7: terrytsui111 ($117.36 in chips) 
Seat 8: ApkawaDavit ($100 in chips) 
terrytsui111: posts small blind $0.50
ApkawaDavit: posts big blind $1
fishkida: sits out 
*** HOLE CARDS ***
Dealt to matiko09 [Kc Tc]
matiko09: raises $2 to $3
Khaine_CM: folds 
Spid1: folds 
cap. marb: folds 
koksskrt: folds 
JimineyCrik: raises $6 to $9
terrytsui111: folds 
ApkawaDavit: folds 
matiko09: folds 
Uncalled bet ($6) returned to JimineyCrik
JimineyCrik collected $7.50 from pot
JimineyCrik: doesn't show hand 
*** SUMMARY ***
Total pot $7.50 | Rake $0 
Seat 1: matiko09 folded before Flop
Seat 2: Khaine_CM folded before Flop (didn't bet)
Seat 3: Spid1 folded before Flop (didn't bet)
Seat 4: cap. marb folded before Flop (didn't bet)
Seat 5: koksskrt folded before Flop (didn't bet)
Seat 6: JimineyCrik (button) collected ($7.50)
Seat 7: terrytsui111 (small blind) folded before Flop
Seat 8: ApkawaDavit (big blind) folded before Flop





PokerStars Hand #152661114775:  Hold'em No Limit ($0.50/$1.00 USD) - 2016/04/30 18:08:55 CET [2016/04/30 12:08:55 ET]
Table 'Lova II' 9-max Seat #7 is the button
Seat 1: koksskrt ($106.50 in chips) 
Seat 2: bilukm ($282.20 in chips) 
Seat 3: matiko09 ($100 in chips) 
Seat 4: VanDobeln ($138.16 in chips) 
Seat 5: Ilov3NBA ($100 in chips) 
Seat 6: di0d80 ($115.67 in chips) 
Seat 7: meysam270 ($38.43 in chips) 
Seat 8: cap. marb ($47.68 in chips) 
Seat 9: hurtNCYDE ($100 in chips) 
cap. marb: posts small blind $0.50
hurtNCYDE: posts big blind $1
*** HOLE CARDS ***
Dealt to matiko09 [4h 8h]
koksskrt: folds 
bilukm: calls $1
matiko09: folds 
VanDobeln: folds 
Ilov3NBA: folds 
di0d80: folds 
meysam270: folds 
cap. marb: calls $0.50
hurtNCYDE: checks 
*** FLOP *** [3d Th 8c]
cap. marb: checks 
hurtNCYDE: checks 
bilukm: checks 
*** TURN *** [3d Th 8c] [5h]
cap. marb: checks 
hurtNCYDE: checks 
bilukm: checks 
*** RIVER *** [3d Th 8c 5h] [Js]
cap. marb: checks 
hurtNCYDE: checks 
bilukm: checks 
*** SHOW DOWN ***
cap. marb: shows [7s As] (high card Ace)
hurtNCYDE: mucks hand 
bilukm: mucks hand 
cap. marb collected $2.85 from pot
*** SUMMARY ***
Total pot $3 | Rake $0.15 
Board [3d Th 8c 5h Js]
Seat 1: koksskrt folded before Flop (didn't bet)
Seat 2: bilukm mucked [2s Ac]
Seat 3: matiko09 folded before Flop (didn't bet)
Seat 4: VanDobeln folded before Flop (didn't bet)
Seat 5: Ilov3NBA folded before Flop (didn't bet)
Seat 6: di0d80 folded before Flop (didn't bet)
Seat 7: meysam270 (button) folded before Flop (didn't bet)
Seat 8: cap. marb (small blind) showed [7s As] and won ($2.85) with high card Ace
Seat 9: hurtNCYDE (big blind) mucked [4s Qc]





PokerStars Hand #152661123088:  Hold'em No Limit ($0.50/$1.00 USD) - 2016/04/30 18:09:06 CET [2016/04/30 12:09:06 ET]
Table 'Malautra II' 9-max Seat #6 is the button
Seat 1: Fivez ($132.19 in chips) 
Seat 2: koksskrt ($100 in chips) 
Seat 3: t.sneijder ($96.63 in chips) 
Seat 4: Khaine_CM ($100 in chips) 
Seat 6: matiko09 ($101.52 in chips) 
Seat 7: poker-rat95 ($29.28 in chips) 
Seat 8: maxxmeister ($173.88 in chips) 
Seat 9: kblkxls ($155.13 in chips) 
poker-rat95: posts small blind $0.50
maxxmeister: posts big blind $1
*** HOLE CARDS ***
Dealt to matiko09 [3c As]
kblkxls: folds 
Fivez: folds 
koksskrt: folds 
t.sneijder: calls $1
Khaine_CM: folds 
kblkxls leaves the table
matiko09: raises $3 to $4
Bailey Dew joins the table at seat #9 
poker-rat95: folds 
maxxmeister: folds 
t.sneijder: calls $3
*** FLOP *** [Tc 7h 6d]
t.sneijder: bets $4
matiko09: folds 
Uncalled bet ($4) returned to t.sneijder
t.sneijder collected $9.02 from pot
t.sneijder: doesn't show hand 
*** SUMMARY ***
Total pot $9.50 | Rake $0.48 
Board [Tc 7h 6d]
Seat 1: Fivez folded before Flop (didn't bet)
Seat 2: koksskrt folded before Flop (didn't bet)
Seat 3: t.sneijder collected ($9.02)
Seat 4: Khaine_CM folded before Flop (didn't bet)
Seat 6: matiko09 (button) folded on the Flop
Seat 7: poker-rat95 (small blind) folded before Flop
Seat 8: maxxmeister (big blind) folded before Flop
Seat 9: kblkxls folded before Flop (didn't bet)





PokerStars Hand #152661125411:  Hold'em No Limit ($0.50/$1.00 USD) - 2016/04/30 18:09:09 CET [2016/04/30 12:09:09 ET]
Table 'Raissa II' 9-max Seat #2 is the button
Seat 1: cap. marb ($39.38 in chips) 
Seat 2: azzad2007 ($100 in chips) 
Seat 3: Kelvin sai ($22.07 in chips) 
Seat 4: koksskrt ($101.50 in chips) 
Seat 5: Jess7jay ($112.36 in chips) 
Seat 6: ilaviiitech ($106.65 in chips) 
Seat 7: matiko09 ($100 in chips) 
Seat 8: Khaine_CM ($101.50 in chips) 
Seat 9: ApkawaDavit ($134.63 in chips) 
Kelvin sai: posts small blind $0.50
koksskrt: posts big blind $1
*** HOLE CARDS ***
Dealt to matiko09 [6c Jh]
Jess7jay: folds 
ilaviiitech: folds 
matiko09: folds 
Khaine_CM: folds 
ApkawaDavit: folds 
cap. marb: folds 
azzad2007: folds 
Kelvin sai: folds 
Uncalled bet ($0.50) returned to koksskrt
koksskrt collected $1 from pot
koksskrt: doesn't show hand 
*** SUMMARY ***
Total pot $1 | Rake $0 
Seat 1: cap. marb folded before Flop (didn't bet)
Seat 2: azzad2007 (button) folded before Flop (didn't bet)
Seat 3: Kelvin sai (small blind) folded before Flop
Seat 4: koksskrt (big blind) collected ($1)
Seat 5: Jess7jay folded before Flop (didn't bet)
Seat 6: ilaviiitech folded before Flop (didn't bet)
Seat 7: matiko09 folded before Flop (didn't bet)
Seat 8: Khaine_CM folded before Flop (didn't bet)
Seat 9: ApkawaDavit folded before Flop (didn't bet)





PokerStars Hand #152661130702:  Hold'em No Limit ($0.50/$1.00 USD) - 2016/04/30 18:09:16 CET [2016/04/30 12:09:16 ET]
Table 'Arcturus' 9-max Seat #7 is the button
Seat 1: matiko09 ($100 in chips) 
Seat 2: Khaine_CM ($130.97 in chips) 
Seat 3: Spid1 ($110.18 in chips) 
Seat 4: cap. marb ($37 in chips) 
Seat 5: koksskrt ($104 in chips) 
Seat 6: JimineyCrik ($181.34 in chips) 
Seat 7: terrytsui111 ($116.86 in chips) 
Seat 8: ApkawaDavit ($100 in chips) 
Seat 9: fishkida ($119.45 in chips) 
ApkawaDavit: posts small blind $0.50
fishkida: posts big blind $1
*** HOLE CARDS ***
Dealt to matiko09 [4c Th]
matiko09: folds 
Khaine_CM: folds 
Spid1: folds 
cap. marb: folds 
koksskrt: folds 
JimineyCrik: folds 
terrytsui111: raises $2 to $3
ApkawaDavit: raises $6 to $9
fishkida: folds 
terrytsui111: calls $6
*** FLOP *** [Kh Qh Jd]
ApkawaDavit: bets $13
terrytsui111: folds 
Uncalled bet ($13) returned to ApkawaDavit
ApkawaDavit collected $18.05 from pot
ApkawaDavit: doesn't show hand 
*** SUMMARY ***
Total pot $19 | Rake $0.95 
Board [Kh Qh Jd]
Seat 1: matiko09 folded before Flop (didn't bet)
Seat 2: Khaine_CM folded before Flop (didn't bet)
Seat 3: Spid1 folded before Flop (didn't bet)
Seat 4: cap. marb folded before Flop (didn't bet)
Seat 5: koksskrt folded before Flop (didn't bet)
Seat 6: JimineyCrik folded before Flop (didn't bet)
Seat 7: terrytsui111 (button) folded on the Flop
Seat 8: ApkawaDavit (small blind) collected ($18.05)
Seat 9: fishkida (big blind) folded before Flop





PokerStars Hand #152661142282:  Hold'em No Limit (€0.50/€1.00 EUR) - 2016/04/30 18:09:31 CET [2016/04/30 12:09:31 ET]
Table 'Benda' 9-max Seat #5 is the button
Seat 1: aquarua7 (€223.91 in chips) 
Seat 2: cap. marb (€37 in chips) 
Seat 3: ApkawaDavit (€100 in chips) 
Seat 4: fireball2112 (€94.40 in chips) 
Seat 5: Spid1 (€102.25 in chips) 
Seat 7: Ouga Buga (€100 in chips) 
Seat 8: matiko09 (€100.13 in chips) 
Ouga Buga: posts small blind €0.50
matiko09: posts big blind €1
Racushniak: sits out 
*** HOLE CARDS ***
Dealt to matiko09 [Qh 6c]
aquarua7: folds 
cap. marb: folds 
ApkawaDavit: folds 
fireball2112: folds 
Spid1: folds 
Ouga Buga: raises €2 to €3
matiko09: folds 
Uncalled bet (€2) returned to Ouga Buga
Ouga Buga collected €2 from pot
Ouga Buga: doesn't show hand 
*** SUMMARY ***
Total pot €2 | Rake €0 
Seat 1: aquarua7 folded before Flop (didn't bet)
Seat 2: cap. marb folded before Flop (didn't bet)
Seat 3: ApkawaDavit folded before Flop (didn't bet)
Seat 4: fireball2112 folded before Flop (didn't bet)
Seat 5: Spid1 (button) folded before Flop (didn't bet)
Seat 7: Ouga Buga (small blind) collected (€2)
Seat 8: matiko09 (big blind) folded before Flop





PokerStars Hand #152661160708:  Hold'em No Limit ($0.50/$1.00 USD) - 2016/04/30 18:09:55 CET [2016/04/30 12:09:55 ET]
Table 'Malautra II' 9-max Seat #7 is the button
Seat 1: Fivez ($132.19 in chips) 
Seat 2: koksskrt ($100 in chips) 
Seat 3: t.sneijder ($101.65 in chips) 
Seat 4: Khaine_CM ($100 in chips) 
Seat 6: matiko09 ($100 in chips) 
Seat 7: poker-rat95 ($28.78 in chips) 
Seat 8: maxxmeister ($172.88 in chips) 
maxxmeister: posts small blind $0.50
Fivez: posts big blind $1
*** HOLE CARDS ***
Dealt to matiko09 [Kc Kd]
koksskrt: folds 
t.sneijder: folds 
Bailey Dew leaves the table
Khaine_CM: raises $2 to $3
koksskrt leaves the table
hurtNCYDE joins the table at seat #2 
matiko09: raises $7 to $10
poker-rat95: folds 
hurtNCYDE leaves the table
cap. marb joins the table at seat #9 
Ilov3NBA joins the table at seat #2 
maxxmeister: folds 
Fivez: folds 
Khaine_CM: folds 
Uncalled bet ($7) returned to matiko09
matiko09 collected $7.50 from pot
matiko09: doesn't show hand 
*** SUMMARY ***
Total pot $7.50 | Rake $0 
Seat 1: Fivez (big blind) folded before Flop
Seat 2: koksskrt folded before Flop (didn't bet)
Seat 3: t.sneijder folded before Flop (didn't bet)
Seat 4: Khaine_CM folded before Flop
Seat 6: matiko09 collected ($7.50)
Seat 7: poker-rat95 (button) folded before Flop (didn't bet)
Seat 8: maxxmeister (small blind) folded before Flop





PokerStars Hand #152661161918:  Hold'em No Limit ($0.50/$1.00 USD) - 2016/04/30 18:09:56 CET [2016/04/30 12:09:56 ET]
Table 'Raissa II' 9-max Seat #3 is the button
Seat 1: cap. marb ($39.38 in chips) 
Seat 2: azzad2007 ($100 in chips) 
Seat 3: Kelvin sai ($21.57 in chips) 
Seat 4: koksskrt ($102 in chips) 
Seat 5: Jess7jay ($112.36 in chips) 
Seat 6: ilaviiitech ($106.65 in chips) 
Seat 7: matiko09 ($100 in chips) 
Seat 8: Khaine_CM ($101.50 in chips) 
Seat 9: ApkawaDavit ($134.63 in chips) 
koksskrt: posts small blind $0.50
Jess7jay: posts big blind $1
*** HOLE CARDS ***
Dealt to matiko09 [6h 9c]
ilaviiitech: folds 
matiko09: folds 
Khaine_CM: raises $2 to $3
ApkawaDavit: calls $3
cap. marb: raises $5 to $8
azzad2007: folds 
Kelvin sai: folds 
koksskrt: folds 
Jess7jay: folds 
Khaine_CM: folds 
ApkawaDavit: folds 
Uncalled bet ($5) returned to cap. marb
cap. marb collected $10.50 from pot
cap. marb: doesn't show hand 
*** SUMMARY ***
Total pot $10.50 | Rake $0 
Seat 1: cap. marb collected ($10.50)
Seat 2: azzad2007 folded before Flop (didn't bet)
Seat 3: Kelvin sai (button) folded before Flop (didn't bet)
Seat 4: koksskrt (small blind) folded before Flop
Seat 5: Jess7jay (big blind) folded before Flop
Seat 6: ilaviiitech folded before Flop (didn't bet)
Seat 7: matiko09 folded before Flop (didn't bet)
Seat 8: Khaine_CM folded before Flop
Seat 9: ApkawaDavit folded before Flop





PokerStars Hand #152661162906:  Hold'em No Limit (€0.50/€1.00 EUR) - 2016/04/30 18:09:58 CET [2016/04/30 12:09:58 ET]
Table 'Benda' 9-max Seat #7 is the button
Seat 1: aquarua7 (€223.91 in chips) 
Seat 2: cap. marb (€37 in chips) 
Seat 3: ApkawaDavit (€100 in chips) 
Seat 4: fireball2112 (€94.40 in chips) 
Seat 5: Spid1 (€102.25 in chips) 
Seat 7: Ouga Buga (€101 in chips) 
Seat 8: matiko09 (€100 in chips) 
Seat 9: Racushniak (€117.73 in chips) 
matiko09: posts small blind €0.50
Racushniak: posts big blind €1
*** HOLE CARDS ***
Dealt to matiko09 [2c Kc]
aquarua7: folds 
cap. marb: folds 
ApkawaDavit: folds 
fireball2112: folds 
Spid1: folds 
Ouga Buga: folds 
matiko09: raises €1.50 to €2.50
Racushniak: calls €1.50
*** FLOP *** [8c 4c Th]
matiko09: bets €3.09
Racushniak: calls €3.09
*** TURN *** [8c 4c Th] [Qh]
matiko09: bets €7
Racushniak: calls €7
*** RIVER *** [8c 4c Th Qh] [8h]
matiko09: bets €17
Racushniak: calls €17
*** SHOW DOWN ***
matiko09: shows [2c Kc] (a pair of Eights)
Racushniak: shows [As Td] (two pair, Tens and Eights)
Racushniak collected €56.93 from pot
*** SUMMARY ***
Total pot €59.18 | Rake €2.25 
Board [8c 4c Th Qh 8h]
Seat 1: aquarua7 folded before Flop (didn't bet)
Seat 2: cap. marb folded before Flop (didn't bet)
Seat 3: ApkawaDavit folded before Flop (didn't bet)
Seat 4: fireball2112 folded before Flop (didn't bet)
Seat 5: Spid1 folded before Flop (didn't bet)
Seat 7: Ouga Buga (button) folded before Flop (didn't bet)
Seat 8: matiko09 (small blind) showed [2c Kc] and lost with a pair of Eights
Seat 9: Racushniak (big blind) showed [As Td] and won (€56.93) with two pair, Tens and Eights





PokerStars Hand #152661165372:  Hold'em No Limit ($0.50/$1.00 USD) - 2016/04/30 18:10:01 CET [2016/04/30 12:10:01 ET]
Table 'Lova II' 9-max Seat #8 is the button
Seat 1: koksskrt ($106.50 in chips) 
Seat 2: bilukm ($281.20 in chips) 
Seat 3: matiko09 ($100 in chips) 
Seat 4: VanDobeln ($138.16 in chips) 
Seat 5: Ilov3NBA ($100 in chips) 
Seat 6: di0d80 ($115.67 in chips) 
Seat 7: meysam270 ($38.43 in chips) 
Seat 8: cap. marb ($49.53 in chips) 
Seat 9: hurtNCYDE ($100 in chips) 
hurtNCYDE: posts small blind $0.50
koksskrt: posts big blind $1
*** HOLE CARDS ***
Dealt to matiko09 [7d Jh]
bilukm: calls $1
matiko09: folds 
VanDobeln: folds 
Ilov3NBA: folds 
di0d80: folds 
meysam270: folds 
cap. marb: raises $3.50 to $4.50
hurtNCYDE: folds 
koksskrt: folds 
bilukm: calls $3.50
*** FLOP *** [5c Kh Jd]
bilukm: bets $1
cap. marb: raises $7 to $8
bilukm: folds 
Uncalled bet ($7) returned to cap. marb
cap. marb collected $11.88 from pot
cap. marb: doesn't show hand 
*** SUMMARY ***
Total pot $12.50 | Rake $0.62 
Board [5c Kh Jd]
Seat 1: koksskrt (big blind) folded before Flop
Seat 2: bilukm folded on the Flop
Seat 3: matiko09 folded before Flop (didn't bet)
Seat 4: VanDobeln folded before Flop (didn't bet)
Seat 5: Ilov3NBA folded before Flop (didn't bet)
Seat 6: di0d80 folded before Flop (didn't bet)
Seat 7: meysam270 folded before Flop (didn't bet)
Seat 8: cap. marb (button) collected ($11.88)
Seat 9: hurtNCYDE (small blind) folded before Flop





PokerStars Hand #152661175062:  Hold'em No Limit ($0.50/$1.00 USD) - 2016/04/30 18:10:14 CET [2016/04/30 12:10:14 ET]
Table 'Arcturus' 9-max Seat #8 is the button
Seat 1: matiko09 ($100 in chips) 
Seat 2: Khaine_CM ($130.97 in chips) 
Seat 3: Spid1 ($110.18 in chips) 
Seat 4: cap. marb ($37 in chips) 
Seat 5: koksskrt ($104 in chips) 
Seat 6: JimineyCrik ($181.34 in chips) 
Seat 7: terrytsui111 ($107.86 in chips) 
Seat 8: ApkawaDavit ($109.05 in chips) 
Seat 9: fishkida ($118.45 in chips) 
fishkida: posts small blind $0.50
matiko09: posts big blind $1
*** HOLE CARDS ***
Dealt to matiko09 [8d 5c]
Khaine_CM: folds 
Spid1: folds 
cap. marb: raises $1.12 to $2.12
koksskrt: folds 
JimineyCrik: folds 
terrytsui111: calls $2.12
ApkawaDavit: folds 
fishkida: calls $1.62
matiko09: folds 
*** FLOP *** [Tc 4c 5s]
fishkida: checks 
cap. marb: checks 
terrytsui111: bets $4
fishkida: folds 
cap. marb: folds 
Uncalled bet ($4) returned to terrytsui111
terrytsui111 collected $6.99 from pot
terrytsui111: doesn't show hand 
*** SUMMARY ***
Total pot $7.36 | Rake $0.37 
Board [Tc 4c 5s]
Seat 1: matiko09 (big blind) folded before Flop
Seat 2: Khaine_CM folded before Flop (didn't bet)
Seat 3: Spid1 folded before Flop (didn't bet)
Seat 4: cap. marb folded on the Flop
Seat 5: koksskrt folded before Flop (didn't bet)
Seat 6: JimineyCrik folded before Flop (didn't bet)
Seat 7: terrytsui111 collected ($6.99)
Seat 8: ApkawaDavit (button) folded before Flop (didn't bet)
Seat 9: fishkida (small blind) folded on the Flop





PokerStars Hand #152661192097:  Hold'em No Limit ($0.50/$1.00 USD) - 2016/04/30 18:10:36 CET [2016/04/30 12:10:36 ET]
Table 'Malautra II' 9-max Seat #8 is the button
Seat 1: Fivez ($131.19 in chips) 
Seat 2: Ilov3NBA ($100 in chips) 
Seat 3: t.sneijder ($101.65 in chips) 
Seat 4: Khaine_CM ($100 in chips) 
Seat 6: matiko09 ($104.50 in chips) 
Seat 7: poker-rat95 ($28.78 in chips) 
Seat 8: maxxmeister ($172.38 in chips) 
cap. marb will be allowed to play after the button
Fivez: posts small blind $0.50
Ilov3NBA: posts big blind $1
*** HOLE CARDS ***
Dealt to matiko09 [8d 7h]
t.sneijder: folds 
Khaine_CM: folds 
matiko09: folds 
poker-rat95: folds 
maxxmeister: folds 
Fivez: raises $2 to $3
Ilov3NBA: calls $2
*** FLOP *** [3c 2d 9c]
Fivez: bets $4
Ilov3NBA: calls $4
*** TURN *** [3c 2d 9c] [9s]
Fivez: checks 
Ilov3NBA: checks 
*** RIVER *** [3c 2d 9c 9s] [8h]
darren1031 was removed from the table for failing to post
Fivez: checks 
hurtNCYDE joins the table at seat #5 
Ilov3NBA: checks 
*** SHOW DOWN ***
Fivez: shows [As 5s] (a pair of Nines)
Ilov3NBA: shows [3h Ad] (two pair, Nines and Threes)
Ilov3NBA collected $13.30 from pot
*** SUMMARY ***
Total pot $14 | Rake $0.70 
Board [3c 2d 9c 9s 8h]
Seat 1: Fivez (small blind) showed [As 5s] and lost with a pair of Nines
Seat 2: Ilov3NBA (big blind) showed [3h Ad] and won ($13.30) with two pair, Nines and Threes
Seat 3: t.sneijder folded before Flop (didn't bet)
Seat 4: Khaine_CM folded before Flop (didn't bet)
Seat 6: matiko09 folded before Flop (didn't bet)
Seat 7: poker-rat95 folded before Flop (didn't bet)
Seat 8: maxxmeister (button) folded before Flop (didn't bet)





PokerStars Hand #152661195194:  Hold'em No Limit ($0.50/$1.00 USD) - 2016/04/30 18:10:40 CET [2016/04/30 12:10:40 ET]
Table 'Raissa II' 9-max Seat #4 is the button
Seat 1: cap. marb ($46.88 in chips) 
Seat 2: azzad2007 ($100 in chips) 
Seat 3: Kelvin sai ($21.57 in chips) 
Seat 4: koksskrt ($101.50 in chips) 
Seat 5: Jess7jay ($111.36 in chips) 
Seat 6: ilaviiitech ($106.65 in chips) 
Seat 7: matiko09 ($100 in chips) 
Seat 8: Khaine_CM ($100 in chips) 
Seat 9: ApkawaDavit ($131.63 in chips) 
Jess7jay: posts small blind $0.50
ilaviiitech: posts big blind $1
*** HOLE CARDS ***
Dealt to matiko09 [5s 8c]
matiko09: folds 
Khaine_CM: folds 
ApkawaDavit: folds 
cap. marb: folds 
azzad2007: folds 
Kelvin sai: raises $2 to $3
koksskrt: folds 
Jess7jay: calls $2.50
ilaviiitech: folds 
*** FLOP *** [6c 4d 3s]
Jess7jay: checks 
Kelvin sai: checks 
*** TURN *** [6c 4d 3s] [2s]
Jess7jay: checks 
Kelvin sai: bets $3
Jess7jay: folds 
Uncalled bet ($3) returned to Kelvin sai
Kelvin sai collected $6.65 from pot
*** SUMMARY ***
Total pot $7 | Rake $0.35 
Board [6c 4d 3s 2s]
Seat 1: cap. marb folded before Flop (didn't bet)
Seat 2: azzad2007 folded before Flop (didn't bet)
Seat 3: Kelvin sai collected ($6.65)
Seat 4: koksskrt (button) folded before Flop (didn't bet)
Seat 5: Jess7jay (small blind) folded on the Turn
Seat 6: ilaviiitech (big blind) folded before Flop
Seat 7: matiko09 folded before Flop (didn't bet)
Seat 8: Khaine_CM folded before Flop (didn't bet)
Seat 9: ApkawaDavit folded before Flop (didn't bet)





PokerStars Hand #152661204137:  Hold'em No Limit ($0.50/$1.00 USD) - 2016/04/30 18:10:52 CET [2016/04/30 12:10:52 ET]
Table 'Arcturus' 9-max Seat #9 is the button
Seat 1: matiko09 ($100 in chips) 
Seat 2: Khaine_CM ($130.97 in chips) 
Seat 3: Spid1 ($110.18 in chips) 
Seat 4: cap. marb ($40 in chips) 
Seat 5: koksskrt ($104 in chips) 
Seat 6: JimineyCrik ($181.34 in chips) 
Seat 7: terrytsui111 ($112.73 in chips) 
Seat 8: ApkawaDavit ($109.05 in chips) 
Seat 9: fishkida ($116.33 in chips) 
matiko09: posts small blind $0.50
Khaine_CM: posts big blind $1
*** HOLE CARDS ***
Dealt to matiko09 [6c 9h]
Spid1: folds 
cap. marb: raises $1.12 to $2.12
koksskrt: folds 
JimineyCrik: folds 
terrytsui111: calls $2.12
ApkawaDavit: folds 
fishkida: folds 
matiko09: folds 
Khaine_CM: folds 
*** FLOP *** [8c Ac 9s]
cap. marb: bets $3.59
terrytsui111: raises $11.59 to $15.18
cap. marb: folds 
Uncalled bet ($11.59) returned to terrytsui111
terrytsui111 collected $12.27 from pot
terrytsui111: doesn't show hand 
*** SUMMARY ***
Total pot $12.92 | Rake $0.65 
Board [8c Ac 9s]
Seat 1: matiko09 (small blind) folded before Flop
Seat 2: Khaine_CM (big blind) folded before Flop
Seat 3: Spid1 folded before Flop (didn't bet)
Seat 4: cap. marb folded on the Flop
Seat 5: koksskrt folded before Flop (didn't bet)
Seat 6: JimineyCrik folded before Flop (didn't bet)
Seat 7: terrytsui111 collected ($12.27)
Seat 8: ApkawaDavit folded before Flop (didn't bet)
Seat 9: fishkida (button) folded before Flop (didn't bet)





PokerStars Hand #152661219309:  Hold'em No Limit (€0.50/€1.00 EUR) - 2016/04/30 18:11:11 CET [2016/04/30 12:11:11 ET]
Table 'Benda' 9-max Seat #8 is the button
Seat 1: aquarua7 (€223.91 in chips) 
Seat 2: cap. marb (€37 in chips) 
Seat 3: ApkawaDavit (€100 in chips) 
Seat 4: fireball2112 (€94.40 in chips) 
Seat 5: Spid1 (€102.25 in chips) 
Seat 7: Ouga Buga (€101 in chips) 
Seat 8: matiko09 (€100 in chips) 
Seat 9: Racushniak (€145.07 in chips) 
Racushniak: posts small blind €0.50
aquarua7: posts big blind €1
Nunzio1985ct: sits out 
*** HOLE CARDS ***
Dealt to matiko09 [5d 9d]
cap. marb: folds 
ApkawaDavit: raises €2 to €3
fireball2112: folds 
Spid1: folds 
Ouga Buga: folds 
matiko09: folds 
Racushniak: folds 
aquarua7: folds 
Uncalled bet (€2) returned to ApkawaDavit
ApkawaDavit collected €2.50 from pot
ApkawaDavit: doesn't show hand 
*** SUMMARY ***
Total pot €2.50 | Rake €0 
Seat 1: aquarua7 (big blind) folded before Flop
Seat 2: cap. marb folded before Flop (didn't bet)
Seat 3: ApkawaDavit collected (€2.50)
Seat 4: fireball2112 folded before Flop (didn't bet)
Seat 5: Spid1 folded before Flop (didn't bet)
Seat 7: Ouga Buga folded before Flop (didn't bet)
Seat 8: matiko09 (button) folded before Flop (didn't bet)
Seat 9: Racushniak (small blind) folded before Flop





PokerStars Hand #152661225715:  Hold'em No Limit ($0.50/$1.00 USD) - 2016/04/30 18:11:20 CET [2016/04/30 12:11:20 ET]
Table 'Lova II' 9-max Seat #9 is the button
Seat 1: koksskrt ($105.50 in chips) 
Seat 2: bilukm ($275.70 in chips) 
Seat 3: matiko09 ($100 in chips) 
Seat 4: VanDobeln ($138.16 in chips) 
Seat 5: Ilov3NBA ($100 in chips) 
Seat 6: di0d80 ($115.67 in chips) 
Seat 7: meysam270 ($38.43 in chips) 
Seat 8: cap. marb ($55.91 in chips) 
Seat 9: hurtNCYDE ($100 in chips) 
koksskrt: posts small blind $0.50
bilukm: posts big blind $1
*** HOLE CARDS ***
Dealt to matiko09 [Ks 5c]
matiko09: folds 
VanDobeln: folds 
Ilov3NBA: folds 
di0d80: folds 
meysam270: folds 
cap. marb: raises $1.12 to $2.12
hurtNCYDE: folds 
koksskrt: raises $4.88 to $7
bilukm: folds 
cap. marb: folds 
Uncalled bet ($4.88) returned to koksskrt
koksskrt collected $5.24 from pot
koksskrt: doesn't show hand 
*** SUMMARY ***
Total pot $5.24 | Rake $0 
Seat 1: koksskrt (small blind) collected ($5.24)
Seat 2: bilukm (big blind) folded before Flop
Seat 3: matiko09 folded before Flop (didn't bet)
Seat 4: VanDobeln folded before Flop (didn't bet)
Seat 5: Ilov3NBA folded before Flop (didn't bet)
Seat 6: di0d80 folded before Flop (didn't bet)
Seat 7: meysam270 folded before Flop (didn't bet)
Seat 8: cap. marb folded before Flop
Seat 9: hurtNCYDE (button) folded before Flop (didn't bet)





PokerStars Hand #152661233758:  Hold'em No Limit ($0.50/$1.00 USD) - 2016/04/30 18:11:30 CET [2016/04/30 12:11:30 ET]
Table 'Malautra II' 9-max Seat #1 is the button
Seat 1: Fivez ($124.19 in chips) 
Seat 2: Ilov3NBA ($106.30 in chips) 
Seat 3: t.sneijder ($101.65 in chips) 
Seat 4: Khaine_CM ($100 in chips) 
Seat 6: matiko09 ($104.50 in chips) 
Seat 7: poker-rat95 ($28.78 in chips) 
Seat 8: maxxmeister ($172.38 in chips) 
Ilov3NBA: posts small blind $0.50
t.sneijder: posts big blind $1
hurtNCYDE: sits out 
cap. marb: sits out 
*** HOLE CARDS ***
Dealt to matiko09 [5c 6d]
Khaine_CM: folds 
matiko09: folds 
poker-rat95: folds 
maxxmeister: raises $2 to $3
Fivez: folds 
Ilov3NBA: folds 
t.sneijder: calls $2
*** FLOP *** [Qd 8c 2s]
t.sneijder: bets $3
maxxmeister: folds 
Uncalled bet ($3) returned to t.sneijder
t.sneijder collected $6.18 from pot
t.sneijder: doesn't show hand 
*** SUMMARY ***
Total pot $6.50 | Rake $0.32 
Board [Qd 8c 2s]
Seat 1: Fivez (button) folded before Flop (didn't bet)
Seat 2: Ilov3NBA (small blind) folded before Flop
Seat 3: t.sneijder (big blind) collected ($6.18)
Seat 4: Khaine_CM folded before Flop (didn't bet)
Seat 6: matiko09 folded before Flop (didn't bet)
Seat 7: poker-rat95 folded before Flop (didn't bet)
Seat 8: maxxmeister folded on the Flop





PokerStars Hand #152661235229:  Hold'em No Limit ($0.50/$1.00 USD) - 2016/04/30 18:11:32 CET [2016/04/30 12:11:32 ET]
Table 'Arcturus' 9-max Seat #1 is the button
Seat 1: matiko09 ($100 in chips) 
Seat 2: Khaine_CM ($129.97 in chips) 
Seat 3: Spid1 ($110.18 in chips) 
Seat 4: cap. marb ($40 in chips) 
Seat 5: koksskrt ($104 in chips) 
Seat 6: JimineyCrik ($181.34 in chips) 
Seat 7: terrytsui111 ($119.29 in chips) 
Seat 8: ApkawaDavit ($109.05 in chips) 
Seat 9: fishkida ($116.33 in chips) 
Khaine_CM: posts small blind $0.50
Spid1: posts big blind $1
*** HOLE CARDS ***
Dealt to matiko09 [Ac 4d]
cap. marb: folds 
koksskrt: folds 
JimineyCrik: folds 
terrytsui111: folds 
ApkawaDavit: folds 
fishkida: folds 
matiko09: raises $1.27 to $2.27
Khaine_CM: folds 
Spid1: calls $1.27
*** FLOP *** [3h 5h Th]
Spid1: checks 
matiko09: checks 
*** TURN *** [3h 5h Th] [7d]
Spid1: bets $3.50
matiko09: folds 
Uncalled bet ($3.50) returned to Spid1
Spid1 collected $4.79 from pot
Spid1: doesn't show hand 
*** SUMMARY ***
Total pot $5.04 | Rake $0.25 
Board [3h 5h Th 7d]
Seat 1: matiko09 (button) folded on the Turn
Seat 2: Khaine_CM (small blind) folded before Flop
Seat 3: Spid1 (big blind) collected ($4.79)
Seat 4: cap. marb folded before Flop (didn't bet)
Seat 5: koksskrt folded before Flop (didn't bet)
Seat 6: JimineyCrik folded before Flop (didn't bet)
Seat 7: terrytsui111 folded before Flop (didn't bet)
Seat 8: ApkawaDavit folded before Flop (didn't bet)
Seat 9: fishkida folded before Flop (didn't bet)





PokerStars Hand #152661246777:  Hold'em No Limit ($0.50/$1.00 USD) - 2016/04/30 18:11:47 CET [2016/04/30 12:11:47 ET]
Table 'Raissa II' 9-max Seat #5 is the button
Seat 1: cap. marb ($46.88 in chips) 
Seat 2: azzad2007 ($100 in chips) 
Seat 3: Kelvin sai ($25.22 in chips) 
Seat 4: koksskrt ($101.50 in chips) 
Seat 5: Jess7jay ($108.36 in chips) 
Seat 6: ilaviiitech ($105.65 in chips) 
Seat 7: matiko09 ($100 in chips) 
Seat 8: Khaine_CM ($100 in chips) 
Seat 9: ApkawaDavit ($131.63 in chips) 
ilaviiitech: posts small blind $0.50
matiko09: posts big blind $1
*** HOLE CARDS ***
Dealt to matiko09 [9s Ah]
Khaine_CM: folds 
ApkawaDavit: folds 
cap. marb: folds 
azzad2007: folds 
Kelvin sai: folds 
koksskrt: folds 
Jess7jay: folds 
ilaviiitech: folds 
Uncalled bet ($0.50) returned to matiko09
matiko09 collected $1 from pot
matiko09: doesn't show hand 
*** SUMMARY ***
Total pot $1 | Rake $0 
Seat 1: cap. marb folded before Flop (didn't bet)
Seat 2: azzad2007 folded before Flop (didn't bet)
Seat 3: Kelvin sai folded before Flop (didn't bet)
Seat 4: koksskrt folded before Flop (didn't bet)
Seat 5: Jess7jay (button) folded before Flop (didn't bet)
Seat 6: ilaviiitech (small blind) folded before Flop
Seat 7: matiko09 (big blind) collected ($1)
Seat 8: Khaine_CM folded before Flop (didn't bet)
Seat 9: ApkawaDavit folded before Flop (didn't bet)





PokerStars Hand #152661246572:  Hold'em No Limit (€0.50/€1.00 EUR) - 2016/04/30 18:11:47 CET [2016/04/30 12:11:47 ET]
Table 'Benda' 9-max Seat #9 is the button
Seat 1: aquarua7 (€222.91 in chips) 
Seat 2: cap. marb (€37 in chips) 
Seat 3: ApkawaDavit (€101.50 in chips) 
Seat 4: fireball2112 (€94.40 in chips) 
Seat 5: Spid1 (€102.25 in chips) 
Seat 6: Nunzio1985ct (€36.11 in chips) 
Seat 7: Ouga Buga (€101 in chips) 
Seat 8: matiko09 (€100 in chips) 
Seat 9: Racushniak (€144.57 in chips) 
aquarua7: posts small blind €0.50
cap. marb: posts big blind €1
Nunzio1985ct: posts small & big blinds €1.50
*** HOLE CARDS ***
Dealt to matiko09 [6s Kh]
ApkawaDavit: folds 
fireball2112: raises €1 to €2
Spid1: raises €6 to €8
Nunzio1985ct: folds 
Ouga Buga: folds 
matiko09: folds 
Racushniak: folds 
aquarua7: folds 
cap. marb: folds 
fireball2112: folds 
Uncalled bet (€6) returned to Spid1
Spid1 collected €7 from pot
Spid1: doesn't show hand 
*** SUMMARY ***
Total pot €7 | Rake €0 
Seat 1: aquarua7 (small blind) folded before Flop
Seat 2: cap. marb (big blind) folded before Flop
Seat 3: ApkawaDavit folded before Flop (didn't bet)
Seat 4: fireball2112 folded before Flop
Seat 5: Spid1 collected (€7)
Seat 6: Nunzio1985ct folded before Flop
Seat 7: Ouga Buga folded before Flop (didn't bet)
Seat 8: matiko09 folded before Flop (didn't bet)
Seat 9: Racushniak (button) folded before Flop (didn't bet)





PokerStars Hand #152661249971:  Hold'em No Limit ($0.50/$1.00 USD) - 2016/04/30 18:11:52 CET [2016/04/30 12:11:52 ET]
Table 'Lova II' 9-max Seat #1 is the button
Seat 1: koksskrt ($108.62 in chips) 
Seat 2: bilukm ($274.70 in chips) 
Seat 3: matiko09 ($100 in chips) 
Seat 4: VanDobeln ($138.16 in chips) 
Seat 5: Ilov3NBA ($100 in chips) 
Seat 6: di0d80 ($115.67 in chips) 
Seat 7: meysam270 ($38.43 in chips) 
Seat 8: cap. marb ($53.79 in chips) 
Seat 9: hurtNCYDE ($100 in chips) 
bilukm: posts small blind $0.50
matiko09: posts big blind $1
*** HOLE CARDS ***
Dealt to matiko09 [7s Ah]
VanDobeln: raises $2 to $3
Ilov3NBA: raises $5.50 to $8.50
di0d80: folds 
meysam270: folds 
cap. marb: folds 
hurtNCYDE: folds 
koksskrt: folds 
bilukm: folds 
matiko09: folds 
VanDobeln: folds 
Uncalled bet ($5.50) returned to Ilov3NBA
Ilov3NBA collected $7.50 from pot
Ilov3NBA: doesn't show hand 
*** SUMMARY ***
Total pot $7.50 | Rake $0 
Seat 1: koksskrt (button) folded before Flop (didn't bet)
Seat 2: bilukm (small blind) folded before Flop
Seat 3: matiko09 (big blind) folded before Flop
Seat 4: VanDobeln folded before Flop
Seat 5: Ilov3NBA collected ($7.50)
Seat 6: di0d80 folded before Flop (didn't bet)
Seat 7: meysam270 folded before Flop (didn't bet)
Seat 8: cap. marb folded before Flop (didn't bet)
Seat 9: hurtNCYDE folded before Flop (didn't bet)





PokerStars Hand #152661256449:  Hold'em No Limit ($0.50/$1.00 USD) - 2016/04/30 18:12:00 CET [2016/04/30 12:12:00 ET]
Table 'Malautra II' 9-max Seat #2 is the button
Seat 1: Fivez ($124.19 in chips) 
Seat 2: Ilov3NBA ($105.80 in chips) 
Seat 3: t.sneijder ($104.83 in chips) 
Seat 4: Khaine_CM ($100 in chips) 
Seat 6: matiko09 ($104.50 in chips) 
Seat 7: poker-rat95 ($28.78 in chips) 
Seat 8: maxxmeister ($169.38 in chips) 
t.sneijder: posts small blind $0.50
Khaine_CM: posts big blind $1
hurtNCYDE: sits out 
cap. marb: sits out 
*** HOLE CARDS ***
Dealt to matiko09 [3s Ts]
matiko09: folds 
poker-rat95: raises $1 to $2
maxxmeister: folds 
Fivez: calls $2
Ilov3NBA: folds 
t.sneijder: calls $1.50
Khaine_CM: folds 
*** FLOP *** [3d 6h 7h]
t.sneijder: bets $2
poker-rat95: calls $2
Fivez: calls $2
*** TURN *** [3d 6h 7h] [Tc]
t.sneijder: bets $2
poker-rat95: calls $2
Fivez: calls $2
*** RIVER *** [3d 6h 7h Tc] [Qc]
t.sneijder: checks 
poker-rat95: bets $9
Fivez: folds 
t.sneijder: folds 
Uncalled bet ($9) returned to poker-rat95
poker-rat95 collected $18.05 from pot
poker-rat95: doesn't show hand 
*** SUMMARY ***
Total pot $19 | Rake $0.95 
Board [3d 6h 7h Tc Qc]
Seat 1: Fivez folded on the River
Seat 2: Ilov3NBA (button) folded before Flop (didn't bet)
Seat 3: t.sneijder (small blind) folded on the River
Seat 4: Khaine_CM (big blind) folded before Flop
Seat 6: matiko09 folded before Flop (didn't bet)
Seat 7: poker-rat95 collected ($18.05)
Seat 8: maxxmeister folded before Flop (didn't bet)





PokerStars Hand #152661260323:  Hold'em No Limit ($0.50/$1.00 USD) - 2016/04/30 18:12:05 CET [2016/04/30 12:12:05 ET]
Table 'Raissa II' 9-max Seat #6 is the button
Seat 1: cap. marb ($46.88 in chips) 
Seat 2: azzad2007 ($100 in chips) 
Seat 3: Kelvin sai ($25.22 in chips) 
Seat 4: koksskrt ($101.50 in chips) 
Seat 5: Jess7jay ($108.36 in chips) 
Seat 6: ilaviiitech ($105.15 in chips) 
Seat 7: matiko09 ($100.50 in chips) 
Seat 8: Khaine_CM ($100 in chips) 
Seat 9: ApkawaDavit ($131.63 in chips) 
matiko09: posts small blind $0.50
Khaine_CM: posts big blind $1
*** HOLE CARDS ***
Dealt to matiko09 [Js Th]
ApkawaDavit: folds 
cap. marb: folds 
azzad2007: folds 
Kelvin sai: raises $1 to $2
koksskrt: folds 
Jess7jay: folds 
ilaviiitech: folds 
matiko09: folds 
Khaine_CM: folds 
Uncalled bet ($1) returned to Kelvin sai
Kelvin sai collected $2.50 from pot
Kelvin sai: doesn't show hand 
*** SUMMARY ***
Total pot $2.50 | Rake $0 
Seat 1: cap. marb folded before Flop (didn't bet)
Seat 2: azzad2007 folded before Flop (didn't bet)
Seat 3: Kelvin sai collected ($2.50)
Seat 4: koksskrt folded before Flop (didn't bet)
Seat 5: Jess7jay folded before Flop (didn't bet)
Seat 6: ilaviiitech (button) folded before Flop (didn't bet)
Seat 7: matiko09 (small blind) folded before Flop
Seat 8: Khaine_CM (big blind) folded before Flop
Seat 9: ApkawaDavit folded before Flop (didn't bet)





PokerStars Hand #152661272483:  Hold'em No Limit ($0.50/$1.00 USD) - 2016/04/30 18:12:21 CET [2016/04/30 12:12:21 ET]
Table 'Arcturus' 9-max Seat #2 is the button
Seat 1: matiko09 ($100 in chips) 
Seat 2: Khaine_CM ($129.47 in chips) 
Seat 3: Spid1 ($112.70 in chips) 
Seat 4: cap. marb ($40 in chips) 
Seat 5: koksskrt ($104 in chips) 
Seat 6: JimineyCrik ($181.34 in chips) 
Seat 7: terrytsui111 ($119.29 in chips) 
Seat 8: ApkawaDavit ($109.05 in chips) 
Seat 9: fishkida ($116.33 in chips) 
Spid1: posts small blind $0.50
cap. marb: posts big blind $1
*** HOLE CARDS ***
Dealt to matiko09 [Ks Tc]
koksskrt: folds 
JimineyCrik: folds 
terrytsui111: folds 
ApkawaDavit: folds 
koksskrt leaves the table
fishkida: raises $2 to $3
matiko09: folds 
Khaine_CM: folds 
Spid1: folds 
cap. marb: folds 
Uncalled bet ($2) returned to fishkida
fishkida collected $2.50 from pot
fishkida: doesn't show hand 
*** SUMMARY ***
Total pot $2.50 | Rake $0 
Seat 1: matiko09 folded before Flop (didn't bet)
Seat 2: Khaine_CM (button) folded before Flop (didn't bet)
Seat 3: Spid1 (small blind) folded before Flop
Seat 4: cap. marb (big blind) folded before Flop
Seat 5: koksskrt folded before Flop (didn't bet)
Seat 6: JimineyCrik folded before Flop (didn't bet)
Seat 7: terrytsui111 folded before Flop (didn't bet)
Seat 8: ApkawaDavit folded before Flop (didn't bet)
Seat 9: fishkida collected ($2.50)





PokerStars Hand #152661275356:  Hold'em No Limit ($0.50/$1.00 USD) - 2016/04/30 18:12:25 CET [2016/04/30 12:12:25 ET]
Table 'Lova II' 9-max Seat #2 is the button
Seat 1: koksskrt ($108.62 in chips) 
Seat 2: bilukm ($274.20 in chips) 
Seat 3: matiko09 ($100 in chips) 
Seat 4: VanDobeln ($135.16 in chips) 
Seat 5: Ilov3NBA ($104.50 in chips) 
Seat 6: di0d80 ($115.67 in chips) 
Seat 7: meysam270 ($38.43 in chips) 
Seat 8: cap. marb ($53.79 in chips) 
Seat 9: hurtNCYDE ($100 in chips) 
matiko09: posts small blind $0.50
VanDobeln: posts big blind $1
*** HOLE CARDS ***
Dealt to matiko09 [7s Qs]
Ilov3NBA: folds 
di0d80: folds 
meysam270: folds 
cap. marb: folds 
hurtNCYDE: folds 
koksskrt: raises $1.50 to $2.50
bilukm: folds 
matiko09: folds 
VanDobeln: folds 
Uncalled bet ($1.50) returned to koksskrt
koksskrt collected $2.50 from pot
koksskrt: doesn't show hand 
*** SUMMARY ***
Total pot $2.50 | Rake $0 
Seat 1: koksskrt collected ($2.50)
Seat 2: bilukm (button) folded before Flop (didn't bet)
Seat 3: matiko09 (small blind) folded before Flop
Seat 4: VanDobeln (big blind) folded before Flop
Seat 5: Ilov3NBA folded before Flop (didn't bet)
Seat 6: di0d80 folded before Flop (didn't bet)
Seat 7: meysam270 folded before Flop (didn't bet)
Seat 8: cap. marb folded before Flop (didn't bet)
Seat 9: hurtNCYDE folded before Flop (didn't bet)





PokerStars Hand #152661292961:  Hold'em No Limit (€0.50/€1.00 EUR) - 2016/04/30 18:12:48 CET [2016/04/30 12:12:48 ET]
Table 'Benda' 9-max Seat #1 is the button
Seat 1: aquarua7 (€222.41 in chips) 
Seat 2: cap. marb (€36 in chips) 
Seat 3: ApkawaDavit (€101.50 in chips) 
Seat 4: fireball2112 (€92.40 in chips) 
Seat 5: Spid1 (€107.25 in chips) 
Seat 6: Nunzio1985ct (€34.61 in chips) 
Seat 7: Ouga Buga (€101 in chips) 
Seat 8: matiko09 (€100 in chips) 
Seat 9: Racushniak (€144.57 in chips) 
cap. marb: posts small blind €0.50
ApkawaDavit: posts big blind €1
*** HOLE CARDS ***
Dealt to matiko09 [Jh Th]
fireball2112: calls €1
Spid1: folds 
Nunzio1985ct: folds 
Ouga Buga: folds 
matiko09: raises €3 to €4
Racushniak: folds 
aquarua7: folds 
cap. marb: folds 
ApkawaDavit: folds 
fireball2112: folds 
Uncalled bet (€3) returned to matiko09
matiko09 collected €3.50 from pot
matiko09: doesn't show hand 
*** SUMMARY ***
Total pot €3.50 | Rake €0 
Seat 1: aquarua7 (button) folded before Flop (didn't bet)
Seat 2: cap. marb (small blind) folded before Flop
Seat 3: ApkawaDavit (big blind) folded before Flop
Seat 4: fireball2112 folded before Flop
Seat 5: Spid1 folded before Flop (didn't bet)
Seat 6: Nunzio1985ct folded before Flop (didn't bet)
Seat 7: Ouga Buga folded before Flop (didn't bet)
Seat 8: matiko09 collected (€3.50)
Seat 9: Racushniak folded before Flop (didn't bet)





PokerStars Hand #152661294680:  Hold'em No Limit ($0.50/$1.00 USD) - 2016/04/30 18:12:50 CET [2016/04/30 12:12:50 ET]
Table 'Raissa II' 9-max Seat #7 is the button
Seat 1: cap. marb ($46.88 in chips) 
Seat 2: azzad2007 ($100 in chips) 
Seat 3: Kelvin sai ($26.72 in chips) 
Seat 4: koksskrt ($101.50 in chips) 
Seat 5: Jess7jay ($108.36 in chips) 
Seat 6: ilaviiitech ($105.15 in chips) 
Seat 7: matiko09 ($100 in chips) 
Seat 8: Khaine_CM ($100 in chips) 
Seat 9: ApkawaDavit ($131.63 in chips) 
Khaine_CM: posts small blind $0.50
ApkawaDavit: posts big blind $1
*** HOLE CARDS ***
Dealt to matiko09 [8s 5c]
cap. marb: folds 
azzad2007: folds 
Kelvin sai: raises $1 to $2
koksskrt: folds 
Jess7jay: folds 
ilaviiitech: folds 
matiko09: folds 
Khaine_CM: folds 
ApkawaDavit: folds 
Uncalled bet ($1) returned to Kelvin sai
Kelvin sai collected $2.50 from pot
*** SUMMARY ***
Total pot $2.50 | Rake $0 
Seat 1: cap. marb folded before Flop (didn't bet)
Seat 2: azzad2007 folded before Flop (didn't bet)
Seat 3: Kelvin sai collected ($2.50)
Seat 4: koksskrt folded before Flop (didn't bet)
Seat 5: Jess7jay folded before Flop (didn't bet)
Seat 6: ilaviiitech folded before Flop (didn't bet)
Seat 7: matiko09 (button) folded before Flop (didn't bet)
Seat 8: Khaine_CM (small blind) folded before Flop
Seat 9: ApkawaDavit (big blind) folded before Flop





PokerStars Hand #152661296305:  Hold'em No Limit ($0.50/$1.00 USD) - 2016/04/30 18:12:52 CET [2016/04/30 12:12:52 ET]
Table 'Arcturus' 9-max Seat #3 is the button
Seat 1: matiko09 ($100 in chips) 
Seat 2: Khaine_CM ($129.47 in chips) 
Seat 3: Spid1 ($112.20 in chips) 
Seat 4: cap. marb ($39 in chips) 
Seat 6: JimineyCrik ($181.34 in chips) 
Seat 7: terrytsui111 ($119.29 in chips) 
Seat 8: ApkawaDavit ($109.05 in chips) 
Seat 9: fishkida ($117.83 in chips) 
cap. marb: posts small blind $0.50
JimineyCrik: posts big blind $1
*** HOLE CARDS ***
Dealt to matiko09 [3h Js]
terrytsui111: raises $1 to $2
ApkawaDavit: folds 
hurtNCYDE joins the table at seat #5 
fishkida: folds 
hurtNCYDE leaves the table
matiko09: folds 
Khaine_CM: folds 
Spid1: folds 
cap. marb: folds 
Ilov3NBA joins the table at seat #5 
JimineyCrik: folds 
Uncalled bet ($1) returned to terrytsui111
terrytsui111 collected $2.50 from pot
terrytsui111: doesn't show hand 
*** SUMMARY ***
Total pot $2.50 | Rake $0 
Seat 1: matiko09 folded before Flop (didn't bet)
Seat 2: Khaine_CM folded before Flop (didn't bet)
Seat 3: Spid1 (button) folded before Flop (didn't bet)
Seat 4: cap. marb (small blind) folded before Flop
Seat 6: JimineyCrik (big blind) folded before Flop
Seat 7: terrytsui111 collected ($2.50)
Seat 8: ApkawaDavit folded before Flop (didn't bet)
Seat 9: fishkida folded before Flop (didn't bet)





PokerStars Hand #152661302677:  Hold'em No Limit ($0.50/$1.00 USD) - 2016/04/30 18:13:00 CET [2016/04/30 12:13:00 ET]
Table 'Malautra II' 9-max Seat #3 is the button
Seat 1: Fivez ($118.19 in chips) 
Seat 2: Ilov3NBA ($105.80 in chips) 
Seat 3: t.sneijder ($98.83 in chips) 
Seat 4: Khaine_CM ($100 in chips) 
Seat 5: hurtNCYDE ($100 in chips) 
Seat 6: matiko09 ($104.50 in chips) 
Seat 7: poker-rat95 ($40.83 in chips) 
Seat 8: maxxmeister ($169.38 in chips) 
Khaine_CM: posts small blind $0.50
hurtNCYDE: posts big blind $1
cap. marb: sits out 
*** HOLE CARDS ***
Dealt to matiko09 [Tc 3h]
matiko09: folds 
poker-rat95: raises $1 to $2
maxxmeister: folds 
Fivez: folds 
Ilov3NBA: folds 
t.sneijder: calls $2
Khaine_CM: folds 
hurtNCYDE: folds 
*** FLOP *** [7s Ac 4d]
poker-rat95: bets $3
t.sneijder: calls $3
*** TURN *** [7s Ac 4d] [2d]
poker-rat95: bets $5
t.sneijder: folds 
Uncalled bet ($5) returned to poker-rat95
poker-rat95 collected $10.92 from pot
poker-rat95: doesn't show hand 
*** SUMMARY ***
Total pot $11.50 | Rake $0.58 
Board [7s Ac 4d 2d]
Seat 1: Fivez folded before Flop (didn't bet)
Seat 2: Ilov3NBA folded before Flop (didn't bet)
Seat 3: t.sneijder (button) folded on the Turn
Seat 4: Khaine_CM (small blind) folded before Flop
Seat 5: hurtNCYDE (big blind) folded before Flop
Seat 6: matiko09 folded before Flop (didn't bet)
Seat 7: poker-rat95 collected ($10.92)
Seat 8: maxxmeister folded before Flop (didn't bet)





PokerStars Hand #152661304349:  Hold'em No Limit ($0.50/$1.00 USD) - 2016/04/30 18:13:03 CET [2016/04/30 12:13:03 ET]
Table 'Lova II' 9-max Seat #3 is the button
Seat 1: koksskrt ($110.12 in chips) 
Seat 2: bilukm ($274.20 in chips) 
Seat 3: matiko09 ($100 in chips) 
Seat 4: VanDobeln ($134.16 in chips) 
Seat 5: Ilov3NBA ($104.50 in chips) 
Seat 6: di0d80 ($115.67 in chips) 
Seat 7: meysam270 ($38.43 in chips) 
Seat 8: cap. marb ($53.79 in chips) 
Seat 9: hurtNCYDE ($100 in chips) 
VanDobeln: posts small blind $0.50
Ilov3NBA: posts big blind $1
*** HOLE CARDS ***
Dealt to matiko09 [Ts Qh]
di0d80: folds 
meysam270: folds 
cap. marb: folds 
hurtNCYDE: folds 
koksskrt: folds 
bilukm: folds 
matiko09: raises $1.27 to $2.27
VanDobeln: folds 
Ilov3NBA: folds 
Uncalled bet ($1.27) returned to matiko09
matiko09 collected $2.50 from pot
matiko09: doesn't show hand 
*** SUMMARY ***
Total pot $2.50 | Rake $0 
Seat 1: koksskrt folded before Flop (didn't bet)
Seat 2: bilukm folded before Flop (didn't bet)
Seat 3: matiko09 (button) collected ($2.50)
Seat 4: VanDobeln (small blind) folded before Flop
Seat 5: Ilov3NBA (big blind) folded before Flop
Seat 6: di0d80 folded before Flop (didn't bet)
Seat 7: meysam270 folded before Flop (didn't bet)
Seat 8: cap. marb folded before Flop (didn't bet)
Seat 9: hurtNCYDE folded before Flop (didn't bet)





PokerStars Hand #152661310216:  Hold'em No Limit ($0.50/$1.00 USD) - 2016/04/30 18:13:10 CET [2016/04/30 12:13:10 ET]
Table 'Arcturus' 9-max Seat #4 is the button
Seat 1: matiko09 ($100 in chips) 
Seat 2: Khaine_CM ($129.47 in chips) 
Seat 3: Spid1 ($112.20 in chips) 
Seat 4: cap. marb ($38.50 in chips) 
Seat 6: JimineyCrik ($180.34 in chips) 
Seat 7: terrytsui111 ($120.79 in chips) 
Seat 8: ApkawaDavit ($109.05 in chips) 
Seat 9: fishkida ($117.83 in chips) 
Ilov3NBA will be allowed to play after the button
JimineyCrik: posts small blind $0.50
terrytsui111: posts big blind $1
*** HOLE CARDS ***
Dealt to matiko09 [Qc 3s]
ApkawaDavit: folds 
fishkida: folds 
matiko09: folds 
Khaine_CM: folds 
Spid1: folds 
cap. marb: folds 
JimineyCrik: folds 
Uncalled bet ($0.50) returned to terrytsui111
terrytsui111 collected $1 from pot
terrytsui111: doesn't show hand 
*** SUMMARY ***
Total pot $1 | Rake $0 
Seat 1: matiko09 folded before Flop (didn't bet)
Seat 2: Khaine_CM folded before Flop (didn't bet)
Seat 3: Spid1 folded before Flop (didn't bet)
Seat 4: cap. marb (button) folded before Flop (didn't bet)
Seat 6: JimineyCrik (small blind) folded before Flop
Seat 7: terrytsui111 (big blind) collected ($1)
Seat 8: ApkawaDavit folded before Flop (didn't bet)
Seat 9: fishkida folded before Flop (didn't bet)





PokerStars Hand #152661318796:  Hold'em No Limit ($0.50/$1.00 USD) - 2016/04/30 18:13:22 CET [2016/04/30 12:13:22 ET]
Table 'Raissa II' 9-max Seat #8 is the button
Seat 1: cap. marb ($46.88 in chips) 
Seat 2: azzad2007 ($100 in chips) 
Seat 3: Kelvin sai ($28.22 in chips) 
Seat 4: koksskrt ($101.50 in chips) 
Seat 5: Jess7jay ($108.36 in chips) 
Seat 6: ilaviiitech ($105.15 in chips) 
Seat 7: matiko09 ($100 in chips) 
Seat 8: Khaine_CM ($100 in chips) 
Seat 9: ApkawaDavit ($130.63 in chips) 
ApkawaDavit: posts small blind $0.50
cap. marb: posts big blind $1
*** HOLE CARDS ***
Dealt to matiko09 [7c Ks]
azzad2007: folds 
Kelvin sai: raises $1 to $2
koksskrt: folds 
Jess7jay: calls $2
ilaviiitech: raises $8 to $10
matiko09: folds 
Khaine_CM: folds 
ApkawaDavit: folds 
cap. marb: folds 
Kelvin sai: calls $8
Jess7jay: calls $8
*** FLOP *** [6d 7d 3h]
Kelvin sai: bets $18.22 and is all-in
Jess7jay: calls $18.22
ilaviiitech: raises $76.93 to $95.15 and is all-in
Jess7jay: calls $76.93
*** TURN *** [6d 7d 3h] [Kh]
*** RIVER *** [6d 7d 3h Kh] [2c]
*** SHOW DOWN ***
Jess7jay: shows [5d 5h] (a pair of Fives)
ilaviiitech: shows [Qd Kd] (a pair of Kings)
ilaviiitech collected $153.86 from side pot
Kelvin sai: shows [4h 4c] (a pair of Fours)
ilaviiitech collected $83.66 from main pot
*** SUMMARY ***
Total pot $240.02 Main pot $83.66. Side pot $153.86. | Rake $2.50 
Board [6d 7d 3h Kh 2c]
Seat 1: cap. marb (big blind) folded before Flop
Seat 2: azzad2007 folded before Flop (didn't bet)
Seat 3: Kelvin sai showed [4h 4c] and lost with a pair of Fours
Seat 4: koksskrt folded before Flop (didn't bet)
Seat 5: Jess7jay showed [5d 5h] and lost with a pair of Fives
Seat 6: ilaviiitech showed [Qd Kd] and won ($237.52) with a pair of Kings
Seat 7: matiko09 folded before Flop (didn't bet)
Seat 8: Khaine_CM (button) folded before Flop (didn't bet)
Seat 9: ApkawaDavit (small blind) folded before Flop





PokerStars Hand #152661322356:  Hold'em No Limit (€0.50/€1.00 EUR) - 2016/04/30 18:13:26 CET [2016/04/30 12:13:26 ET]
Table 'Benda' 9-max Seat #2 is the button
Seat 1: aquarua7 (€222.41 in chips) 
Seat 2: cap. marb (€35.50 in chips) 
Seat 3: ApkawaDavit (€100.50 in chips) 
Seat 4: fireball2112 (€91.40 in chips) 
Seat 5: Spid1 (€107.25 in chips) 
Seat 6: Nunzio1985ct (€34.61 in chips) 
Seat 7: Ouga Buga (€101 in chips) 
Seat 8: matiko09 (€102.50 in chips) 
Seat 9: Racushniak (€144.57 in chips) 
ApkawaDavit: posts small blind €0.50
fireball2112: posts big blind €1
*** HOLE CARDS ***
Dealt to matiko09 [8d 9c]
Spid1: folds 
Nunzio1985ct: folds 
Ouga Buga: raises €1.50 to €2.50
matiko09: folds 
Racushniak: calls €2.50
aquarua7: folds 
cap. marb: folds 
ApkawaDavit: folds 
fireball2112: folds 
*** FLOP *** [4c As Qd]
Ouga Buga: bets €4.07
Racushniak: folds 
Uncalled bet (€4.07) returned to Ouga Buga
Ouga Buga collected €6.18 from pot
Ouga Buga: doesn't show hand 
*** SUMMARY ***
Total pot €6.50 | Rake €0.32 
Board [4c As Qd]
Seat 1: aquarua7 folded before Flop (didn't bet)
Seat 2: cap. marb (button) folded before Flop (didn't bet)
Seat 3: ApkawaDavit (small blind) folded before Flop
Seat 4: fireball2112 (big blind) folded before Flop
Seat 5: Spid1 folded before Flop (didn't bet)
Seat 6: Nunzio1985ct folded before Flop (didn't bet)
Seat 7: Ouga Buga collected (€6.18)
Seat 8: matiko09 folded before Flop (didn't bet)
Seat 9: Racushniak folded on the Flop





PokerStars Hand #152661323719:  Hold'em No Limit ($0.50/$1.00 USD) - 2016/04/30 18:13:28 CET [2016/04/30 12:13:28 ET]
Table 'Arcturus' 9-max Seat #6 is the button
Seat 1: matiko09 ($100 in chips) 
Seat 2: Khaine_CM ($129.47 in chips) 
Seat 3: Spid1 ($112.20 in chips) 
Seat 4: cap. marb ($38.50 in chips) 
Seat 6: JimineyCrik ($179.84 in chips) 
Seat 7: terrytsui111 ($121.29 in chips) 
Seat 8: ApkawaDavit ($109.05 in chips) 
Seat 9: fishkida ($117.83 in chips) 
terrytsui111: posts small blind $0.50
ApkawaDavit: posts big blind $1
Ilov3NBA: sits out 
*** HOLE CARDS ***
Dealt to matiko09 [2s 7d]
fishkida: folds 
matiko09: folds 
Khaine_CM: folds 
Spid1: raises $2 to $3
cap. marb: raises $4 to $7
JimineyCrik: folds 
terrytsui111: folds 
ApkawaDavit: folds 
Spid1: folds 
Uncalled bet ($4) returned to cap. marb
cap. marb collected $7.50 from pot
cap. marb: doesn't show hand 
*** SUMMARY ***
Total pot $7.50 | Rake $0 
Seat 1: matiko09 folded before Flop (didn't bet)
Seat 2: Khaine_CM folded before Flop (didn't bet)
Seat 3: Spid1 folded before Flop
Seat 4: cap. marb collected ($7.50)
Seat 6: JimineyCrik (button) folded before Flop (didn't bet)
Seat 7: terrytsui111 (small blind) folded before Flop
Seat 8: ApkawaDavit (big blind) folded before Flop
Seat 9: fishkida folded before Flop (didn't bet)





PokerStars Hand #152661334431:  Hold'em No Limit ($0.50/$1.00 USD) - 2016/04/30 18:13:42 CET [2016/04/30 12:13:42 ET]
Table 'Lova II' 9-max Seat #4 is the button
Seat 1: koksskrt ($110.12 in chips) 
Seat 2: bilukm ($274.20 in chips) 
Seat 3: matiko09 ($101.50 in chips) 
Seat 4: VanDobeln ($133.66 in chips) 
Seat 5: Ilov3NBA ($103.50 in chips) 
Seat 6: di0d80 ($115.67 in chips) 
Seat 7: meysam270 ($38.43 in chips) 
Seat 8: cap. marb ($53.79 in chips) 
Seat 9: hurtNCYDE ($100 in chips) 
Ilov3NBA: posts small blind $0.50
di0d80: posts big blind $1
*** HOLE CARDS ***
Dealt to matiko09 [Ts 6s]
meysam270: folds 
cap. marb: folds 
hurtNCYDE: folds 
koksskrt: raises $2 to $3
bilukm: folds 
matiko09: folds 
VanDobeln: folds 
Ilov3NBA: folds 
di0d80: folds 
Uncalled bet ($2) returned to koksskrt
koksskrt collected $2.50 from pot
koksskrt: doesn't show hand 
*** SUMMARY ***
Total pot $2.50 | Rake $0 
Seat 1: koksskrt collected ($2.50)
Seat 2: bilukm folded before Flop (didn't bet)
Seat 3: matiko09 folded before Flop (didn't bet)
Seat 4: VanDobeln (button) folded before Flop (didn't bet)
Seat 5: Ilov3NBA (small blind) folded before Flop
Seat 6: di0d80 (big blind) folded before Flop
Seat 7: meysam270 folded before Flop (didn't bet)
Seat 8: cap. marb folded before Flop (didn't bet)
Seat 9: hurtNCYDE folded before Flop (didn't bet)





PokerStars Hand #152661352529:  Hold'em No Limit ($0.50/$1.00 USD) - 2016/04/30 18:14:05 CET [2016/04/30 12:14:05 ET]
Table 'Arcturus' 9-max Seat #7 is the button
Seat 1: matiko09 ($100 in chips) 
Seat 2: Khaine_CM ($129.47 in chips) 
Seat 3: Spid1 ($109.20 in chips) 
Seat 4: cap. marb ($43 in chips) 
Seat 6: JimineyCrik ($179.84 in chips) 
Seat 7: terrytsui111 ($120.79 in chips) 
Seat 8: ApkawaDavit ($108.05 in chips) 
Seat 9: fishkida ($117.83 in chips) 
ApkawaDavit: posts small blind $0.50
fishkida: posts big blind $1
Ilov3NBA: sits out 
*** HOLE CARDS ***
Dealt to matiko09 [Td Kc]
matiko09: folds 
Khaine_CM: folds 
Spid1: folds 
cap. marb: raises $1.12 to $2.12
JimineyCrik: folds 
terrytsui111: raises $5.12 to $7.24
ApkawaDavit: folds 
fishkida: raises $11.76 to $19
cap. marb: raises $24 to $43 and is all-in
terrytsui111: calls $35.76
fishkida: folds 
*** FLOP *** [2s 4h Jd]
*** TURN *** [2s 4h Jd] [3s]
*** RIVER *** [2s 4h Jd 3s] [7c]
*** SHOW DOWN ***
cap. marb: shows [Kd Ac] (high card Ace)
terrytsui111: shows [Kh Ad] (high card Ace)
cap. marb collected $51.50 from pot
terrytsui111 collected $51.50 from pot
*** SUMMARY ***
Total pot $105.50 | Rake $2.50 
Board [2s 4h Jd 3s 7c]
Seat 1: matiko09 folded before Flop (didn't bet)
Seat 2: Khaine_CM folded before Flop (didn't bet)
Seat 3: Spid1 folded before Flop (didn't bet)
Seat 4: cap. marb showed [Kd Ac] and won ($51.50) with high card Ace
Seat 6: JimineyCrik folded before Flop (didn't bet)
Seat 7: terrytsui111 (button) showed [Kh Ad] and won ($51.50) with high card Ace
Seat 8: ApkawaDavit (small blind) folded before Flop
Seat 9: fishkida (big blind) folded before Flop





PokerStars Hand #152661356851:  Hold'em No Limit ($0.50/$1.00 USD) - 2016/04/30 18:14:11 CET [2016/04/30 12:14:11 ET]
Table 'Lova II' 9-max Seat #5 is the button
Seat 1: koksskrt ($111.62 in chips) 
Seat 2: bilukm ($274.20 in chips) 
Seat 3: matiko09 ($101.50 in chips) 
Seat 4: VanDobeln ($133.66 in chips) 
Seat 5: Ilov3NBA ($103 in chips) 
Seat 6: di0d80 ($114.67 in chips) 
Seat 7: meysam270 ($38.43 in chips) 
Seat 8: cap. marb ($53.79 in chips) 
Seat 9: hurtNCYDE ($100 in chips) 
di0d80: posts small blind $0.50
meysam270: posts big blind $1
*** HOLE CARDS ***
Dealt to matiko09 [Ad 6h]
cap. marb: folds 
hurtNCYDE: folds 
koksskrt: folds 
bilukm: folds 
matiko09: folds 
VanDobeln: folds 
Ilov3NBA: folds 
di0d80: raises $2 to $3
meysam270: raises $6 to $9
di0d80: folds 
Uncalled bet ($6) returned to meysam270
meysam270 collected $6 from pot
meysam270: doesn't show hand 
*** SUMMARY ***
Total pot $6 | Rake $0 
Seat 1: koksskrt folded before Flop (didn't bet)
Seat 2: bilukm folded before Flop (didn't bet)
Seat 3: matiko09 folded before Flop (didn't bet)
Seat 4: VanDobeln folded before Flop (didn't bet)
Seat 5: Ilov3NBA (button) folded before Flop (didn't bet)
Seat 6: di0d80 (small blind) folded before Flop
Seat 7: meysam270 (big blind) collected ($6)
Seat 8: cap. marb folded before Flop (didn't bet)
Seat 9: hurtNCYDE folded before Flop (didn't bet)





PokerStars Hand #152661359673:  Hold'em No Limit ($0.50/$1.00 USD) - 2016/04/30 18:14:15 CET [2016/04/30 12:14:15 ET]
Table 'Malautra II' 9-max Seat #4 is the button
Seat 1: Fivez ($118.19 in chips) 
Seat 2: Ilov3NBA ($105.80 in chips) 
Seat 3: t.sneijder ($93.83 in chips) 
Seat 4: Khaine_CM ($100 in chips) 
Seat 5: hurtNCYDE ($100 in chips) 
Seat 6: matiko09 ($104.50 in chips) 
Seat 7: poker-rat95 ($46.75 in chips) 
Seat 8: maxxmeister ($169.38 in chips) 
hurtNCYDE: posts small blind $0.50
matiko09: posts big blind $1
cap. marb: sits out 
*** HOLE CARDS ***
Dealt to matiko09 [6h Tc]
poker-rat95: folds 
maxxmeister: folds 
Fivez: folds 
Ilov3NBA: folds 
t.sneijder: raises $1 to $2
Khaine_CM: calls $2
hurtNCYDE: folds 
matiko09: folds 
*** FLOP *** [Th Td 5d]
t.sneijder: checks 
Khaine_CM: bets $3
t.sneijder: folds 
Uncalled bet ($3) returned to Khaine_CM
Khaine_CM collected $5.22 from pot
Khaine_CM: doesn't show hand 
*** SUMMARY ***
Total pot $5.50 | Rake $0.28 
Board [Th Td 5d]
Seat 1: Fivez folded before Flop (didn't bet)
Seat 2: Ilov3NBA folded before Flop (didn't bet)
Seat 3: t.sneijder folded on the Flop
Seat 4: Khaine_CM (button) collected ($5.22)
Seat 5: hurtNCYDE (small blind) folded before Flop
Seat 6: matiko09 (big blind) folded before Flop
Seat 7: poker-rat95 folded before Flop (didn't bet)
Seat 8: maxxmeister folded before Flop (didn't bet)





PokerStars Hand #152661366063:  Hold'em No Limit (€0.50/€1.00 EUR) - 2016/04/30 18:14:23 CET [2016/04/30 12:14:23 ET]
Table 'Benda' 9-max Seat #3 is the button
Seat 1: aquarua7 (€222.41 in chips) 
Seat 2: cap. marb (€35.50 in chips) 
Seat 3: ApkawaDavit (€100 in chips) 
Seat 4: fireball2112 (€90.40 in chips) 
Seat 6: Nunzio1985ct (€34.61 in chips) 
Seat 7: Ouga Buga (€104.68 in chips) 
Seat 8: matiko09 (€102.50 in chips) 
Seat 9: Racushniak (€142.07 in chips) 
fireball2112: posts small blind €0.50
Spid1: is sitting out 
Nunzio1985ct: posts big blind €1
*** HOLE CARDS ***
Dealt to matiko09 [5s Jd]
Spid1 leaves the table
Ouga Buga: folds 
Bailey Dew joins the table at seat #5 
matiko09: folds 
Racushniak: folds 
aquarua7: folds 
cap. marb: folds 
ApkawaDavit: raises €1 to €2
fireball2112: calls €1.50
Bailey Dew leaves the table
hurtNCYDE joins the table at seat #5 
Nunzio1985ct: folds 
*** FLOP *** [8c 2s 6s]
fireball2112: bets €2
ApkawaDavit: raises €3.50 to €5.50
fireball2112: calls €3.50
*** TURN *** [8c 2s 6s] [5d]
fireball2112: checks 
ApkawaDavit: bets €9.50
fireball2112: folds 
Uncalled bet (€9.50) returned to ApkawaDavit
ApkawaDavit collected €15.20 from pot
ApkawaDavit: doesn't show hand 
*** SUMMARY ***
Total pot €16 | Rake €0.80 
Board [8c 2s 6s 5d]
Seat 1: aquarua7 folded before Flop (didn't bet)
Seat 2: cap. marb folded before Flop (didn't bet)
Seat 3: ApkawaDavit (button) collected (€15.20)
Seat 4: fireball2112 (small blind) folded on the Turn
Seat 6: Nunzio1985ct (big blind) folded before Flop
Seat 7: Ouga Buga folded before Flop (didn't bet)
Seat 8: matiko09 folded before Flop (didn't bet)
Seat 9: Racushniak folded before Flop (didn't bet)





PokerStars Hand #152661378865:  Hold'em No Limit ($0.50/$1.00 USD) - 2016/04/30 18:14:40 CET [2016/04/30 12:14:40 ET]
Table 'Lova II' 9-max Seat #6 is the button
Seat 1: koksskrt ($111.62 in chips) 
Seat 2: bilukm ($274.20 in chips) 
Seat 3: matiko09 ($101.50 in chips) 
Seat 4: VanDobeln ($133.66 in chips) 
Seat 5: Ilov3NBA ($103 in chips) 
Seat 6: di0d80 ($111.67 in chips) 
Seat 7: meysam270 ($41.43 in chips) 
Seat 8: cap. marb ($53.79 in chips) 
Seat 9: hurtNCYDE ($100 in chips) 
meysam270: posts small blind $0.50
cap. marb: posts big blind $1
*** HOLE CARDS ***
Dealt to matiko09 [2d As]
hurtNCYDE: raises $1.50 to $2.50
koksskrt: folds 
bilukm is connected 
bilukm: folds 
matiko09: folds 
VanDobeln: folds 
Ilov3NBA: folds 
di0d80: folds 
meysam270: folds 
cap. marb: folds 
Uncalled bet ($1.50) returned to hurtNCYDE
hurtNCYDE collected $2.50 from pot
*** SUMMARY ***
Total pot $2.50 | Rake $0 
Seat 1: koksskrt folded before Flop (didn't bet)
Seat 2: bilukm folded before Flop (didn't bet)
Seat 3: matiko09 folded before Flop (didn't bet)
Seat 4: VanDobeln folded before Flop (didn't bet)
Seat 5: Ilov3NBA folded before Flop (didn't bet)
Seat 6: di0d80 (button) folded before Flop (didn't bet)
Seat 7: meysam270 (small blind) folded before Flop
Seat 8: cap. marb (big blind) folded before Flop
Seat 9: hurtNCYDE collected ($2.50)





PokerStars Hand #152661386435:  Hold'em No Limit ($0.50/$1.00 USD) - 2016/04/30 18:14:50 CET [2016/04/30 12:14:50 ET]
Table 'Raissa II' 9-max Seat #9 is the button
Seat 1: cap. marb ($45.88 in chips) 
Seat 2: azzad2007 ($100 in chips) 
Seat 4: koksskrt ($101.50 in chips) 
Seat 5: Jess7jay ($3.21 in chips) 
Seat 6: ilaviiitech ($237.52 in chips) 
Seat 7: matiko09 ($100 in chips) 
Seat 8: Khaine_CM ($100 in chips) 
Seat 9: ApkawaDavit ($130.13 in chips) 
cap. marb: posts small blind $0.50
azzad2007: posts big blind $1
*** HOLE CARDS ***
Dealt to matiko09 [Th Kc]
koksskrt: folds 
Jess7jay: folds 
ilaviiitech: folds 
Kelvin sai leaves the table
Jess7jay leaves the table
Ilov3NBA joins the table at seat #3 
Ilov3NBA leaves the table
matiko09: raises $2 to $3
hurtNCYDE joins the table at seat #3 
hurtNCYDE leaves the table
Khaine_CM: folds 
ApkawaDavit: folds 
cap. marb: folds 
azzad2007: folds 
Uncalled bet ($2) returned to matiko09
matiko09 collected $2.50 from pot
matiko09: doesn't show hand 
*** SUMMARY ***
Total pot $2.50 | Rake $0 
Seat 1: cap. marb (small blind) folded before Flop
Seat 2: azzad2007 (big blind) folded before Flop
Seat 4: koksskrt folded before Flop (didn't bet)
Seat 5: Jess7jay folded before Flop (didn't bet)
Seat 6: ilaviiitech folded before Flop (didn't bet)
Seat 7: matiko09 collected ($2.50)
Seat 8: Khaine_CM folded before Flop (didn't bet)
Seat 9: ApkawaDavit (button) folded before Flop (didn't bet)





PokerStars Hand #152661393997:  Hold'em No Limit ($0.50/$1.00 USD) - 2016/04/30 18:15:00 CET [2016/04/30 12:15:00 ET]
Table 'Malautra II' 9-max Seat #5 is the button
Seat 1: Fivez ($118.19 in chips) 
Seat 2: Ilov3NBA ($105.80 in chips) 
Seat 3: t.sneijder ($91.83 in chips) 
Seat 4: Khaine_CM ($103.22 in chips) 
Seat 5: hurtNCYDE ($100 in chips) 
Seat 6: matiko09 ($103.50 in chips) 
Seat 7: poker-rat95 ($46.75 in chips) 
Seat 8: maxxmeister ($169.38 in chips) 
matiko09: posts small blind $0.50
poker-rat95: posts big blind $1
cap. marb: sits out 
*** HOLE CARDS ***
Dealt to matiko09 [4d 6s]
maxxmeister: folds 
maxxmeister leaves the table
Fivez: raises $2 to $3
Ilov3NBA: folds 
t.sneijder: folds 
Bailey Dew joins the table at seat #8 
Khaine_CM: folds 
hurtNCYDE: folds 
matiko09: folds 
poker-rat95: calls $2
*** FLOP *** [9s 2h 8d]
poker-rat95: checks 
Fivez: bets $4
poker-rat95: folds 
Uncalled bet ($4) returned to Fivez
Fivez collected $6.18 from pot
Fivez: doesn't show hand 
*** SUMMARY ***
Total pot $6.50 | Rake $0.32 
Board [9s 2h 8d]
Seat 1: Fivez collected ($6.18)
Seat 2: Ilov3NBA folded before Flop (didn't bet)
Seat 3: t.sneijder folded before Flop (didn't bet)
Seat 4: Khaine_CM folded before Flop (didn't bet)
Seat 5: hurtNCYDE (button) folded before Flop (didn't bet)
Seat 6: matiko09 (small blind) folded before Flop
Seat 7: poker-rat95 (big blind) folded on the Flop
Seat 8: maxxmeister folded before Flop (didn't bet)





PokerStars Hand #152661403438:  Hold'em No Limit ($0.50/$1.00 USD) - 2016/04/30 18:15:12 CET [2016/04/30 12:15:12 ET]
Table 'Lova II' 9-max Seat #7 is the button
Seat 1: koksskrt ($111.62 in chips) 
Seat 2: bilukm ($274.20 in chips) 
Seat 3: matiko09 ($101.50 in chips) 
Seat 4: VanDobeln ($133.66 in chips) 
Seat 5: Ilov3NBA ($103 in chips) 
Seat 6: di0d80 ($111.67 in chips) 
Seat 7: meysam270 ($40.93 in chips) 
Seat 8: cap. marb ($52.79 in chips) 
Seat 9: hurtNCYDE ($101.50 in chips) 
cap. marb: posts small blind $0.50
hurtNCYDE: posts big blind $1
*** HOLE CARDS ***
Dealt to matiko09 [Ts Qc]
koksskrt: raises $2 to $3
bilukm: folds 
matiko09: folds 
VanDobeln: folds 
Ilov3NBA: folds 
di0d80: calls $3
meysam270: folds 
cap. marb: folds 
hurtNCYDE: folds 
*** FLOP *** [Jc As 3c]
koksskrt: checks 
di0d80: checks 
*** TURN *** [Jc As 3c] [Td]
koksskrt: checks 
di0d80: checks 
*** RIVER *** [Jc As 3c Td] [5c]
koksskrt: checks 
di0d80: checks 
*** SHOW DOWN ***
koksskrt: shows [9d 9c] (a pair of Nines)
di0d80: shows [Qh Jh] (a pair of Jacks)
di0d80 collected $7.12 from pot
*** SUMMARY ***
Total pot $7.50 | Rake $0.38 
Board [Jc As 3c Td 5c]
Seat 1: koksskrt showed [9d 9c] and lost with a pair of Nines
Seat 2: bilukm folded before Flop (didn't bet)
Seat 3: matiko09 folded before Flop (didn't bet)
Seat 4: VanDobeln folded before Flop (didn't bet)
Seat 5: Ilov3NBA folded before Flop (didn't bet)
Seat 6: di0d80 showed [Qh Jh] and won ($7.12) with a pair of Jacks
Seat 7: meysam270 (button) folded before Flop (didn't bet)
Seat 8: cap. marb (small blind) folded before Flop
Seat 9: hurtNCYDE (big blind) folded before Flop





PokerStars Hand #152661406517:  Hold'em No Limit ($0.50/$1.00 USD) - 2016/04/30 18:15:16 CET [2016/04/30 12:15:16 ET]
Table 'Raissa II' 9-max Seat #1 is the button
Seat 1: cap. marb ($45.38 in chips) 
Seat 2: azzad2007 ($100 in chips) 
Seat 4: koksskrt ($101.50 in chips) 
Seat 6: ilaviiitech ($237.52 in chips) 
Seat 7: matiko09 ($101.50 in chips) 
Seat 8: Khaine_CM ($100 in chips) 
Seat 9: ApkawaDavit ($130.13 in chips) 
azzad2007: posts small blind $0.50
koksskrt: posts big blind $1
*** HOLE CARDS ***
Dealt to matiko09 [6s Qd]
ilaviiitech: folds 
matiko09: folds 
Khaine_CM: folds 
ApkawaDavit: folds 
korlito69 joins the table at seat #5 
cap. marb: raises $1.12 to $2.12
azzad2007: raises $5.88 to $8
iRivuLose joins the table at seat #3 
koksskrt: folds 
cap. marb: calls $5.88
*** FLOP *** [9d Ks 2h]
azzad2007: bets $4.52
cap. marb: calls $4.52
*** TURN *** [9d Ks 2h] [6c]
azzad2007: checks 
cap. marb: bets $11.87
azzad2007: calls $11.87
*** RIVER *** [9d Ks 2h 6c] [9c]
azzad2007: checks 
cap. marb: checks 
*** SHOW DOWN ***
azzad2007: shows [Kd Jh] (two pair, Kings and Nines)
cap. marb: mucks hand 
azzad2007 collected $47.29 from pot
*** SUMMARY ***
Total pot $49.78 | Rake $2.49 
Board [9d Ks 2h 6c 9c]
Seat 1: cap. marb (button) mucked [Jc Qc]
Seat 2: azzad2007 (small blind) showed [Kd Jh] and won ($47.29) with two pair, Kings and Nines
Seat 4: koksskrt (big blind) folded before Flop
Seat 6: ilaviiitech folded before Flop (didn't bet)
Seat 7: matiko09 folded before Flop (didn't bet)
Seat 8: Khaine_CM folded before Flop (didn't bet)
Seat 9: ApkawaDavit folded before Flop (didn't bet)





PokerStars Hand #152661418828:  Hold'em No Limit ($0.50/$1.00 USD) - 2016/04/30 18:15:32 CET [2016/04/30 12:15:32 ET]
Table 'Arcturus' 9-max Seat #8 is the button
Seat 1: matiko09 ($100 in chips) 
Seat 2: Khaine_CM ($129.47 in chips) 
Seat 3: Spid1 ($109.20 in chips) 
Seat 4: cap. marb ($51.50 in chips) 
Seat 6: JimineyCrik ($179.84 in chips) 
Seat 7: terrytsui111 ($129.29 in chips) 
Seat 8: ApkawaDavit ($107.55 in chips) 
Seat 9: fishkida ($98.83 in chips) 
fishkida: posts small blind $0.50
matiko09: posts big blind $1
Ilov3NBA: sits out 
*** HOLE CARDS ***
Dealt to matiko09 [Kc 4h]
Khaine_CM: folds 
Spid1: folds 
cap. marb: raises $1.12 to $2.12
JimineyCrik: folds 
terrytsui111: calls $2.12
ApkawaDavit: raises $6.38 to $8.50
fishkida: folds 
matiko09: folds 
cap. marb: folds 
terrytsui111: calls $6.38
*** FLOP *** [4d 4s 3h]
terrytsui111: checks 
ApkawaDavit: bets $10.50
terrytsui111: calls $10.50
*** TURN *** [4d 4s 3h] [2c]
terrytsui111: checks 
ApkawaDavit: checks 
*** RIVER *** [4d 4s 3h 2c] [Qc]
terrytsui111: checks 
ApkawaDavit: bets $19.50
terrytsui111: calls $19.50
*** SHOW DOWN ***
ApkawaDavit: shows [Kh Jd] (a pair of Fours)
terrytsui111: shows [6c 6d] (two pair, Sixes and Fours)
terrytsui111 collected $78.12 from pot
*** SUMMARY ***
Total pot $80.62 | Rake $2.50 
Board [4d 4s 3h 2c Qc]
Seat 1: matiko09 (big blind) folded before Flop
Seat 2: Khaine_CM folded before Flop (didn't bet)
Seat 3: Spid1 folded before Flop (didn't bet)
Seat 4: cap. marb folded before Flop
Seat 6: JimineyCrik folded before Flop (didn't bet)
Seat 7: terrytsui111 showed [6c 6d] and won ($78.12) with two pair, Sixes and Fours
Seat 8: ApkawaDavit (button) showed [Kh Jd] and lost with a pair of Fours
Seat 9: fishkida (small blind) folded before Flop





PokerStars Hand #152661421000:  Hold'em No Limit ($0.50/$1.00 USD) - 2016/04/30 18:15:35 CET [2016/04/30 12:15:35 ET]
Table 'Malautra II' 9-max Seat #6 is the button
Seat 1: Fivez ($121.37 in chips) 
Seat 2: Ilov3NBA ($105.80 in chips) 
Seat 3: t.sneijder ($91.83 in chips) 
Seat 4: Khaine_CM ($103.22 in chips) 
Seat 5: hurtNCYDE ($100 in chips) 
Seat 6: matiko09 ($103 in chips) 
Seat 7: poker-rat95 ($43.75 in chips) 
Seat 9: cap. marb ($40 in chips) 
poker-rat95: posts small blind $0.50
cap. marb: posts big blind $1
*** HOLE CARDS ***
Dealt to matiko09 [5h 6c]
Fivez: folds 
Ilov3NBA: folds 
t.sneijder: calls $1
Bailey Dew leaves the table
Khaine_CM: raises $3 to $4
hurtNCYDE: calls $4
Nito Lansky joins the table at seat #8 
matiko09: folds 
poker-rat95: calls $3.50
cap. marb: folds 
t.sneijder: calls $3
*** FLOP *** [As Jc 8h]
poker-rat95: checks 
t.sneijder: checks 
Khaine_CM: checks 
hurtNCYDE: checks 
*** TURN *** [As Jc 8h] [Jh]
poker-rat95: checks 
t.sneijder: checks 
Khaine_CM: bets $11
hurtNCYDE: folds 
poker-rat95: folds 
t.sneijder: folds 
Uncalled bet ($11) returned to Khaine_CM
Khaine_CM collected $16.15 from pot
Khaine_CM: doesn't show hand 
*** SUMMARY ***
Total pot $17 | Rake $0.85 
Board [As Jc 8h Jh]
Seat 1: Fivez folded before Flop (didn't bet)
Seat 2: Ilov3NBA folded before Flop (didn't bet)
Seat 3: t.sneijder folded on the Turn
Seat 4: Khaine_CM collected ($16.15)
Seat 5: hurtNCYDE folded on the Turn
Seat 6: matiko09 (button) folded before Flop (didn't bet)
Seat 7: poker-rat95 (small blind) folded on the Turn
Seat 9: cap. marb (big blind) folded before Flop





PokerStars Hand #152661427610:  Hold'em No Limit (€0.50/€1.00 EUR) - 2016/04/30 18:15:43 CET [2016/04/30 12:15:43 ET]
Table 'Benda' 9-max Seat #4 is the button
Seat 1: aquarua7 (€222.41 in chips) 
Seat 2: cap. marb (€35.50 in chips) 
Seat 3: ApkawaDavit (€107.70 in chips) 
Seat 4: fireball2112 (€82.90 in chips) 
Seat 6: Nunzio1985ct (€33.61 in chips) 
Seat 7: Ouga Buga (€104.68 in chips) 
Seat 8: matiko09 (€102.50 in chips) 
Seat 9: Racushniak (€142.07 in chips) 
hurtNCYDE will be allowed to play after the button
Nunzio1985ct: posts small blind €0.50
Ouga Buga: posts big blind €1
*** HOLE CARDS ***
Dealt to matiko09 [6d 3h]
matiko09: folds 
Racushniak: folds 
aquarua7: folds 
cap. marb: folds 
ApkawaDavit: folds 
fireball2112: folds 
Nunzio1985ct: calls €0.50
Ouga Buga: checks 
*** FLOP *** [7h 3d 8c]
Nunzio1985ct: bets €1
Ouga Buga: calls €1
*** TURN *** [7h 3d 8c] [Ac]
Nunzio1985ct: checks 
Ouga Buga: checks 
*** RIVER *** [7h 3d 8c Ac] [4s]
Nunzio1985ct: bets €4
Ouga Buga: folds 
Uncalled bet (€4) returned to Nunzio1985ct
Nunzio1985ct collected €3.80 from pot
*** SUMMARY ***
Total pot €4 | Rake €0.20 
Board [7h 3d 8c Ac 4s]
Seat 1: aquarua7 folded before Flop (didn't bet)
Seat 2: cap. marb folded before Flop (didn't bet)
Seat 3: ApkawaDavit folded before Flop (didn't bet)
Seat 4: fireball2112 (button) folded before Flop (didn't bet)
Seat 6: Nunzio1985ct (small blind) collected (€3.80)
Seat 7: Ouga Buga (big blind) folded on the River
Seat 8: matiko09 folded before Flop (didn't bet)
Seat 9: Racushniak folded before Flop (didn't bet)





PokerStars Hand #152661463625:  Hold'em No Limit ($0.50/$1.00 USD) - 2016/04/30 18:16:30 CET [2016/04/30 12:16:30 ET]
Table 'Lova II' 9-max Seat #8 is the button
Seat 2: bilukm ($274.20 in chips) 
Seat 3: matiko09 ($101.50 in chips) 
Seat 4: VanDobeln ($133.66 in chips) 
Seat 5: Ilov3NBA ($103 in chips) 
Seat 6: di0d80 ($115.79 in chips) 
Seat 7: meysam270 ($40.93 in chips) 
Seat 8: cap. marb ($52.29 in chips) 
Seat 9: hurtNCYDE ($100.50 in chips) 
hurtNCYDE: posts small blind $0.50
koksskrt: is sitting out 
koksskrt leaves the table
bilukm: posts big blind $1
*** HOLE CARDS ***
Dealt to matiko09 [3d 2d]
matiko09: folds 
VanDobeln: folds 
Ilov3NBA: folds 
di0d80: folds 
meysam270: folds 
cap. marb: folds 
hurtNCYDE: raises $1.50 to $2.50
bilukm: folds 
Uncalled bet ($1.50) returned to hurtNCYDE
hurtNCYDE collected $2 from pot
hurtNCYDE: doesn't show hand 
*** SUMMARY ***
Total pot $2 | Rake $0 
Seat 2: bilukm (big blind) folded before Flop
Seat 3: matiko09 folded before Flop (didn't bet)
Seat 4: VanDobeln folded before Flop (didn't bet)
Seat 5: Ilov3NBA folded before Flop (didn't bet)
Seat 6: di0d80 folded before Flop (didn't bet)
Seat 7: meysam270 folded before Flop (didn't bet)
Seat 8: cap. marb (button) folded before Flop (didn't bet)
Seat 9: hurtNCYDE (small blind) collected ($2)





PokerStars Hand #152661473905:  Hold'em No Limit ($0.50/$1.00 USD) - 2016/04/30 18:16:44 CET [2016/04/30 12:16:44 ET]
Table 'Malautra II' 9-max Seat #7 is the button
Seat 2: Ilov3NBA ($105.80 in chips) 
Seat 3: t.sneijder ($87.83 in chips) 
Seat 4: Khaine_CM ($115.37 in chips) 
Seat 5: hurtNCYDE ($100 in chips) 
Seat 6: matiko09 ($103 in chips) 
Seat 7: poker-rat95 ($39.75 in chips) 
Seat 9: cap. marb ($39 in chips) 
Nito Lansky will be allowed to play after the button
cap. marb: posts small blind $0.50
Fivez: is sitting out 
Ilov3NBA: posts big blind $1
*** HOLE CARDS ***
Dealt to matiko09 [2s 9c]
t.sneijder: calls $1
Khaine_CM: folds 
hurtNCYDE: raises $3 to $4
matiko09: folds 
poker-rat95: calls $4
cap. marb: folds 
Ilov3NBA: folds 
t.sneijder: calls $3
*** FLOP *** [Tc 7c 7h]
t.sneijder: bets $3
hurtNCYDE: folds 
poker-rat95: calls $3
*** TURN *** [Tc 7c 7h] [5s]
t.sneijder: bets $10
poker-rat95: folds 
Uncalled bet ($10) returned to t.sneijder
t.sneijder collected $18.52 from pot
t.sneijder: doesn't show hand 
*** SUMMARY ***
Total pot $19.50 | Rake $0.98 
Board [Tc 7c 7h 5s]
Seat 2: Ilov3NBA (big blind) folded before Flop
Seat 3: t.sneijder collected ($18.52)
Seat 4: Khaine_CM folded before Flop (didn't bet)
Seat 5: hurtNCYDE folded on the Flop
Seat 6: matiko09 folded before Flop (didn't bet)
Seat 7: poker-rat95 (button) folded on the Turn
Seat 9: cap. marb (small blind) folded before Flop





PokerStars Hand #152661474628:  Hold'em No Limit ($0.50/$1.00 USD) - 2016/04/30 18:16:45 CET [2016/04/30 12:16:45 ET]
Table 'Arcturus' 9-max Seat #9 is the button
Seat 1: matiko09 ($100 in chips) 
Seat 2: Khaine_CM ($129.47 in chips) 
Seat 3: Spid1 ($109.20 in chips) 
Seat 4: cap. marb ($49.38 in chips) 
Seat 6: JimineyCrik ($179.84 in chips) 
Seat 7: terrytsui111 ($168.91 in chips) 
Seat 8: ApkawaDavit ($100 in chips) 
Seat 9: fishkida ($98.33 in chips) 
matiko09: posts small blind $0.50
Khaine_CM: posts big blind $1
Ilov3NBA: sits out 
*** HOLE CARDS ***
Dealt to matiko09 [4h Td]
Spid1: folds 
cap. marb: folds 
JimineyCrik: folds 
terrytsui111: raises $1 to $2
ApkawaDavit: folds 
fishkida: folds 
matiko09: folds 
Khaine_CM: folds 
Uncalled bet ($1) returned to terrytsui111
terrytsui111 collected $2.50 from pot
terrytsui111: doesn't show hand 
*** SUMMARY ***
Total pot $2.50 | Rake $0 
Seat 1: matiko09 (small blind) folded before Flop
Seat 2: Khaine_CM (big blind) folded before Flop
Seat 3: Spid1 folded before Flop (didn't bet)
Seat 4: cap. marb folded before Flop (didn't bet)
Seat 6: JimineyCrik folded before Flop (didn't bet)
Seat 7: terrytsui111 collected ($2.50)
Seat 8: ApkawaDavit folded before Flop (didn't bet)
Seat 9: fishkida (button) folded before Flop (didn't bet)





PokerStars Hand #152661487966:  Hold'em No Limit ($0.50/$1.00 USD) - 2016/04/30 18:17:02 CET [2016/04/30 12:17:02 ET]
Table 'Lova II' 9-max Seat #9 is the button
Seat 2: bilukm ($273.20 in chips) 
Seat 3: matiko09 ($101.50 in chips) 
Seat 4: VanDobeln ($133.66 in chips) 
Seat 5: Ilov3NBA ($103 in chips) 
Seat 6: di0d80 ($115.79 in chips) 
Seat 7: meysam270 ($40.93 in chips) 
Seat 8: cap. marb ($52.29 in chips) 
Seat 9: hurtNCYDE ($101.50 in chips) 
bilukm: posts small blind $0.50
matiko09: posts big blind $1
*** HOLE CARDS ***
Dealt to matiko09 [5d As]
VanDobeln: folds 
Ilov3NBA: folds 
di0d80: folds 
meysam270: folds 
cap. marb: raises $1.12 to $2.12
hurtNCYDE: folds 
Bailey Dew joins the table at seat #1 
bilukm is disconnected 
bilukm is connected 
bilukm: folds 
matiko09: folds 
Uncalled bet ($1.12) returned to cap. marb
cap. marb collected $2.50 from pot
cap. marb: doesn't show hand 
*** SUMMARY ***
Total pot $2.50 | Rake $0 
Seat 2: bilukm (small blind) folded before Flop
Seat 3: matiko09 (big blind) folded before Flop
Seat 4: VanDobeln folded before Flop (didn't bet)
Seat 5: Ilov3NBA folded before Flop (didn't bet)
Seat 6: di0d80 folded before Flop (didn't bet)
Seat 7: meysam270 folded before Flop (didn't bet)
Seat 8: cap. marb collected ($2.50)
Seat 9: hurtNCYDE (button) folded before Flop (didn't bet)





PokerStars Hand #152661498839:  Hold'em No Limit ($0.50/$1.00 USD) - 2016/04/30 18:17:16 CET [2016/04/30 12:17:16 ET]
Table 'Arcturus' 9-max Seat #1 is the button
Seat 1: matiko09 ($100 in chips) 
Seat 2: Khaine_CM ($128.47 in chips) 
Seat 3: Spid1 ($109.20 in chips) 
Seat 4: cap. marb ($49.38 in chips) 
Seat 6: JimineyCrik ($179.84 in chips) 
Seat 7: terrytsui111 ($170.41 in chips) 
Seat 8: ApkawaDavit ($100 in chips) 
Seat 9: fishkida ($98.33 in chips) 
Khaine_CM: posts small blind $0.50
Spid1: posts big blind $1
Ilov3NBA: sits out 
*** HOLE CARDS ***
Dealt to matiko09 [Tc 8d]
cap. marb: folds 
JimineyCrik: folds 
terrytsui111: raises $2 to $3
ApkawaDavit: folds 
fishkida: calls $3
matiko09: folds 
Khaine_CM: folds 
Spid1: folds 
*** FLOP *** [7c Js Qc]
terrytsui111: checks 
fishkida: bets $5
terrytsui111: folds 
Uncalled bet ($5) returned to fishkida
fishkida collected $7.12 from pot
fishkida: doesn't show hand 
*** SUMMARY ***
Total pot $7.50 | Rake $0.38 
Board [7c Js Qc]
Seat 1: matiko09 (button) folded before Flop (didn't bet)
Seat 2: Khaine_CM (small blind) folded before Flop
Seat 3: Spid1 (big blind) folded before Flop
Seat 4: cap. marb folded before Flop (didn't bet)
Seat 6: JimineyCrik folded before Flop (didn't bet)
Seat 7: terrytsui111 folded on the Flop
Seat 8: ApkawaDavit folded before Flop (didn't bet)
Seat 9: fishkida collected ($7.12)





PokerStars Hand #152661500981:  Hold'em No Limit ($0.50/$1.00 USD) - 2016/04/30 18:17:19 CET [2016/04/30 12:17:19 ET]
Table 'Raissa II' 9-max Seat #2 is the button
Seat 1: cap. marb ($40 in chips) 
Seat 2: azzad2007 ($122.90 in chips) 
Seat 4: koksskrt ($100.50 in chips) 
Seat 5: korlito69 ($50 in chips) 
Seat 6: ilaviiitech ($237.52 in chips) 
Seat 7: matiko09 ($101.50 in chips) 
Seat 8: Khaine_CM ($100 in chips) 
Seat 9: ApkawaDavit ($130.13 in chips) 
iRivuLose will be allowed to play after the button
koksskrt: posts small blind $0.50
korlito69: posts big blind $1
*** HOLE CARDS ***
Dealt to matiko09 [3h 4c]
ilaviiitech: folds 
matiko09: folds 
Khaine_CM: raises $2 to $3
ilaviiitech leaves the table
Bailey Dew joins the table at seat #6 
ApkawaDavit: folds 
Bailey Dew leaves the table
cap. marb: folds 
azzad2007: folds 
koksskrt: folds 
hurtNCYDE joins the table at seat #6 
korlito69: folds 
Uncalled bet ($2) returned to Khaine_CM
Khaine_CM collected $2.50 from pot
Khaine_CM: doesn't show hand 
*** SUMMARY ***
Total pot $2.50 | Rake $0 
Seat 1: cap. marb folded before Flop (didn't bet)
Seat 2: azzad2007 (button) folded before Flop (didn't bet)
Seat 4: koksskrt (small blind) folded before Flop
Seat 5: korlito69 (big blind) folded before Flop
Seat 6: ilaviiitech folded before Flop (didn't bet)
Seat 7: matiko09 folded before Flop (didn't bet)
Seat 8: Khaine_CM collected ($2.50)
Seat 9: ApkawaDavit folded before Flop (didn't bet)





PokerStars Hand #152661501924:  Hold'em No Limit (€0.50/€1.00 EUR) - 2016/04/30 18:17:20 CET [2016/04/30 12:17:20 ET]
Table 'Benda' 9-max Seat #6 is the button
Seat 1: aquarua7 (€222.41 in chips) 
Seat 2: cap. marb (€35.50 in chips) 
Seat 3: ApkawaDavit (€107.70 in chips) 
Seat 4: fireball2112 (€82.90 in chips) 
Seat 6: Nunzio1985ct (€35.41 in chips) 
Seat 7: Ouga Buga (€102.68 in chips) 
Seat 8: matiko09 (€102.50 in chips) 
Seat 9: Racushniak (€142.07 in chips) 
Ouga Buga: posts small blind €0.50
matiko09: posts big blind €1
hurtNCYDE: sits out 
*** HOLE CARDS ***
Dealt to matiko09 [2c 9h]
Racushniak: raises €2.50 to €3.50
aquarua7: folds 
cap. marb: folds 
ApkawaDavit: folds 
fireball2112: folds 
Nunzio1985ct: folds 
Ouga Buga: folds 
matiko09: folds 
Uncalled bet (€2.50) returned to Racushniak
Racushniak collected €2.50 from pot
Racushniak: doesn't show hand 
*** SUMMARY ***
Total pot €2.50 | Rake €0 
Seat 1: aquarua7 folded before Flop (didn't bet)
Seat 2: cap. marb folded before Flop (didn't bet)
Seat 3: ApkawaDavit folded before Flop (didn't bet)
Seat 4: fireball2112 folded before Flop (didn't bet)
Seat 6: Nunzio1985ct (button) folded before Flop (didn't bet)
Seat 7: Ouga Buga (small blind) folded before Flop
Seat 8: matiko09 (big blind) folded before Flop
Seat 9: Racushniak collected (€2.50)





PokerStars Hand #152661515665:  Hold'em No Limit ($0.50/$1.00 USD) - 2016/04/30 18:17:38 CET [2016/04/30 12:17:38 ET]
Table 'Malautra II' 9-max Seat #9 is the button
Seat 2: Ilov3NBA ($104.80 in chips) 
Seat 3: t.sneijder ($99.35 in chips) 
Seat 4: Khaine_CM ($115.37 in chips) 
Seat 5: hurtNCYDE ($100 in chips) 
Seat 6: matiko09 ($103 in chips) 
Seat 7: poker-rat95 ($32.75 in chips) 
Seat 8: Nito Lansky ($80 in chips) 
Seat 9: cap. marb ($38.50 in chips) 
Fivez will be allowed to play after the button
Ilov3NBA: posts small blind $0.50
t.sneijder: posts big blind $1
Nito Lansky: posts big blind $1
*** HOLE CARDS ***
Dealt to matiko09 [5c 8h]
Khaine_CM: folds 
hurtNCYDE: folds 
matiko09: folds 
poker-rat95: calls $1
Nito Lansky: raises $2 to $3
cap. marb: raises $5 to $8
Ilov3NBA: folds 
t.sneijder: calls $7
poker-rat95: calls $7
Nito Lansky: folds 
*** FLOP *** [6s Th 9c]
t.sneijder: bets $8
poker-rat95: calls $8
cap. marb: raises $22.50 to $30.50 and is all-in
t.sneijder: calls $22.50
poker-rat95: calls $16.75 and is all-in
*** TURN *** [6s Th 9c] [Jh]
*** RIVER *** [6s Th 9c Jh] [Ah]
*** SHOW DOWN ***
t.sneijder: shows [8d 6d] (a pair of Sixes)
cap. marb: shows [Td Ts] (three of a kind, Tens)
cap. marb collected $11.50 from side pot
poker-rat95: shows [Qs Kd] (a straight, Ten to Ace)
poker-rat95 collected $99.25 from main pot
*** SUMMARY ***
Total pot $113.25 Main pot $99.25. Side pot $11.50. | Rake $2.50 
Board [6s Th 9c Jh Ah]
Seat 2: Ilov3NBA (small blind) folded before Flop
Seat 3: t.sneijder (big blind) showed [8d 6d] and lost with a pair of Sixes
Seat 4: Khaine_CM folded before Flop (didn't bet)
Seat 5: hurtNCYDE folded before Flop (didn't bet)
Seat 6: matiko09 folded before Flop (didn't bet)
Seat 7: poker-rat95 showed [Qs Kd] and won ($99.25) with a straight, Ten to Ace
Seat 8: Nito Lansky folded before Flop
Seat 9: cap. marb (button) showed [Td Ts] and won ($11.50) with three of a kind, Tens





PokerStars Hand #152661518711:  Hold'em No Limit (€0.50/€1.00 EUR) - 2016/04/30 18:17:42 CET [2016/04/30 12:17:42 ET]
Table 'Benda' 9-max Seat #7 is the button
Seat 1: aquarua7 (€222.41 in chips) 
Seat 2: cap. marb (€35.50 in chips) 
Seat 3: ApkawaDavit (€107.70 in chips) 
Seat 4: fireball2112 (€82.90 in chips) 
Seat 6: Nunzio1985ct (€35.41 in chips) 
Seat 7: Ouga Buga (€102.18 in chips) 
Seat 8: matiko09 (€101.50 in chips) 
Seat 9: Racushniak (€143.57 in chips) 
matiko09: posts small blind €0.50
Racushniak: posts big blind €1
hurtNCYDE: sits out 
*** HOLE CARDS ***
Dealt to matiko09 [Kd 4h]
aquarua7: folds 
cap. marb: folds 
ApkawaDavit: folds 
fireball2112: raises €1 to €2
Nunzio1985ct: folds 
Ouga Buga: calls €2
matiko09: folds 
Racushniak: calls €1
*** FLOP *** [5h 3c Jd]
Racushniak: checks 
fireball2112: bets €3
Ouga Buga: folds 
Racushniak: calls €3
*** TURN *** [5h 3c Jd] [9c]
Racushniak: checks 
fireball2112: bets €5
Racushniak: raises €19.69 to €24.69
fireball2112: folds 
Uncalled bet (€19.69) returned to Racushniak
Racushniak collected €21.38 from pot
Racushniak: doesn't show hand 
*** SUMMARY ***
Total pot €22.50 | Rake €1.12 
Board [5h 3c Jd 9c]
Seat 1: aquarua7 folded before Flop (didn't bet)
Seat 2: cap. marb folded before Flop (didn't bet)
Seat 3: ApkawaDavit folded before Flop (didn't bet)
Seat 4: fireball2112 folded on the Turn
Seat 6: Nunzio1985ct folded before Flop (didn't bet)
Seat 7: Ouga Buga (button) folded on the Flop
Seat 8: matiko09 (small blind) folded before Flop
Seat 9: Racushniak (big blind) collected (€21.38)





PokerStars Hand #152661526178:  Hold'em No Limit ($0.50/$1.00 USD) - 2016/04/30 18:17:52 CET [2016/04/30 12:17:52 ET]
Table 'Raissa II' 9-max Seat #4 is the button
Seat 1: cap. marb ($40 in chips) 
Seat 2: azzad2007 ($122.90 in chips) 
Seat 3: iRivuLose ($100 in chips) 
Seat 4: koksskrt ($100 in chips) 
Seat 5: korlito69 ($49 in chips) 
Seat 6: hurtNCYDE ($100 in chips) 
Seat 7: matiko09 ($101.50 in chips) 
Seat 8: Khaine_CM ($101.50 in chips) 
Seat 9: ApkawaDavit ($130.13 in chips) 
korlito69: posts small blind $0.50
hurtNCYDE: posts big blind $1
iRivuLose: posts big blind $1
*** HOLE CARDS ***
Dealt to matiko09 [4s 2c]
matiko09: folds 
Khaine_CM: folds 
ApkawaDavit: folds 
cap. marb: folds 
azzad2007: folds 
iRivuLose: raises $1.10 to $2.10
koksskrt: folds 
korlito69: folds 
hurtNCYDE: calls $1.10
*** FLOP *** [7h Kc 7s]
hurtNCYDE: checks 
iRivuLose: bets $2.05
hurtNCYDE: calls $2.05
*** TURN *** [7h Kc 7s] [Td]
hurtNCYDE: checks 
iRivuLose: checks 
*** RIVER *** [7h Kc 7s Td] [Kh]
hurtNCYDE: checks 
iRivuLose: bets $4.18
hurtNCYDE: folds 
Uncalled bet ($4.18) returned to iRivuLose
iRivuLose collected $8.36 from pot
iRivuLose: doesn't show hand 
*** SUMMARY ***
Total pot $8.80 | Rake $0.44 
Board [7h Kc 7s Td Kh]
Seat 1: cap. marb folded before Flop (didn't bet)
Seat 2: azzad2007 folded before Flop (didn't bet)
Seat 3: iRivuLose collected ($8.36)
Seat 4: koksskrt (button) folded before Flop (didn't bet)
Seat 5: korlito69 (small blind) folded before Flop
Seat 6: hurtNCYDE (big blind) folded on the River
Seat 7: matiko09 folded before Flop (didn't bet)
Seat 8: Khaine_CM folded before Flop (didn't bet)
Seat 9: ApkawaDavit folded before Flop (didn't bet)





PokerStars Hand #152661530368:  Hold'em No Limit ($0.50/$1.00 USD) - 2016/04/30 18:17:58 CET [2016/04/30 12:17:58 ET]
Table 'Arcturus' 9-max Seat #2 is the button
Seat 1: matiko09 ($100 in chips) 
Seat 2: Khaine_CM ($127.97 in chips) 
Seat 3: Spid1 ($108.20 in chips) 
Seat 4: cap. marb ($49.38 in chips) 
Seat 6: JimineyCrik ($179.84 in chips) 
Seat 7: terrytsui111 ($167.41 in chips) 
Seat 8: ApkawaDavit ($100 in chips) 
Seat 9: fishkida ($102.45 in chips) 
Spid1: posts small blind $0.50
cap. marb: posts big blind $1
Ilov3NBA: sits out 
*** HOLE CARDS ***
Dealt to matiko09 [3d 9c]
JimineyCrik: folds 
terrytsui111: folds 
ApkawaDavit: folds 
fishkida: folds 
matiko09: folds 
Khaine_CM: raises $1 to $2
Spid1: folds 
JimineyCrik leaves the table
Bailey Dew joins the table at seat #6 
cap. marb: folds 
Uncalled bet ($1) returned to Khaine_CM
Khaine_CM collected $2.50 from pot
Khaine_CM: doesn't show hand 
*** SUMMARY ***
Total pot $2.50 | Rake $0 
Seat 1: matiko09 folded before Flop (didn't bet)
Seat 2: Khaine_CM (button) collected ($2.50)
Seat 3: Spid1 (small blind) folded before Flop
Seat 4: cap. marb (big blind) folded before Flop
Seat 6: JimineyCrik folded before Flop (didn't bet)
Seat 7: terrytsui111 folded before Flop (didn't bet)
Seat 8: ApkawaDavit folded before Flop (didn't bet)
Seat 9: fishkida folded before Flop (didn't bet)





PokerStars Hand #152661547975:  Hold'em No Limit ($0.50/$1.00 USD) - 2016/04/30 18:18:21 CET [2016/04/30 12:18:21 ET]
Table 'Arcturus' 9-max Seat #3 is the button
Seat 1: matiko09 ($100 in chips) 
Seat 2: Khaine_CM ($129.47 in chips) 
Seat 3: Spid1 ($107.70 in chips) 
Seat 4: cap. marb ($48.38 in chips) 
Seat 5: Ilov3NBA ($100 in chips) 
Seat 7: terrytsui111 ($167.41 in chips) 
Seat 8: ApkawaDavit ($100 in chips) 
Seat 9: fishkida ($102.45 in chips) 
cap. marb: posts small blind $0.50
Ilov3NBA: posts big blind $1
*** HOLE CARDS ***
Dealt to matiko09 [7h 9h]
terrytsui111: raises $4 to $5
Bailey Dew leaves the table
ApkawaDavit: folds 
fishkida: folds 
WrongButton joins the table at seat #6 
matiko09: folds 
Khaine_CM: folds 
Spid1: folds 
cap. marb: folds 
Ilov3NBA: folds 
Uncalled bet ($4) returned to terrytsui111
terrytsui111 collected $2.50 from pot
terrytsui111: doesn't show hand 
*** SUMMARY ***
Total pot $2.50 | Rake $0 
Seat 1: matiko09 folded before Flop (didn't bet)
Seat 2: Khaine_CM folded before Flop (didn't bet)
Seat 3: Spid1 (button) folded before Flop (didn't bet)
Seat 4: cap. marb (small blind) folded before Flop
Seat 5: Ilov3NBA (big blind) folded before Flop
Seat 7: terrytsui111 collected ($2.50)
Seat 8: ApkawaDavit folded before Flop (didn't bet)
Seat 9: fishkida folded before Flop (didn't bet)





PokerStars Hand #152661555593:  Hold'em No Limit ($0.50/$1.00 USD) - 2016/04/30 18:18:31 CET [2016/04/30 12:18:31 ET]
Table 'Lova II' 9-max Seat #2 is the button
Seat 2: bilukm ($272.70 in chips) 
Seat 3: matiko09 ($100.50 in chips) 
Seat 4: VanDobeln ($133.66 in chips) 
Seat 5: Ilov3NBA ($103 in chips) 
Seat 6: di0d80 ($115.79 in chips) 
Seat 7: meysam270 ($40.93 in chips) 
Seat 8: cap. marb ($53.79 in chips) 
Seat 9: hurtNCYDE ($101.50 in chips) 
matiko09: posts small blind $0.50
VanDobeln: posts big blind $1
*** HOLE CARDS ***
Dealt to matiko09 [6s Ac]
Ilov3NBA: folds 
Bailey Dew leaves the table
di0d80: folds 
meysam270: folds 
RoadtoNepal joins the table at seat #1 
cap. marb: folds 
hurtNCYDE: folds 
bilukm: raises $1 to $2
matiko09: folds 
VanDobeln: calls $1
*** FLOP *** [4h 4c 2c]
VanDobeln: checks 
bilukm: checks 
*** TURN *** [4h 4c 2c] [Jh]
VanDobeln: bets $3.21
bilukm: calls $3.21
*** RIVER *** [4h 4c 2c Jh] [4s]
VanDobeln: checks 
bilukm: checks 
*** SHOW DOWN ***
VanDobeln: shows [5d 5h] (a full house, Fours full of Fives)
bilukm: shows [Qc Js] (a full house, Fours full of Jacks)
bilukm collected $10.37 from pot
*** SUMMARY ***
Total pot $10.92 | Rake $0.55 
Board [4h 4c 2c Jh 4s]
Seat 2: bilukm (button) showed [Qc Js] and won ($10.37) with a full house, Fours full of Jacks
Seat 3: matiko09 (small blind) folded before Flop
Seat 4: VanDobeln (big blind) showed [5d 5h] and lost with a full house, Fours full of Fives
Seat 5: Ilov3NBA folded before Flop (didn't bet)
Seat 6: di0d80 folded before Flop (didn't bet)
Seat 7: meysam270 folded before Flop (didn't bet)
Seat 8: cap. marb folded before Flop (didn't bet)
Seat 9: hurtNCYDE folded before Flop (didn't bet)





PokerStars Hand #152661560108:  Hold'em No Limit ($0.50/$1.00 USD) - 2016/04/30 18:18:37 CET [2016/04/30 12:18:37 ET]
Table 'Malautra II' 9-max Seat #2 is the button
Seat 2: Ilov3NBA ($104.30 in chips) 
Seat 3: t.sneijder ($60.85 in chips) 
Seat 5: hurtNCYDE ($100 in chips) 
Seat 6: matiko09 ($103 in chips) 
Seat 7: poker-rat95 ($99.25 in chips) 
Seat 8: Nito Lansky ($77 in chips) 
Seat 9: cap. marb ($40 in chips) 
t.sneijder: posts small blind $0.50
Khaine_CM: is sitting out 
hurtNCYDE: posts big blind $1
Khaine_CM leaves the table
Fivez: sits out 
*** HOLE CARDS ***
Dealt to matiko09 [Qh 8s]
matiko09: folds 
poker-rat95: calls $1
Nito Lansky: calls $1
cap. marb: folds 
Ilov3NBA: folds 
t.sneijder: raises $2 to $3
hurtNCYDE: folds 
poker-rat95: calls $2
Nito Lansky: calls $2
*** FLOP *** [3d 2c 6d]
t.sneijder: bets $2
poker-rat95: calls $2
Nito Lansky: calls $2
*** TURN *** [3d 2c 6d] [Qd]
RoadtoNepal joins the table at seat #4 
t.sneijder: checks 
poker-rat95: bets $8
Nito Lansky: folds 
t.sneijder: folds 
Uncalled bet ($8) returned to poker-rat95
poker-rat95 collected $15.20 from pot
poker-rat95: doesn't show hand 
*** SUMMARY ***
Total pot $16 | Rake $0.80 
Board [3d 2c 6d Qd]
Seat 2: Ilov3NBA (button) folded before Flop (didn't bet)
Seat 3: t.sneijder (small blind) folded on the Turn
Seat 5: hurtNCYDE (big blind) folded before Flop
Seat 6: matiko09 folded before Flop (didn't bet)
Seat 7: poker-rat95 collected ($15.20)
Seat 8: Nito Lansky folded on the Turn
Seat 9: cap. marb folded before Flop (didn't bet)





PokerStars Hand #152661575482:  Hold'em No Limit ($0.50/$1.00 USD) - 2016/04/30 18:18:57 CET [2016/04/30 12:18:57 ET]
Table 'Arcturus' 9-max Seat #4 is the button
Seat 1: matiko09 ($100 in chips) 
Seat 2: Khaine_CM ($129.47 in chips) 
Seat 3: Spid1 ($107.70 in chips) 
Seat 4: cap. marb ($47.88 in chips) 
Seat 5: Ilov3NBA ($100 in chips) 
Seat 6: WrongButton ($100 in chips) 
Seat 7: terrytsui111 ($168.91 in chips) 
Seat 8: ApkawaDavit ($100 in chips) 
Seat 9: fishkida ($102.45 in chips) 
Ilov3NBA: posts small blind $0.50
WrongButton: posts big blind $1
*** HOLE CARDS ***
Dealt to matiko09 [4c 6h]
terrytsui111: folds 
ApkawaDavit: folds 
fishkida: folds 
matiko09: folds 
Khaine_CM: folds 
Spid1: raises $1.50 to $2.50
cap. marb: folds 
Ilov3NBA: folds 
WrongButton: folds 
Uncalled bet ($1.50) returned to Spid1
Spid1 collected $2.50 from pot
Spid1: doesn't show hand 
*** SUMMARY ***
Total pot $2.50 | Rake $0 
Seat 1: matiko09 folded before Flop (didn't bet)
Seat 2: Khaine_CM folded before Flop (didn't bet)
Seat 3: Spid1 collected ($2.50)
Seat 4: cap. marb (button) folded before Flop (didn't bet)
Seat 5: Ilov3NBA (small blind) folded before Flop
Seat 6: WrongButton (big blind) folded before Flop
Seat 7: terrytsui111 folded before Flop (didn't bet)
Seat 8: ApkawaDavit folded before Flop (didn't bet)
Seat 9: fishkida folded before Flop (didn't bet)





PokerStars Hand #152661597167:  Hold'em No Limit (€0.50/€1.00 EUR) - 2016/04/30 18:19:25 CET [2016/04/30 12:19:25 ET]
Table 'Benda' 9-max Seat #8 is the button
Seat 1: aquarua7 (€222.41 in chips) 
Seat 2: cap. marb (€35.50 in chips) 
Seat 3: ApkawaDavit (€107.70 in chips) 
Seat 4: fireball2112 (€72.90 in chips) 
Seat 6: Nunzio1985ct (€35.41 in chips) 
Seat 7: Ouga Buga (€100.18 in chips) 
Seat 8: matiko09 (€101 in chips) 
Seat 9: Racushniak (€154.95 in chips) 
Racushniak: posts small blind €0.50
aquarua7: posts big blind €1
hurtNCYDE: sits out 
*** HOLE CARDS ***
Dealt to matiko09 [5s Qc]
cap. marb: folds 
ApkawaDavit: folds 
fireball2112: raises €2 to €3
Nunzio1985ct: folds 
Ouga Buga: folds 
matiko09: folds 
Racushniak: folds 
aquarua7: calls €2
*** FLOP *** [Jh 7c 5h]
aquarua7: checks 
fireball2112: bets €4
aquarua7: calls €4
*** TURN *** [Jh 7c 5h] [9h]
aquarua7: checks 
fireball2112: bets €5
aquarua7: folds 
Uncalled bet (€5) returned to fireball2112
fireball2112 collected €13.78 from pot
fireball2112: doesn't show hand 
*** SUMMARY ***
Total pot €14.50 | Rake €0.72 
Board [Jh 7c 5h 9h]
Seat 1: aquarua7 (big blind) folded on the Turn
Seat 2: cap. marb folded before Flop (didn't bet)
Seat 3: ApkawaDavit folded before Flop (didn't bet)
Seat 4: fireball2112 collected (€13.78)
Seat 6: Nunzio1985ct folded before Flop (didn't bet)
Seat 7: Ouga Buga folded before Flop (didn't bet)
Seat 8: matiko09 (button) folded before Flop (didn't bet)
Seat 9: Racushniak (small blind) folded before Flop





PokerStars Hand #152661598331:  Hold'em No Limit ($0.50/$1.00 USD) - 2016/04/30 18:19:27 CET [2016/04/30 12:19:27 ET]
Table 'Lova II' 9-max Seat #3 is the button
Seat 2: bilukm ($277.86 in chips) 
Seat 3: matiko09 ($100 in chips) 
Seat 4: VanDobeln ($128.45 in chips) 
Seat 5: Ilov3NBA ($103 in chips) 
Seat 6: di0d80 ($115.79 in chips) 
Seat 7: meysam270 ($40.93 in chips) 
Seat 8: cap. marb ($53.79 in chips) 
Seat 9: hurtNCYDE ($101.50 in chips) 
VanDobeln: posts small blind $0.50
Ilov3NBA: posts big blind $1
RoadtoNepal: sits out 
*** HOLE CARDS ***
Dealt to matiko09 [5h Ad]
di0d80: folds 
meysam270: folds 
cap. marb: raises $1.12 to $2.12
hurtNCYDE: folds 
bilukm: folds 
matiko09: folds 
VanDobeln: folds 
Ilov3NBA: folds 
Uncalled bet ($1.12) returned to cap. marb
cap. marb collected $2.50 from pot
cap. marb: doesn't show hand 
*** SUMMARY ***
Total pot $2.50 | Rake $0 
Seat 2: bilukm folded before Flop (didn't bet)
Seat 3: matiko09 (button) folded before Flop (didn't bet)
Seat 4: VanDobeln (small blind) folded before Flop
Seat 5: Ilov3NBA (big blind) folded before Flop
Seat 6: di0d80 folded before Flop (didn't bet)
Seat 7: meysam270 folded before Flop (didn't bet)
Seat 8: cap. marb collected ($2.50)
Seat 9: hurtNCYDE folded before Flop (didn't bet)





PokerStars Hand #152661603925:  Hold'em No Limit ($0.50/$1.00 USD) - 2016/04/30 18:19:34 CET [2016/04/30 12:19:34 ET]
Table 'Raissa II' 9-max Seat #5 is the button
Seat 1: cap. marb ($40 in chips) 
Seat 2: azzad2007 ($122.90 in chips) 
Seat 3: iRivuLose ($104.21 in chips) 
Seat 4: koksskrt ($100 in chips) 
Seat 5: korlito69 ($48.50 in chips) 
Seat 6: hurtNCYDE ($100 in chips) 
Seat 7: matiko09 ($101.50 in chips) 
Seat 8: Khaine_CM ($101.50 in chips) 
Seat 9: ApkawaDavit ($130.13 in chips) 
hurtNCYDE: posts small blind $0.50
matiko09: posts big blind $1
*** HOLE CARDS ***
Dealt to matiko09 [2d 3h]
Khaine_CM: folds 
ApkawaDavit: folds 
cap. marb: folds 
azzad2007: folds 
iRivuLose: folds 
koksskrt: folds 
korlito69: raises $3 to $4
hurtNCYDE: calls $3.50
matiko09: folds 
*** FLOP *** [7c 2h 8d]
hurtNCYDE: checks 
korlito69: checks 
*** TURN *** [7c 2h 8d] [Ks]
hurtNCYDE: checks 
korlito69: bets $4
hurtNCYDE: folds 
Uncalled bet ($4) returned to korlito69
korlito69 collected $8.55 from pot
korlito69: doesn't show hand 
*** SUMMARY ***
Total pot $9 | Rake $0.45 
Board [7c 2h 8d Ks]
Seat 1: cap. marb folded before Flop (didn't bet)
Seat 2: azzad2007 folded before Flop (didn't bet)
Seat 3: iRivuLose folded before Flop (didn't bet)
Seat 4: koksskrt folded before Flop (didn't bet)
Seat 5: korlito69 (button) collected ($8.55)
Seat 6: hurtNCYDE (small blind) folded on the Turn
Seat 7: matiko09 (big blind) folded before Flop
Seat 8: Khaine_CM folded before Flop (didn't bet)
Seat 9: ApkawaDavit folded before Flop (didn't bet)





PokerStars Hand #152661609402:  Hold'em No Limit ($0.50/$1.00 USD) - 2016/04/30 18:19:41 CET [2016/04/30 12:19:41 ET]
Table 'Malautra II' 9-max Seat #3 is the button
Seat 2: Ilov3NBA ($104.30 in chips) 
Seat 3: t.sneijder ($55.85 in chips) 
Seat 5: hurtNCYDE ($100 in chips) 
Seat 6: matiko09 ($103 in chips) 
Seat 7: poker-rat95 ($109.45 in chips) 
Seat 8: Nito Lansky ($72 in chips) 
Seat 9: cap. marb ($40 in chips) 
RoadtoNepal will be allowed to play after the button
hurtNCYDE: posts small blind $0.50
matiko09: posts big blind $1
Fivez: sits out 
*** HOLE CARDS ***
Dealt to matiko09 [8d 9s]
poker-rat95: folds 
Nito Lansky: folds 
cap. marb: folds 
Ilov3NBA: raises $1.50 to $2.50
t.sneijder: calls $2.50
hurtNCYDE: folds 
matiko09: folds 
*** FLOP *** [3d 9c 5h]
Ilov3NBA: bets $3.39
t.sneijder: calls $3.39
*** TURN *** [3d 9c 5h] [7s]
Ilov3NBA: checks 
t.sneijder: bets $9
Ilov3NBA: calls $9
*** RIVER *** [3d 9c 5h 7s] [8h]
Ilov3NBA: checks 
t.sneijder: checks 
*** SHOW DOWN ***
Ilov3NBA: shows [7h Jh] (a pair of Sevens)
t.sneijder: mucks hand 
Ilov3NBA collected $29.72 from pot
*** SUMMARY ***
Total pot $31.28 | Rake $1.56 
Board [3d 9c 5h 7s 8h]
Seat 2: Ilov3NBA showed [7h Jh] and won ($29.72) with a pair of Sevens
Seat 3: t.sneijder (button) mucked [Jd Ah]
Seat 5: hurtNCYDE (small blind) folded before Flop
Seat 6: matiko09 (big blind) folded before Flop
Seat 7: poker-rat95 folded before Flop (didn't bet)
Seat 8: Nito Lansky folded before Flop (didn't bet)
Seat 9: cap. marb folded before Flop (didn't bet)





PokerStars Hand #152661611510:  Hold'em No Limit ($0.50/$1.00 USD) - 2016/04/30 18:19:44 CET [2016/04/30 12:19:44 ET]
Table 'Arcturus' 9-max Seat #5 is the button
Seat 1: matiko09 ($100 in chips) 
Seat 2: Khaine_CM ($129.47 in chips) 
Seat 3: Spid1 ($109.20 in chips) 
Seat 4: cap. marb ($47.88 in chips) 
Seat 5: Ilov3NBA ($100 in chips) 
Seat 6: WrongButton ($100 in chips) 
Seat 7: terrytsui111 ($168.91 in chips) 
Seat 8: ApkawaDavit ($100 in chips) 
Seat 9: fishkida ($102.45 in chips) 
WrongButton: posts small blind $0.50
terrytsui111: posts big blind $1
*** HOLE CARDS ***
Dealt to matiko09 [3s 2s]
ApkawaDavit: raises $2 to $3
fishkida: folds 
matiko09: folds 
Khaine_CM: folds 
Spid1: folds 
cap. marb: folds 
Ilov3NBA: folds 
WrongButton: folds 
terrytsui111: calls $2
*** FLOP *** [Td 6s Qc]
terrytsui111: checks 
ApkawaDavit: bets $4
terrytsui111: folds 
Uncalled bet ($4) returned to ApkawaDavit
ApkawaDavit collected $6.18 from pot
ApkawaDavit: doesn't show hand 
*** SUMMARY ***
Total pot $6.50 | Rake $0.32 
Board [Td 6s Qc]
Seat 1: matiko09 folded before Flop (didn't bet)
Seat 2: Khaine_CM folded before Flop (didn't bet)
Seat 3: Spid1 folded before Flop (didn't bet)
Seat 4: cap. marb folded before Flop (didn't bet)
Seat 5: Ilov3NBA (button) folded before Flop (didn't bet)
Seat 6: WrongButton (small blind) folded before Flop
Seat 7: terrytsui111 (big blind) folded on the Flop
Seat 8: ApkawaDavit collected ($6.18)
Seat 9: fishkida folded before Flop (didn't bet)





PokerStars Hand #152661632639:  Hold'em No Limit ($0.50/$1.00 USD) - 2016/04/30 18:20:12 CET [2016/04/30 12:20:12 ET]
Table 'Arcturus' 9-max Seat #6 is the button
Seat 1: matiko09 ($100 in chips) 
Seat 2: Khaine_CM ($129.47 in chips) 
Seat 3: Spid1 ($109.20 in chips) 
Seat 4: cap. marb ($47.88 in chips) 
Seat 5: Ilov3NBA ($100 in chips) 
Seat 6: WrongButton ($100 in chips) 
Seat 7: terrytsui111 ($165.91 in chips) 
Seat 8: ApkawaDavit ($103.18 in chips) 
Seat 9: fishkida ($102.45 in chips) 
terrytsui111: posts small blind $0.50
ApkawaDavit: posts big blind $1
*** HOLE CARDS ***
Dealt to matiko09 [Ts 6c]
fishkida: folds 
matiko09: folds 
Khaine_CM: folds 
Spid1: folds 
cap. marb: folds 
Ilov3NBA: folds 
WrongButton: raises $1 to $2
terrytsui111: calls $1.50
ApkawaDavit: folds 
*** FLOP *** [3c 5d 9c]
terrytsui111: bets $5
WrongButton: folds 
Uncalled bet ($5) returned to terrytsui111
terrytsui111 collected $4.75 from pot
terrytsui111: doesn't show hand 
*** SUMMARY ***
Total pot $5 | Rake $0.25 
Board [3c 5d 9c]
Seat 1: matiko09 folded before Flop (didn't bet)
Seat 2: Khaine_CM folded before Flop (didn't bet)
Seat 3: Spid1 folded before Flop (didn't bet)
Seat 4: cap. marb folded before Flop (didn't bet)
Seat 5: Ilov3NBA folded before Flop (didn't bet)
Seat 6: WrongButton (button) folded on the Flop
Seat 7: terrytsui111 (small blind) collected ($4.75)
Seat 8: ApkawaDavit (big blind) folded before Flop
Seat 9: fishkida folded before Flop (didn't bet)





PokerStars Hand #152661637406:  Hold'em No Limit ($0.50/$1.00 USD) - 2016/04/30 18:20:18 CET [2016/04/30 12:20:18 ET]
Table 'Lova II' 9-max Seat #4 is the button
Seat 2: bilukm ($277.86 in chips) 
Seat 3: matiko09 ($100 in chips) 
Seat 4: VanDobeln ($127.95 in chips) 
Seat 5: Ilov3NBA ($102 in chips) 
Seat 6: di0d80 ($115.79 in chips) 
Seat 7: meysam270 ($40.93 in chips) 
Seat 8: cap. marb ($55.29 in chips) 
Seat 9: hurtNCYDE ($101.50 in chips) 
Ilov3NBA: posts small blind $0.50
di0d80: posts big blind $1
RoadtoNepal: sits out 
*** HOLE CARDS ***
Dealt to matiko09 [9h As]
meysam270: folds 
cap. marb: folds 
hurtNCYDE: folds 
bilukm: folds 
matiko09: raises $1.50 to $2.50
VanDobeln: folds 
Ilov3NBA: folds 
di0d80: calls $1.50
*** FLOP *** [Jc Ah 9d]
di0d80: checks 
matiko09: bets $3.39
di0d80: folds 
Uncalled bet ($3.39) returned to matiko09
matiko09 collected $5.22 from pot
matiko09: doesn't show hand 
*** SUMMARY ***
Total pot $5.50 | Rake $0.28 
Board [Jc Ah 9d]
Seat 2: bilukm folded before Flop (didn't bet)
Seat 3: matiko09 collected ($5.22)
Seat 4: VanDobeln (button) folded before Flop (didn't bet)
Seat 5: Ilov3NBA (small blind) folded before Flop
Seat 6: di0d80 (big blind) folded on the Flop
Seat 7: meysam270 folded before Flop (didn't bet)
Seat 8: cap. marb folded before Flop (didn't bet)
Seat 9: hurtNCYDE folded before Flop (didn't bet)





PokerStars Hand #152661658092:  Hold'em No Limit ($0.50/$1.00 USD) - 2016/04/30 18:20:46 CET [2016/04/30 12:20:46 ET]
Table 'Arcturus' 9-max Seat #7 is the button
Seat 1: matiko09 ($100 in chips) 
Seat 2: Khaine_CM ($129.47 in chips) 
Seat 3: Spid1 ($109.20 in chips) 
Seat 4: cap. marb ($47.88 in chips) 
Seat 5: Ilov3NBA ($100 in chips) 
Seat 6: WrongButton ($100 in chips) 
Seat 7: terrytsui111 ($168.66 in chips) 
Seat 8: ApkawaDavit ($102.18 in chips) 
Seat 9: fishkida ($102.45 in chips) 
ApkawaDavit: posts small blind $0.50
fishkida: posts big blind $1
*** HOLE CARDS ***
Dealt to matiko09 [5c 9d]
matiko09: folds 
Khaine_CM: folds 
Spid1: folds 
cap. marb: folds 
Ilov3NBA: raises $2 to $3
WrongButton: folds 
terrytsui111: calls $3
ApkawaDavit: folds 
fishkida: folds 
*** FLOP *** [5h 3c 7s]
Ilov3NBA: bets $3.91
terrytsui111: folds 
Uncalled bet ($3.91) returned to Ilov3NBA
Ilov3NBA collected $7.12 from pot
Ilov3NBA: doesn't show hand 
*** SUMMARY ***
Total pot $7.50 | Rake $0.38 
Board [5h 3c 7s]
Seat 1: matiko09 folded before Flop (didn't bet)
Seat 2: Khaine_CM folded before Flop (didn't bet)
Seat 3: Spid1 folded before Flop (didn't bet)
Seat 4: cap. marb folded before Flop (didn't bet)
Seat 5: Ilov3NBA collected ($7.12)
Seat 6: WrongButton folded before Flop (didn't bet)
Seat 7: terrytsui111 (button) folded on the Flop
Seat 8: ApkawaDavit (small blind) folded before Flop
Seat 9: fishkida (big blind) folded before Flop





PokerStars Hand #152661660196:  Hold'em No Limit ($0.50/$1.00 USD) - 2016/04/30 18:20:48 CET [2016/04/30 12:20:48 ET]
Table 'Raissa II' 9-max Seat #6 is the button
Seat 1: cap. marb ($40 in chips) 
Seat 2: azzad2007 ($122.90 in chips) 
Seat 3: iRivuLose ($104.21 in chips) 
Seat 4: koksskrt ($100 in chips) 
Seat 5: korlito69 ($53.05 in chips) 
Seat 6: hurtNCYDE ($100 in chips) 
Seat 7: matiko09 ($100.50 in chips) 
matiko09: posts small blind $0.50
Khaine_CM: is sitting out 
Khaine_CM leaves the table
ApkawaDavit: is sitting out 
ApkawaDavit leaves the table
cap. marb: posts big blind $1
*** HOLE CARDS ***
Dealt to matiko09 [Td Js]
Pacifistas joins the table at seat #8 
Ilov3NBA joins the table at seat #9 
azzad2007: folds 
iRivuLose: folds 
koksskrt: folds 
korlito69: calls $1
hurtNCYDE: folds 
matiko09: calls $0.50
cap. marb: checks 
*** FLOP *** [5c 5d 9d]
matiko09: bets $1.85
cap. marb: folds 
korlito69: folds 
Uncalled bet ($1.85) returned to matiko09
matiko09 collected $2.85 from pot
matiko09: doesn't show hand 
*** SUMMARY ***
Total pot $3 | Rake $0.15 
Board [5c 5d 9d]
Seat 1: cap. marb (big blind) folded on the Flop
Seat 2: azzad2007 folded before Flop (didn't bet)
Seat 3: iRivuLose folded before Flop (didn't bet)
Seat 4: koksskrt folded before Flop (didn't bet)
Seat 5: korlito69 folded on the Flop
Seat 6: hurtNCYDE (button) folded before Flop (didn't bet)
Seat 7: matiko09 (small blind) collected ($2.85)





PokerStars Hand #152661660354:  Hold'em No Limit (€0.50/€1.00 EUR) - 2016/04/30 18:20:49 CET [2016/04/30 12:20:49 ET]
Table 'Benda' 9-max Seat #9 is the button
Seat 1: aquarua7 (€215.41 in chips) 
Seat 2: cap. marb (€35.50 in chips) 
Seat 3: ApkawaDavit (€107.70 in chips) 
Seat 4: fireball2112 (€79.68 in chips) 
Seat 6: Nunzio1985ct (€35.41 in chips) 
Seat 7: Ouga Buga (€100.18 in chips) 
Seat 8: matiko09 (€101 in chips) 
Seat 9: Racushniak (€154.45 in chips) 
aquarua7: posts small blind €0.50
cap. marb: posts big blind €1
hurtNCYDE: sits out 
*** HOLE CARDS ***
Dealt to matiko09 [8c 7h]
ApkawaDavit: folds 
fireball2112: folds 
Nunzio1985ct has timed out
Nunzio1985ct: folds 
Ouga Buga: folds 
matiko09: folds 
Racushniak: folds 
aquarua7: calls €0.50
cap. marb: checks 
*** FLOP *** [7d Kc 7s]
aquarua7: bets €1
cap. marb: folds 
Uncalled bet (€1) returned to aquarua7
aquarua7 collected €1.90 from pot
aquarua7: doesn't show hand 
*** SUMMARY ***
Total pot €2 | Rake €0.10 
Board [7d Kc 7s]
Seat 1: aquarua7 (small blind) collected (€1.90)
Seat 2: cap. marb (big blind) folded on the Flop
Seat 3: ApkawaDavit folded before Flop (didn't bet)
Seat 4: fireball2112 folded before Flop (didn't bet)
Seat 6: Nunzio1985ct folded before Flop (didn't bet)
Seat 7: Ouga Buga folded before Flop (didn't bet)
Seat 8: matiko09 folded before Flop (didn't bet)
Seat 9: Racushniak (button) folded before Flop (didn't bet)





PokerStars Hand #152661669313:  Hold'em No Limit ($0.50/$1.00 USD) - 2016/04/30 18:21:00 CET [2016/04/30 12:21:00 ET]
Table 'Lova II' 9-max Seat #5 is the button
Seat 2: bilukm ($277.86 in chips) 
Seat 3: matiko09 ($102.72 in chips) 
Seat 4: VanDobeln ($127.95 in chips) 
Seat 5: Ilov3NBA ($101.50 in chips) 
Seat 6: di0d80 ($113.29 in chips) 
Seat 7: meysam270 ($40.93 in chips) 
Seat 8: cap. marb ($55.29 in chips) 
Seat 9: hurtNCYDE ($101.50 in chips) 
di0d80: posts small blind $0.50
meysam270: posts big blind $1
RoadtoNepal: sits out 
*** HOLE CARDS ***
Dealt to matiko09 [3c 8c]
cap. marb: folds 
hurtNCYDE: folds 
bilukm: folds 
matiko09: folds 
VanDobeln: folds 
Ilov3NBA: raises $1 to $2
di0d80: folds 
meysam270: raises $4.50 to $6.50
Ilov3NBA: folds 
Uncalled bet ($4.50) returned to meysam270
meysam270 collected $4.50 from pot
meysam270: doesn't show hand 
*** SUMMARY ***
Total pot $4.50 | Rake $0 
Seat 2: bilukm folded before Flop (didn't bet)
Seat 3: matiko09 folded before Flop (didn't bet)
Seat 4: VanDobeln folded before Flop (didn't bet)
Seat 5: Ilov3NBA (button) folded before Flop
Seat 6: di0d80 (small blind) folded before Flop
Seat 7: meysam270 (big blind) collected ($4.50)
Seat 8: cap. marb folded before Flop (didn't bet)
Seat 9: hurtNCYDE folded before Flop (didn't bet)





PokerStars Hand #152661674702:  Hold'em No Limit ($0.50/$1.00 USD) - 2016/04/30 18:21:08 CET [2016/04/30 12:21:08 ET]
Table 'Malautra II' 9-max Seat #5 is the button
Seat 2: Ilov3NBA ($119.13 in chips) 
Seat 3: t.sneijder ($40.96 in chips) 
Seat 5: hurtNCYDE ($100 in chips) 
Seat 6: matiko09 ($102 in chips) 
Seat 7: poker-rat95 ($109.45 in chips) 
Seat 8: Nito Lansky ($72 in chips) 
Seat 9: cap. marb ($40 in chips) 
matiko09: posts small blind $0.50
poker-rat95: posts big blind $1
Fivez: sits out 
RoadtoNepal: sits out 
*** HOLE CARDS ***
Dealt to matiko09 [6d 9c]
Nito Lansky: folds 
cap. marb: folds 
Ilov3NBA: raises $2 to $3
t.sneijder: calls $3
hurtNCYDE: folds 
matiko09: folds 
poker-rat95: calls $2
*** FLOP *** [8s 5d Qd]
poker-rat95: checks 
Ilov3NBA: bets $6.67
t.sneijder: calls $6.67
poker-rat95: calls $6.67
*** TURN *** [8s 5d Qd] [Ah]
poker-rat95: checks 
Ilov3NBA: checks 
t.sneijder: bets $12
poker-rat95: folds 
Ilov3NBA: folds 
Uncalled bet ($12) returned to t.sneijder
t.sneijder collected $28.03 from pot
t.sneijder: doesn't show hand 
*** SUMMARY ***
Total pot $29.51 | Rake $1.48 
Board [8s 5d Qd Ah]
Seat 2: Ilov3NBA folded on the Turn
Seat 3: t.sneijder collected ($28.03)
Seat 5: hurtNCYDE (button) folded before Flop (didn't bet)
Seat 6: matiko09 (small blind) folded before Flop
Seat 7: poker-rat95 (big blind) folded on the Turn
Seat 8: Nito Lansky folded before Flop (didn't bet)
Seat 9: cap. marb folded before Flop (didn't bet)





PokerStars Hand #152661694725:  Hold'em No Limit ($0.50/$1.00 USD) - 2016/04/30 18:21:34 CET [2016/04/30 12:21:34 ET]
Table 'Lova II' 9-max Seat #6 is the button
Seat 2: bilukm ($277.86 in chips) 
Seat 3: matiko09 ($102.72 in chips) 
Seat 4: VanDobeln ($127.95 in chips) 
Seat 5: Ilov3NBA ($100 in chips) 
Seat 6: di0d80 ($112.79 in chips) 
Seat 7: meysam270 ($43.43 in chips) 
Seat 8: cap. marb ($55.29 in chips) 
Seat 9: hurtNCYDE ($101.50 in chips) 
meysam270: posts small blind $0.50
cap. marb: posts big blind $1
RoadtoNepal: sits out 
*** HOLE CARDS ***
Dealt to matiko09 [Js 3c]
hurtNCYDE: folds 
bilukm: folds 
matiko09: folds 
VanDobeln: folds 
Ilov3NBA: raises $1.50 to $2.50
di0d80: calls $2.50
meysam270: folds 
cap. marb: folds 
*** FLOP *** [8h 5s 2c]
Ilov3NBA: bets $3.50
di0d80: calls $3.50
*** TURN *** [8h 5s 2c] [5c]
Ilov3NBA: bets $8.50
di0d80: calls $8.50
*** RIVER *** [8h 5s 2c 5c] [8s]
Ilov3NBA: bets $16.50
di0d80: raises $23.50 to $40
Ilov3NBA: raises $45.50 to $85.50 and is all-in
di0d80: calls $45.50
*** SHOW DOWN ***
Ilov3NBA: shows [5d 5h] (four of a kind, Fives)
di0d80: shows [7c 8c] (a full house, Eights full of Fives)
Ilov3NBA collected $199 from pot
*** SUMMARY ***
Total pot $201.50 | Rake $2.50 
Board [8h 5s 2c 5c 8s]
Seat 2: bilukm folded before Flop (didn't bet)
Seat 3: matiko09 folded before Flop (didn't bet)
Seat 4: VanDobeln folded before Flop (didn't bet)
Seat 5: Ilov3NBA showed [5d 5h] and won ($199) with four of a kind, Fives
Seat 6: di0d80 (button) showed [7c 8c] and lost with a full house, Eights full of Fives
Seat 7: meysam270 (small blind) folded before Flop
Seat 8: cap. marb (big blind) folded before Flop
Seat 9: hurtNCYDE folded before Flop (didn't bet)





PokerStars Hand #152661698174:  Hold'em No Limit ($0.50/$1.00 USD) - 2016/04/30 18:21:39 CET [2016/04/30 12:21:39 ET]
Table 'Arcturus' 9-max Seat #8 is the button
Seat 1: matiko09 ($100 in chips) 
Seat 2: Khaine_CM ($129.47 in chips) 
Seat 3: Spid1 ($109.20 in chips) 
Seat 4: cap. marb ($47.88 in chips) 
Seat 5: Ilov3NBA ($104.12 in chips) 
Seat 6: WrongButton ($100 in chips) 
Seat 7: terrytsui111 ($165.66 in chips) 
Seat 8: ApkawaDavit ($101.68 in chips) 
Seat 9: fishkida ($101.45 in chips) 
fishkida: posts small blind $0.50
matiko09: posts big blind $1
*** HOLE CARDS ***
Dealt to matiko09 [Ts 3s]
Khaine_CM: raises $2 to $3
Spid1: folds 
cap. marb: folds 
Ilov3NBA: folds 
WrongButton: folds 
terrytsui111: calls $3
ApkawaDavit: folds 
fishkida: folds 
matiko09: folds 
*** FLOP *** [2h 9s 5s]
Khaine_CM: bets $5
terrytsui111: folds 
Uncalled bet ($5) returned to Khaine_CM
Khaine_CM collected $7.12 from pot
Khaine_CM: doesn't show hand 
*** SUMMARY ***
Total pot $7.50 | Rake $0.38 
Board [2h 9s 5s]
Seat 1: matiko09 (big blind) folded before Flop
Seat 2: Khaine_CM collected ($7.12)
Seat 3: Spid1 folded before Flop (didn't bet)
Seat 4: cap. marb folded before Flop (didn't bet)
Seat 5: Ilov3NBA folded before Flop (didn't bet)
Seat 6: WrongButton folded before Flop (didn't bet)
Seat 7: terrytsui111 folded on the Flop
Seat 8: ApkawaDavit (button) folded before Flop (didn't bet)
Seat 9: fishkida (small blind) folded before Flop





PokerStars Hand #152661701801:  Hold'em No Limit ($0.50/$1.00 USD) - 2016/04/30 18:21:43 CET [2016/04/30 12:21:43 ET]
Table 'Raissa II' 9-max Seat #7 is the button
Seat 1: cap. marb ($39 in chips) 
Seat 2: azzad2007 ($122.90 in chips) 
Seat 3: iRivuLose ($104.21 in chips) 
Seat 4: koksskrt ($100 in chips) 
Seat 5: korlito69 ($52.05 in chips) 
Seat 6: hurtNCYDE ($100 in chips) 
Seat 7: matiko09 ($102.35 in chips) 
Ilov3NBA will be allowed to play after the button
cap. marb: posts small blind $0.50
azzad2007: posts big blind $1
*** HOLE CARDS ***
Dealt to matiko09 [Ac 9h]
iRivuLose: folds 
koksskrt: folds 
korlito69: calls $1
hurtNCYDE: folds 
matiko09: raises $3 to $4
cap. marb: folds 
azzad2007: folds 
korlito69: folds 
Uncalled bet ($3) returned to matiko09
matiko09 collected $3.50 from pot
matiko09: doesn't show hand 
*** SUMMARY ***
Total pot $3.50 | Rake $0 
Seat 1: cap. marb (small blind) folded before Flop
Seat 2: azzad2007 (big blind) folded before Flop
Seat 3: iRivuLose folded before Flop (didn't bet)
Seat 4: koksskrt folded before Flop (didn't bet)
Seat 5: korlito69 folded before Flop
Seat 6: hurtNCYDE folded before Flop (didn't bet)
Seat 7: matiko09 (button) collected ($3.50)





PokerStars Hand #152661703920:  Hold'em No Limit (€0.50/€1.00 EUR) - 2016/04/30 18:21:46 CET [2016/04/30 12:21:46 ET]
Table 'Benda' 9-max Seat #1 is the button
Seat 1: aquarua7 (€216.31 in chips) 
Seat 2: cap. marb (€40 in chips) 
Seat 3: ApkawaDavit (€107.70 in chips) 
Seat 4: fireball2112 (€79.68 in chips) 
Seat 6: Nunzio1985ct (€35.41 in chips) 
Seat 7: Ouga Buga (€100.18 in chips) 
Seat 8: matiko09 (€101 in chips) 
Seat 9: Racushniak (€154.45 in chips) 
cap. marb: posts small blind €0.50
ApkawaDavit: posts big blind €1
hurtNCYDE: sits out 
*** HOLE CARDS ***
Dealt to matiko09 [4c 5s]
fireball2112: folds 
Nunzio1985ct: folds 
Ouga Buga: raises €1.50 to €2.50
matiko09: folds 
Racushniak: folds 
aquarua7: folds 
cap. marb: folds 
ApkawaDavit: folds 
Uncalled bet (€1.50) returned to Ouga Buga
Ouga Buga collected €2.50 from pot
Ouga Buga: doesn't show hand 
*** SUMMARY ***
Total pot €2.50 | Rake €0 
Seat 1: aquarua7 (button) folded before Flop (didn't bet)
Seat 2: cap. marb (small blind) folded before Flop
Seat 3: ApkawaDavit (big blind) folded before Flop
Seat 4: fireball2112 folded before Flop (didn't bet)
Seat 6: Nunzio1985ct folded before Flop (didn't bet)
Seat 7: Ouga Buga collected (€2.50)
Seat 8: matiko09 folded before Flop (didn't bet)
Seat 9: Racushniak folded before Flop (didn't bet)





PokerStars Hand #152661731478:  Hold'em No Limit (€0.50/€1.00 EUR) - 2016/04/30 18:22:22 CET [2016/04/30 12:22:22 ET]
Table 'Benda' 9-max Seat #2 is the button
Seat 1: aquarua7 (€216.31 in chips) 
Seat 2: cap. marb (€39.50 in chips) 
Seat 3: ApkawaDavit (€106.70 in chips) 
Seat 4: fireball2112 (€79.68 in chips) 
Seat 6: Nunzio1985ct (€35.41 in chips) 
Seat 7: Ouga Buga (€101.68 in chips) 
Seat 8: matiko09 (€101 in chips) 
Seat 9: Racushniak (€154.45 in chips) 
ApkawaDavit: posts small blind €0.50
fireball2112: posts big blind €1
hurtNCYDE: sits out 
*** HOLE CARDS ***
Dealt to matiko09 [5s 6d]
Nunzio1985ct: folds 
Ouga Buga: folds 
matiko09: folds 
Racushniak: raises €2 to €3
aquarua7: folds 
cap. marb: folds 
ApkawaDavit: folds 
fireball2112: folds 
Uncalled bet (€2) returned to Racushniak
Racushniak collected €2.50 from pot
Racushniak: doesn't show hand 
*** SUMMARY ***
Total pot €2.50 | Rake €0 
Seat 1: aquarua7 folded before Flop (didn't bet)
Seat 2: cap. marb (button) folded before Flop (didn't bet)
Seat 3: ApkawaDavit (small blind) folded before Flop
Seat 4: fireball2112 (big blind) folded before Flop
Seat 6: Nunzio1985ct folded before Flop (didn't bet)
Seat 7: Ouga Buga folded before Flop (didn't bet)
Seat 8: matiko09 folded before Flop (didn't bet)
Seat 9: Racushniak collected (€2.50)





PokerStars Hand #152661733202:  Hold'em No Limit ($0.50/$1.00 USD) - 2016/04/30 18:22:25 CET [2016/04/30 12:22:25 ET]
Table 'Raissa II' 9-max Seat #1 is the button
Seat 1: cap. marb ($38.50 in chips) 
Seat 2: azzad2007 ($121.90 in chips) 
Seat 3: iRivuLose ($104.21 in chips) 
Seat 4: koksskrt ($100 in chips) 
Seat 5: korlito69 ($51.05 in chips) 
Seat 6: hurtNCYDE ($100 in chips) 
Seat 7: matiko09 ($104.85 in chips) 
azzad2007: posts small blind $0.50
iRivuLose: posts big blind $1
Ilov3NBA: sits out 
*** HOLE CARDS ***
Dealt to matiko09 [6s 9h]
koksskrt: folds 
korlito69: folds 
hurtNCYDE: folds 
matiko09: folds 
cap. marb: folds 
azzad2007: folds 
Uncalled bet ($0.50) returned to iRivuLose
iRivuLose collected $1 from pot
*** SUMMARY ***
Total pot $1 | Rake $0 
Seat 1: cap. marb (button) folded before Flop (didn't bet)
Seat 2: azzad2007 (small blind) folded before Flop
Seat 3: iRivuLose (big blind) collected ($1)
Seat 4: koksskrt folded before Flop (didn't bet)
Seat 5: korlito69 folded before Flop (didn't bet)
Seat 6: hurtNCYDE folded before Flop (didn't bet)
Seat 7: matiko09 folded before Flop (didn't bet)





PokerStars Hand #152661741902:  Hold'em No Limit ($0.50/$1.00 USD) - 2016/04/30 18:22:36 CET [2016/04/30 12:22:36 ET]
Table 'Raissa II' 9-max Seat #2 is the button
Seat 1: cap. marb ($38.50 in chips) 
Seat 2: azzad2007 ($121.40 in chips) 
Seat 4: koksskrt ($100 in chips) 
Seat 5: korlito69 ($51.05 in chips) 
Seat 6: hurtNCYDE ($100 in chips) 
Seat 7: matiko09 ($104.85 in chips) 
iRivuLose has timed out while being disconnected
iRivuLose: is sitting out 
koksskrt: posts small blind $0.50
korlito69: posts big blind $1
Ilov3NBA: sits out 
*** HOLE CARDS ***
Dealt to matiko09 [Kc 3s]
hurtNCYDE: folds 
matiko09: folds 
cap. marb: folds 
azzad2007: folds 
koksskrt: folds 
Uncalled bet ($0.50) returned to korlito69
korlito69 collected $1 from pot
korlito69: doesn't show hand 
*** SUMMARY ***
Total pot $1 | Rake $0 
Seat 1: cap. marb folded before Flop (didn't bet)
Seat 2: azzad2007 (button) folded before Flop (didn't bet)
Seat 4: koksskrt (small blind) folded before Flop
Seat 5: korlito69 (big blind) collected ($1)
Seat 6: hurtNCYDE folded before Flop (didn't bet)
Seat 7: matiko09 folded before Flop (didn't bet)





PokerStars Hand #152661748445:  Hold'em No Limit ($0.50/$1.00 USD) - 2016/04/30 18:22:45 CET [2016/04/30 12:22:45 ET]
Table 'Arcturus' 9-max Seat #9 is the button
Seat 1: matiko09 ($100 in chips) 
Seat 3: Spid1 ($109.20 in chips) 
Seat 4: cap. marb ($47.88 in chips) 
Seat 5: Ilov3NBA ($104.12 in chips) 
Seat 6: WrongButton ($100 in chips) 
Seat 7: terrytsui111 ($162.66 in chips) 
Seat 8: ApkawaDavit ($101.68 in chips) 
Seat 9: fishkida ($100.95 in chips) 
matiko09: posts small blind $0.50
Khaine_CM: is sitting out 
Khaine_CM leaves the table
Spid1: posts big blind $1
*** HOLE CARDS ***
Dealt to matiko09 [3c 8h]
hurtNCYDE joins the table at seat #2 
cap. marb: folds 
Ilov3NBA: folds 
WrongButton: folds 
terrytsui111: folds 
ApkawaDavit: folds 
fishkida: folds 
matiko09: folds 
Uncalled bet ($0.50) returned to Spid1
Spid1 collected $1 from pot
Spid1: doesn't show hand 
*** SUMMARY ***
Total pot $1 | Rake $0 
Seat 1: matiko09 (small blind) folded before Flop
Seat 3: Spid1 (big blind) collected ($1)
Seat 4: cap. marb folded before Flop (didn't bet)
Seat 5: Ilov3NBA folded before Flop (didn't bet)
Seat 6: WrongButton folded before Flop (didn't bet)
Seat 7: terrytsui111 folded before Flop (didn't bet)
Seat 8: ApkawaDavit folded before Flop (didn't bet)
Seat 9: fishkida (button) folded before Flop (didn't bet)





PokerStars Hand #152661753262:  Hold'em No Limit ($0.50/$1.00 USD) - 2016/04/30 18:22:51 CET [2016/04/30 12:22:51 ET]
Table 'Alshat' 9-max Seat #9 is the button
Seat 1: marko3213 ($64.50 in chips) 
Seat 3: matiko09 ($100 in chips) 
Seat 6: Stopton ($100 in chips) 
Seat 8: WrongButton ($102.28 in chips) 
Seat 9: ApkawaDavit ($100 in chips) 
marko3213: posts small blind $0.50
matiko09: posts big blind $1
cap. marb: sits out 
Stopton: posts big blind $1
ilaviiitech: sits out 
*** HOLE CARDS ***
Dealt to matiko09 [2s 7c]
Stopton: raises $2 to $3
WrongButton: folds 
edragonl1 joins the table at seat #5 
ApkawaDavit: raises $6 to $9
marko3213: folds 
matiko09: folds 
Stopton: calls $6
*** FLOP *** [6d 4c 6c]
Stopton: checks 
ApkawaDavit: checks 
*** TURN *** [6d 4c 6c] [Ah]
Stopton: checks 
ApkawaDavit: bets $13.50
Stopton: calls $13.50
*** RIVER *** [6d 4c 6c Ah] [2h]
Stopton: checks 
ApkawaDavit: bets $36.50
Stopton: calls $36.50
*** SHOW DOWN ***
ApkawaDavit: shows [Kd Ad] (two pair, Aces and Sixes)
Stopton: mucks hand 
ApkawaDavit collected $117 from pot
*** SUMMARY ***
Total pot $119.50 | Rake $2.50 
Board [6d 4c 6c Ah 2h]
Seat 1: marko3213 (small blind) folded before Flop
Seat 3: matiko09 (big blind) folded before Flop
Seat 6: Stopton mucked [Ts Ac]
Seat 8: WrongButton folded before Flop (didn't bet)
Seat 9: ApkawaDavit (button) showed [Kd Ad] and won ($117) with two pair, Aces and Sixes





PokerStars Hand #152661756128:  Hold'em No Limit ($0.50/$1.00 USD) - 2016/04/30 18:22:55 CET [2016/04/30 12:22:55 ET]
Table 'Malautra II' 9-max Seat #6 is the button
Seat 2: Ilov3NBA ($109.46 in chips) 
Seat 3: t.sneijder ($59.32 in chips) 
Seat 5: hurtNCYDE ($100 in chips) 
Seat 6: matiko09 ($101.50 in chips) 
Seat 7: poker-rat95 ($99.78 in chips) 
Seat 8: Nito Lansky ($72 in chips) 
Seat 9: cap. marb ($40 in chips) 
poker-rat95: posts small blind $0.50
Nito Lansky: posts big blind $1
Fivez: sits out 
RoadtoNepal: sits out 
*** HOLE CARDS ***
Dealt to matiko09 [7c Ad]
cap. marb: folds 
Ilov3NBA: raises $2 to $3
t.sneijder: calls $3
hurtNCYDE: raises $8 to $11
matiko09: folds 
poker-rat95: folds 
Nito Lansky: folds 
Ilov3NBA: calls $8
t.sneijder: calls $8
*** FLOP *** [9h 5h Qd]
poker-rat95 leaves the table
Ilov3NBA: checks 
t.sneijder: bets $16
hurtNCYDE: folds 
Ilov3NBA: calls $16
*** TURN *** [9h 5h Qd] [6s]
Ilov3NBA: checks 
t.sneijder: bets $32.32 and is all-in
Ilov3NBA: calls $32.32
*** RIVER *** [9h 5h Qd 6s] [6c]
*** SHOW DOWN ***
Ilov3NBA: shows [Qs Qc] (a full house, Queens full of Sixes)
t.sneijder: shows [Qh Jd] (two pair, Queens and Sixes)
Ilov3NBA collected $128.64 from pot
*** SUMMARY ***
Total pot $131.14 | Rake $2.50 
Board [9h 5h Qd 6s 6c]
Seat 2: Ilov3NBA showed [Qs Qc] and won ($128.64) with a full house, Queens full of Sixes
Seat 3: t.sneijder showed [Qh Jd] and lost with two pair, Queens and Sixes
Seat 5: hurtNCYDE folded on the Flop
Seat 6: matiko09 (button) folded before Flop (didn't bet)
Seat 7: poker-rat95 (small blind) folded before Flop
Seat 8: Nito Lansky (big blind) folded before Flop
Seat 9: cap. marb folded before Flop (didn't bet)





PokerStars Hand #152661759036:  Hold'em No Limit ($0.50/$1.00 USD) - 2016/04/30 18:22:58 CET [2016/04/30 12:22:58 ET]
Table 'Arcturus' 9-max Seat #1 is the button
Seat 1: matiko09 ($100 in chips) 
Seat 3: Spid1 ($109.70 in chips) 
Seat 4: cap. marb ($47.88 in chips) 
Seat 5: Ilov3NBA ($104.12 in chips) 
Seat 6: WrongButton ($100 in chips) 
Seat 7: terrytsui111 ($162.66 in chips) 
Seat 8: ApkawaDavit ($101.68 in chips) 
Seat 9: fishkida ($100.95 in chips) 
hurtNCYDE will be allowed to play after the button
Spid1: posts small blind $0.50
cap. marb: posts big blind $1
*** HOLE CARDS ***
Dealt to matiko09 [6h 5c]
Ilov3NBA: folds 
WrongButton: folds 
terrytsui111: raises $1 to $2
ApkawaDavit: calls $2
fishkida: folds 
matiko09: folds 
Spid1: folds 
cap. marb: folds 
*** FLOP *** [Jc 2s 5s]
terrytsui111: bets $4
ApkawaDavit: folds 
Uncalled bet ($4) returned to terrytsui111
terrytsui111 collected $5.22 from pot
terrytsui111: doesn't show hand 
*** SUMMARY ***
Total pot $5.50 | Rake $0.28 
Board [Jc 2s 5s]
Seat 1: matiko09 (button) folded before Flop (didn't bet)
Seat 3: Spid1 (small blind) folded before Flop
Seat 4: cap. marb (big blind) folded before Flop
Seat 5: Ilov3NBA folded before Flop (didn't bet)
Seat 6: WrongButton folded before Flop (didn't bet)
Seat 7: terrytsui111 collected ($5.22)
Seat 8: ApkawaDavit folded on the Flop
Seat 9: fishkida folded before Flop (didn't bet)





PokerStars Hand #152661778798:  Hold'em No Limit (€0.50/€1.00 EUR) - 2016/04/30 18:23:24 CET [2016/04/30 12:23:24 ET]
Table 'Benda' 9-max Seat #3 is the button
Seat 1: aquarua7 (€216.31 in chips) 
Seat 2: cap. marb (€39.50 in chips) 
Seat 3: ApkawaDavit (€106.20 in chips) 
Seat 4: fireball2112 (€78.68 in chips) 
Seat 5: hurtNCYDE (€100 in chips) 
Seat 6: Nunzio1985ct (€35.41 in chips) 
Seat 7: Ouga Buga (€101.68 in chips) 
Seat 8: matiko09 (€101 in chips) 
Seat 9: Racushniak (€155.95 in chips) 
fireball2112: posts small blind €0.50
hurtNCYDE: posts big blind €1
*** HOLE CARDS ***
Dealt to matiko09 [2d Ad]
Nunzio1985ct: calls €1
Ouga Buga: folds 
matiko09: folds 
Racushniak: folds 
aquarua7: raises €3.50 to €4.50
cap. marb: folds 
ApkawaDavit: folds 
fireball2112: folds 
hurtNCYDE: folds 
Nunzio1985ct: raises €6.50 to €11
aquarua7: folds 
Uncalled bet (€6.50) returned to Nunzio1985ct
Nunzio1985ct collected €10.50 from pot
*** SUMMARY ***
Total pot €10.50 | Rake €0 
Seat 1: aquarua7 folded before Flop
Seat 2: cap. marb folded before Flop (didn't bet)
Seat 3: ApkawaDavit (button) folded before Flop (didn't bet)
Seat 4: fireball2112 (small blind) folded before Flop
Seat 5: hurtNCYDE (big blind) folded before Flop
Seat 6: Nunzio1985ct collected (€10.50)
Seat 7: Ouga Buga folded before Flop (didn't bet)
Seat 8: matiko09 folded before Flop (didn't bet)
Seat 9: Racushniak folded before Flop (didn't bet)





PokerStars Hand #152661779572:  Hold'em No Limit ($0.50/$1.00 USD) - 2016/04/30 18:23:25 CET [2016/04/30 12:23:25 ET]
Table 'Raissa II' 9-max Seat #4 is the button
Seat 1: cap. marb ($38.50 in chips) 
Seat 2: azzad2007 ($121.40 in chips) 
Seat 3: iRivuLose ($104.71 in chips) 
Seat 4: koksskrt ($100 in chips) 
Seat 5: korlito69 ($51.55 in chips) 
Seat 6: hurtNCYDE ($100 in chips) 
Seat 7: matiko09 ($104.85 in chips) 
korlito69: posts small blind $0.50
hurtNCYDE: posts big blind $1
Ilov3NBA: sits out 
iRivuLose: posts small blind $0.50
*** HOLE CARDS ***
Dealt to matiko09 [Ad 8s]
matiko09: folds 
cap. marb: folds 
azzad2007: folds 
iRivuLose: raises $1.10 to $2.10
koksskrt: folds 
korlito69: folds 
hurtNCYDE: folds 
Uncalled bet ($1.10) returned to iRivuLose
iRivuLose collected $3 from pot
iRivuLose: doesn't show hand 
*** SUMMARY ***
Total pot $3 | Rake $0 
Seat 1: cap. marb folded before Flop (didn't bet)
Seat 2: azzad2007 folded before Flop (didn't bet)
Seat 3: iRivuLose collected ($3)
Seat 4: koksskrt (button) folded before Flop (didn't bet)
Seat 5: korlito69 (small blind) folded before Flop
Seat 6: hurtNCYDE (big blind) folded before Flop
Seat 7: matiko09 folded before Flop (didn't bet)





PokerStars Hand #152661795087:  Hold'em No Limit ($0.50/$1.00 USD) - 2016/04/30 18:23:46 CET [2016/04/30 12:23:46 ET]
Table 'Arcturus' 9-max Seat #3 is the button
Seat 1: matiko09 ($100 in chips) 
Seat 3: Spid1 ($109.20 in chips) 
Seat 4: cap. marb ($46.88 in chips) 
Seat 5: Ilov3NBA ($104.12 in chips) 
Seat 6: WrongButton ($100 in chips) 
Seat 7: terrytsui111 ($165.88 in chips) 
Seat 8: ApkawaDavit ($100 in chips) 
Seat 9: fishkida ($100.95 in chips) 
cap. marb: posts small blind $0.50
Ilov3NBA: posts big blind $1
hurtNCYDE: sits out 
*** HOLE CARDS ***
Dealt to matiko09 [Ts Ad]
WrongButton: folds 
terrytsui111: raises $1 to $2
ApkawaDavit: calls $2
fishkida: raises $8 to $10
matiko09: folds 
Spid1: folds 
cap. marb: folds 
Ilov3NBA: folds 
terrytsui111: calls $8
ApkawaDavit: folds 
*** FLOP *** [Tc 6c Qd]
terrytsui111: bets $6
fishkida: raises $10 to $16
terrytsui111: calls $10
*** TURN *** [Tc 6c Qd] [7d]
terrytsui111: checks 
fishkida: bets $33
terrytsui111: calls $33
*** RIVER *** [Tc 6c Qd 7d] [Td]
terrytsui111: bets $20
fishkida: raises $21.95 to $41.95 and is all-in
terrytsui111: folds 
Uncalled bet ($21.95) returned to fishkida
fishkida collected $159 from pot
fishkida: doesn't show hand 
*** SUMMARY ***
Total pot $161.50 | Rake $2.50 
Board [Tc 6c Qd 7d Td]
Seat 1: matiko09 folded before Flop (didn't bet)
Seat 3: Spid1 (button) folded before Flop (didn't bet)
Seat 4: cap. marb (small blind) folded before Flop
Seat 5: Ilov3NBA (big blind) folded before Flop
Seat 6: WrongButton folded before Flop (didn't bet)
Seat 7: terrytsui111 folded on the River
Seat 8: ApkawaDavit folded before Flop
Seat 9: fishkida collected ($159)





PokerStars Hand #152661796686:  Hold'em No Limit ($0.50/$1.00 USD) - 2016/04/30 18:23:48 CET [2016/04/30 12:23:48 ET]
Table 'Lova II' 9-max Seat #7 is the button
Seat 2: bilukm ($277.86 in chips) 
Seat 3: matiko09 ($102.72 in chips) 
Seat 4: VanDobeln ($127.95 in chips) 
Seat 5: Ilov3NBA ($199 in chips) 
Seat 6: di0d80 ($100 in chips) 
Seat 7: meysam270 ($42.93 in chips) 
Seat 8: cap. marb ($54.29 in chips) 
Seat 9: hurtNCYDE ($101.50 in chips) 
cap. marb: posts small blind $0.50
hurtNCYDE: posts big blind $1
RoadtoNepal: sits out 
*** HOLE CARDS ***
Dealt to matiko09 [7d 4c]
di0d80 said, "i ****in knew it!"
RoadtoNepal leaves the table
bilukm: calls $1
Pacifistas joins the table at seat #1 
matiko09: folds 
VanDobeln: folds 
Ilov3NBA: raises $3.50 to $4.50
di0d80: folds 
meysam270: folds 
cap. marb: folds 
hurtNCYDE: folds 
Ilov3NBA said, "you know one combo"
bilukm: calls $3.50
*** FLOP *** [Ts 3s 5d]
bilukm: checks 
di0d80 said, "thats u"
Ilov3NBA: checks 
*** TURN *** [Ts 3s 5d] [7h]
bilukm: checks 
Ilov3NBA: checks 
*** RIVER *** [Ts 3s 5d 7h] [9h]
bilukm: bets $1
Ilov3NBA: calls $1
*** SHOW DOWN ***
bilukm: shows [Jd 9d] (a pair of Nines)
Ilov3NBA: mucks hand 
bilukm collected $11.88 from pot
*** SUMMARY ***
Total pot $12.50 | Rake $0.62 
Board [Ts 3s 5d 7h 9h]
Seat 2: bilukm showed [Jd 9d] and won ($11.88) with a pair of Nines
Seat 3: matiko09 folded before Flop (didn't bet)
Seat 4: VanDobeln folded before Flop (didn't bet)
Seat 5: Ilov3NBA mucked [Jc As]
Seat 6: di0d80 folded before Flop (didn't bet)
Seat 7: meysam270 (button) folded before Flop (didn't bet)
Seat 8: cap. marb (small blind) folded before Flop
Seat 9: hurtNCYDE (big blind) folded before Flop





PokerStars Hand #152661800958:  Hold'em No Limit ($0.50/$1.00 USD) - 2016/04/30 18:23:53 CET [2016/04/30 12:23:53 ET]
Table 'Raissa II' 9-max Seat #5 is the button
Seat 1: cap. marb ($38.50 in chips) 
Seat 2: azzad2007 ($121.40 in chips) 
Seat 3: iRivuLose ($106.21 in chips) 
Seat 4: koksskrt ($100 in chips) 
Seat 5: korlito69 ($51.05 in chips) 
Seat 6: hurtNCYDE ($100 in chips) 
Seat 7: matiko09 ($104.85 in chips) 
hurtNCYDE: posts small blind $0.50
matiko09: posts big blind $1
Ilov3NBA: sits out 
*** HOLE CARDS ***
Dealt to matiko09 [Ac 7s]
cap. marb: folds 
azzad2007: folds 
iRivuLose: folds 
koksskrt: folds 
korlito69: raises $2 to $3
hurtNCYDE: folds 
matiko09: calls $2
*** FLOP *** [9d Kd Tc]
matiko09: checks 
korlito69: bets $3
matiko09: folds 
Uncalled bet ($3) returned to korlito69
korlito69 collected $6.18 from pot
korlito69: doesn't show hand 
*** SUMMARY ***
Total pot $6.50 | Rake $0.32 
Board [9d Kd Tc]
Seat 1: cap. marb folded before Flop (didn't bet)
Seat 2: azzad2007 folded before Flop (didn't bet)
Seat 3: iRivuLose folded before Flop (didn't bet)
Seat 4: koksskrt folded before Flop (didn't bet)
Seat 5: korlito69 (button) collected ($6.18)
Seat 6: hurtNCYDE (small blind) folded before Flop
Seat 7: matiko09 (big blind) folded on the Flop





PokerStars Hand #152661802335:  Hold'em No Limit ($0.50/$1.00 USD) - 2016/04/30 18:23:55 CET [2016/04/30 12:23:55 ET]
Table 'Alshat' 9-max Seat #1 is the button
Seat 1: marko3213 ($64 in chips) 
Seat 3: matiko09 ($100 in chips) 
Seat 4: cap. marb ($40 in chips) 
Seat 6: Stopton ($41 in chips) 
Seat 8: WrongButton ($102.28 in chips) 
Seat 9: ApkawaDavit ($158 in chips) 
matiko09: posts small blind $0.50
cap. marb: posts big blind $1
edragonl1: sits out 
ilaviiitech: sits out 
*** HOLE CARDS ***
Dealt to matiko09 [3c Js]
Stopton: raises $2 to $3
WrongButton: folds 
ApkawaDavit: raises $6 to $9
marko3213: folds 
matiko09: folds 
cap. marb: folds 
Stopton: raises $32 to $41 and is all-in
ApkawaDavit: calls $32
*** FLOP *** [5d Qs 4d]
*** TURN *** [5d Qs 4d] [Td]
*** RIVER *** [5d Qs 4d Td] [Kd]
*** SHOW DOWN ***
Stopton: shows [Th Tc] (three of a kind, Tens)
ApkawaDavit: shows [As Kc] (a pair of Kings)
Stopton collected $81 from pot
*** SUMMARY ***
Total pot $83.50 | Rake $2.50 
Board [5d Qs 4d Td Kd]
Seat 1: marko3213 (button) folded before Flop (didn't bet)
Seat 3: matiko09 (small blind) folded before Flop
Seat 4: cap. marb (big blind) folded before Flop
Seat 6: Stopton showed [Th Tc] and won ($81) with three of a kind, Tens
Seat 8: WrongButton folded before Flop (didn't bet)
Seat 9: ApkawaDavit showed [As Kc] and lost with a pair of Kings





PokerStars Hand #152661810512:  Hold'em No Limit (€0.50/€1.00 EUR) - 2016/04/30 18:24:06 CET [2016/04/30 12:24:06 ET]
Table 'Benda' 9-max Seat #4 is the button
Seat 1: aquarua7 (€211.81 in chips) 
Seat 2: cap. marb (€39.50 in chips) 
Seat 3: ApkawaDavit (€106.20 in chips) 
Seat 4: fireball2112 (€78.18 in chips) 
Seat 5: hurtNCYDE (€100 in chips) 
Seat 6: Nunzio1985ct (€41.41 in chips) 
Seat 7: Ouga Buga (€101.68 in chips) 
Seat 8: matiko09 (€101 in chips) 
Seat 9: Racushniak (€155.95 in chips) 
hurtNCYDE: posts small blind €0.50
Nunzio1985ct: posts big blind €1
*** HOLE CARDS ***
Dealt to matiko09 [2h Tc]
Ouga Buga: folds 
matiko09: folds 
Racushniak: folds 
aquarua7: folds 
cap. marb: folds 
ApkawaDavit: folds 
fireball2112: folds 
hurtNCYDE: raises €1.50 to €2.50
Nunzio1985ct: calls €1.50
*** FLOP *** [Ts 6c Th]
hurtNCYDE: checks 
Nunzio1985ct: checks 
*** TURN *** [Ts 6c Th] [8h]
hurtNCYDE: bets €2
Nunzio1985ct: folds 
Uncalled bet (€2) returned to hurtNCYDE
hurtNCYDE collected €4.75 from pot
*** SUMMARY ***
Total pot €5 | Rake €0.25 
Board [Ts 6c Th 8h]
Seat 1: aquarua7 folded before Flop (didn't bet)
Seat 2: cap. marb folded before Flop (didn't bet)
Seat 3: ApkawaDavit folded before Flop (didn't bet)
Seat 4: fireball2112 (button) folded before Flop (didn't bet)
Seat 5: hurtNCYDE (small blind) collected (€4.75)
Seat 6: Nunzio1985ct (big blind) folded on the Turn
Seat 7: Ouga Buga folded before Flop (didn't bet)
Seat 8: matiko09 folded before Flop (didn't bet)
Seat 9: Racushniak folded before Flop (didn't bet)





PokerStars Hand #152661817086:  Hold'em No Limit ($0.50/$1.00 USD) - 2016/04/30 18:24:14 CET [2016/04/30 12:24:14 ET]
Table 'Dagmar' 9-max Seat #8 is the button
Seat 1: matiko09 ($100 in chips) 
Seat 2: Spid1 ($184.45 in chips) 
Seat 3: ApkawaDavit ($124.20 in chips) 
Seat 4: legnulk ($178.77 in chips) 
Seat 6: arctur17 ($120.64 in chips) 
Seat 7: kswmh ($95.62 in chips) 
Seat 8: maxxmeister ($101 in chips) 
Seat 9: okkernoot111 ($133.10 in chips) 
okkernoot111: posts small blind $0.50
matiko09: posts big blind $1
cap. marb: sits out 
*** HOLE CARDS ***
Dealt to matiko09 [4h Kc]
Spid1: raises $2 to $3
ApkawaDavit: folds 
legnulk: folds 
arctur17: folds 
kswmh: folds 
maxxmeister: folds 
okkernoot111: raises $7 to $10
matiko09: folds 
Spid1: calls $7
*** FLOP *** [Qc 2h 9c]
okkernoot111: checks 
Spid1: checks 
*** TURN *** [Qc 2h 9c] [3s]
okkernoot111: bets $7
Spid1: calls $7
*** RIVER *** [Qc 2h 9c 3s] [5s]
okkernoot111: checks 
Spid1: checks 
*** SHOW DOWN ***
okkernoot111: shows [Jc Js] (a pair of Jacks)
Spid1: mucks hand 
okkernoot111 collected $33.25 from pot
*** SUMMARY ***
Total pot $35 | Rake $1.75 
Board [Qc 2h 9c 3s 5s]
Seat 1: matiko09 (big blind) folded before Flop
Seat 2: Spid1 mucked [Ad 5d]
Seat 3: ApkawaDavit folded before Flop (didn't bet)
Seat 4: legnulk folded before Flop (didn't bet)
Seat 6: arctur17 folded before Flop (didn't bet)
Seat 7: kswmh folded before Flop (didn't bet)
Seat 8: maxxmeister (button) folded before Flop (didn't bet)
Seat 9: okkernoot111 (small blind) showed [Jc Js] and won ($33.25) with a pair of Jacks





PokerStars Hand #152661823962:  Hold'em No Limit ($0.50/$1.00 USD) - 2016/04/30 18:24:23 CET [2016/04/30 12:24:23 ET]
Table 'Raissa II' 9-max Seat #6 is the button
Seat 1: cap. marb ($38.50 in chips) 
Seat 2: azzad2007 ($121.40 in chips) 
Seat 3: iRivuLose ($106.21 in chips) 
Seat 4: koksskrt ($100 in chips) 
Seat 5: korlito69 ($54.23 in chips) 
Seat 6: hurtNCYDE ($100 in chips) 
Seat 7: matiko09 ($101.85 in chips) 
Seat 9: Ilov3NBA ($100 in chips) 
matiko09: posts small blind $0.50
Ilov3NBA: posts big blind $1
*** HOLE CARDS ***
Dealt to matiko09 [Ts Jc]
cap. marb: raises $1.12 to $2.12
azzad2007: folds 
iRivuLose: folds 
koksskrt: folds 
korlito69: folds 
hurtNCYDE: folds 
matiko09: folds 
Ilov3NBA: calls $1.12
*** FLOP *** [Kc 2d 8s]
Ilov3NBA: checks 
cap. marb: bets $2.97
Ilov3NBA: calls $2.97
*** TURN *** [Kc 2d 8s] [Kh]
Ilov3NBA: checks 
cap. marb: checks 
*** RIVER *** [Kc 2d 8s Kh] [5d]
Ilov3NBA: checks 
cap. marb: bets $6.69
Ilov3NBA: folds 
Uncalled bet ($6.69) returned to cap. marb
cap. marb collected $10.15 from pot
cap. marb: doesn't show hand 
*** SUMMARY ***
Total pot $10.68 | Rake $0.53 
Board [Kc 2d 8s Kh 5d]
Seat 1: cap. marb collected ($10.15)
Seat 2: azzad2007 folded before Flop (didn't bet)
Seat 3: iRivuLose folded before Flop (didn't bet)
Seat 4: koksskrt folded before Flop (didn't bet)
Seat 5: korlito69 folded before Flop (didn't bet)
Seat 6: hurtNCYDE (button) folded before Flop (didn't bet)
Seat 7: matiko09 (small blind) folded before Flop
Seat 9: Ilov3NBA (big blind) folded on the River





PokerStars Hand #152661833994:  Hold'em No Limit ($0.50/$1.00 USD) - 2016/04/30 18:24:36 CET [2016/04/30 12:24:36 ET]
Table 'Alshat' 9-max Seat #3 is the button
Seat 1: marko3213 ($64 in chips) 
Seat 3: matiko09 ($100 in chips) 
Seat 4: cap. marb ($39 in chips) 
Seat 5: edragonl1 ($80 in chips) 
Seat 6: Stopton ($81 in chips) 
Seat 8: WrongButton ($102.28 in chips) 
Seat 9: ApkawaDavit ($117 in chips) 
cap. marb: posts small blind $0.50
edragonl1: posts big blind $1
ilaviiitech: sits out 
*** HOLE CARDS ***
Dealt to matiko09 [2d Td]
Stopton: folds 
WrongButton: folds 
ApkawaDavit: folds 
marko3213: folds 
matiko09: folds 
cap. marb: folds 
Uncalled bet ($0.50) returned to edragonl1
edragonl1 collected $1 from pot
edragonl1: doesn't show hand 
*** SUMMARY ***
Total pot $1 | Rake $0 
Seat 1: marko3213 folded before Flop (didn't bet)
Seat 3: matiko09 (button) folded before Flop (didn't bet)
Seat 4: cap. marb (small blind) folded before Flop
Seat 5: edragonl1 (big blind) collected ($1)
Seat 6: Stopton folded before Flop (didn't bet)
Seat 8: WrongButton folded before Flop (didn't bet)
Seat 9: ApkawaDavit folded before Flop (didn't bet)





PokerStars Hand #152661834359:  Hold'em No Limit ($0.50/$1.00 USD) - 2016/04/30 18:24:37 CET [2016/04/30 12:24:37 ET]
Table 'Malautra II' 9-max Seat #8 is the button
Seat 1: Fivez ($121.37 in chips) 
Seat 2: Ilov3NBA ($178.78 in chips) 
Seat 5: hurtNCYDE ($100 in chips) 
Seat 6: matiko09 ($101.50 in chips) 
Seat 8: Nito Lansky ($71 in chips) 
Seat 9: cap. marb ($40 in chips) 
cap. marb: posts small blind $0.50
Fivez: posts big blind $1
RoadtoNepal: sits out 
*** HOLE CARDS ***
Dealt to matiko09 [7h 4s]
Ilov3NBA: folds 
hurtNCYDE: folds 
t.sneijder leaves the table
matiko09: folds 
WrongButton joins the table at seat #3 
Nito Lansky: calls $1
cap. marb: folds 
Fivez: checks 
*** FLOP *** [2h Jd 5s]
Fivez: checks 
Nito Lansky: bets $1.19
Fivez: calls $1.19
*** TURN *** [2h Jd 5s] [Kh]
Fivez: checks 
Nito Lansky: bets $2.32
Fivez: folds 
Uncalled bet ($2.32) returned to Nito Lansky
Nito Lansky collected $4.64 from pot
Nito Lansky: doesn't show hand 
*** SUMMARY ***
Total pot $4.88 | Rake $0.24 
Board [2h Jd 5s Kh]
Seat 1: Fivez (big blind) folded on the Turn
Seat 2: Ilov3NBA folded before Flop (didn't bet)
Seat 5: hurtNCYDE folded before Flop (didn't bet)
Seat 6: matiko09 folded before Flop (didn't bet)
Seat 8: Nito Lansky (button) collected ($4.64)
Seat 9: cap. marb (small blind) folded before Flop





PokerStars Hand #152661841197:  Hold'em No Limit ($0.50/$1.00 USD) - 2016/04/30 18:24:46 CET [2016/04/30 12:24:46 ET]
Table 'Lova II' 9-max Seat #8 is the button
Seat 2: bilukm ($284.24 in chips) 
Seat 3: matiko09 ($102.72 in chips) 
Seat 4: VanDobeln ($127.95 in chips) 
Seat 5: Ilov3NBA ($193.50 in chips) 
Seat 6: di0d80 ($100 in chips) 
Seat 7: meysam270 ($42.93 in chips) 
Seat 8: cap. marb ($53.79 in chips) 
Seat 9: hurtNCYDE ($100.50 in chips) 
hurtNCYDE: posts small blind $0.50
bilukm: posts big blind $1
*** HOLE CARDS ***
Dealt to matiko09 [5c 4c]
matiko09: folds 
VanDobeln: folds 
Ilov3NBA: folds 
di0d80: raises $1.50 to $2.50
meysam270: folds 
cap. marb: calls $2.50
hurtNCYDE: folds 
bilukm: calls $1.50
*** FLOP *** [2d 7s 8d]
bilukm: checks 
di0d80: checks 
cap. marb: bets $4.50
bilukm: folds 
di0d80: folds 
Uncalled bet ($4.50) returned to cap. marb
cap. marb collected $7.60 from pot
*** SUMMARY ***
Total pot $8 | Rake $0.40 
Board [2d 7s 8d]
Seat 2: bilukm (big blind) folded on the Flop
Seat 3: matiko09 folded before Flop (didn't bet)
Seat 4: VanDobeln folded before Flop (didn't bet)
Seat 5: Ilov3NBA folded before Flop (didn't bet)
Seat 6: di0d80 folded on the Flop
Seat 7: meysam270 folded before Flop (didn't bet)
Seat 8: cap. marb (button) collected ($7.60)
Seat 9: hurtNCYDE (small blind) folded before Flop





PokerStars Hand #152661852412:  Hold'em No Limit (€0.50/€1.00 EUR) - 2016/04/30 18:25:01 CET [2016/04/30 12:25:01 ET]
Table 'Benda' 9-max Seat #5 is the button
Seat 1: aquarua7 (€211.81 in chips) 
Seat 2: cap. marb (€39.50 in chips) 
Seat 3: ApkawaDavit (€106.20 in chips) 
Seat 4: fireball2112 (€78.18 in chips) 
Seat 5: hurtNCYDE (€102.25 in chips) 
Seat 6: Nunzio1985ct (€38.91 in chips) 
Seat 7: Ouga Buga (€101.68 in chips) 
Seat 8: matiko09 (€101 in chips) 
Seat 9: Racushniak (€155.95 in chips) 
Nunzio1985ct: posts small blind €0.50
Ouga Buga: posts big blind €1
*** HOLE CARDS ***
Dealt to matiko09 [4d Kh]
matiko09: folds 
Racushniak: raises €2.50 to €3.50
aquarua7: folds 
cap. marb: folds 
ApkawaDavit: folds 
fireball2112: folds 
hurtNCYDE: folds 
Nunzio1985ct: folds 
Ouga Buga: folds 
Uncalled bet (€2.50) returned to Racushniak
Racushniak collected €2.50 from pot
Racushniak: doesn't show hand 
*** SUMMARY ***
Total pot €2.50 | Rake €0 
Seat 1: aquarua7 folded before Flop (didn't bet)
Seat 2: cap. marb folded before Flop (didn't bet)
Seat 3: ApkawaDavit folded before Flop (didn't bet)
Seat 4: fireball2112 folded before Flop (didn't bet)
Seat 5: hurtNCYDE (button) folded before Flop (didn't bet)
Seat 6: Nunzio1985ct (small blind) folded before Flop
Seat 7: Ouga Buga (big blind) folded before Flop
Seat 8: matiko09 folded before Flop (didn't bet)
Seat 9: Racushniak collected (€2.50)





PokerStars Hand #152661864476:  Hold'em No Limit ($0.50/$1.00 USD) - 2016/04/30 18:25:16 CET [2016/04/30 12:25:16 ET]
Table 'Alshat' 9-max Seat #4 is the button
Seat 1: marko3213 ($64 in chips) 
Seat 3: matiko09 ($100 in chips) 
Seat 4: cap. marb ($38.50 in chips) 
Seat 5: edragonl1 ($80.50 in chips) 
Seat 6: Stopton ($81 in chips) 
Seat 8: WrongButton ($102.28 in chips) 
Seat 9: ApkawaDavit ($117 in chips) 
edragonl1: posts small blind $0.50
Stopton: posts big blind $1
ilaviiitech: sits out 
*** HOLE CARDS ***
Dealt to matiko09 [Ts 7d]
WrongButton: folds 
ApkawaDavit: folds 
marko3213: folds 
matiko09: folds 
cap. marb: folds 
edragonl1: calls $0.50
Stopton: checks 
*** FLOP *** [6s 7s Jd]
edragonl1: checks 
Stopton: checks 
*** TURN *** [6s 7s Jd] [Kc]
edragonl1: bets $3
Stopton: folds 
Uncalled bet ($3) returned to edragonl1
edragonl1 collected $1.90 from pot
edragonl1: doesn't show hand 
*** SUMMARY ***
Total pot $2 | Rake $0.10 
Board [6s 7s Jd Kc]
Seat 1: marko3213 folded before Flop (didn't bet)
Seat 3: matiko09 folded before Flop (didn't bet)
Seat 4: cap. marb (button) folded before Flop (didn't bet)
Seat 5: edragonl1 (small blind) collected ($1.90)
Seat 6: Stopton (big blind) folded on the Turn
Seat 8: WrongButton folded before Flop (didn't bet)
Seat 9: ApkawaDavit folded before Flop (didn't bet)





PokerStars Hand #152661866135:  Hold'em No Limit ($0.50/$1.00 USD) - 2016/04/30 18:25:19 CET [2016/04/30 12:25:19 ET]
Table 'Malautra II' 9-max Seat #9 is the button
Seat 1: Fivez ($119.18 in chips) 
Seat 2: Ilov3NBA ($178.78 in chips) 
Seat 5: hurtNCYDE ($100 in chips) 
Seat 6: matiko09 ($101.50 in chips) 
Seat 8: Nito Lansky ($73.45 in chips) 
Seat 9: cap. marb ($39.50 in chips) 
Fivez: posts small blind $0.50
Ilov3NBA: posts big blind $1
WrongButton: sits out 
RoadtoNepal: sits out 
*** HOLE CARDS ***
Dealt to matiko09 [Ks 6c]
hurtNCYDE: folds 
matiko09: folds 
Nito Lansky: raises $2 to $3
cap. marb: folds 
Fivez: folds 
Ilov3NBA: folds 
Uncalled bet ($2) returned to Nito Lansky
Nito Lansky collected $2.50 from pot
Nito Lansky: doesn't show hand 
*** SUMMARY ***
Total pot $2.50 | Rake $0 
Seat 1: Fivez (small blind) folded before Flop
Seat 2: Ilov3NBA (big blind) folded before Flop
Seat 5: hurtNCYDE folded before Flop (didn't bet)
Seat 6: matiko09 folded before Flop (didn't bet)
Seat 8: Nito Lansky collected ($2.50)
Seat 9: cap. marb (button) folded before Flop (didn't bet)





PokerStars Hand #152661875983:  Hold'em No Limit (€0.50/€1.00 EUR) - 2016/04/30 18:25:31 CET [2016/04/30 12:25:31 ET]
Table 'Benda' 9-max Seat #6 is the button
Seat 1: aquarua7 (€211.81 in chips) 
Seat 2: cap. marb (€39.50 in chips) 
Seat 3: ApkawaDavit (€106.20 in chips) 
Seat 4: fireball2112 (€78.18 in chips) 
Seat 5: hurtNCYDE (€102.25 in chips) 
Seat 6: Nunzio1985ct (€38.41 in chips) 
Seat 7: Ouga Buga (€100.68 in chips) 
Seat 8: matiko09 (€101 in chips) 
Seat 9: Racushniak (€157.45 in chips) 
Ouga Buga: posts small blind €0.50
matiko09: posts big blind €1
*** HOLE CARDS ***
Dealt to matiko09 [8h 7d]
Racushniak: folds 
aquarua7: raises €1.50 to €2.50
cap. marb: folds 
ApkawaDavit: folds 
fireball2112: folds 
hurtNCYDE: folds 
Nunzio1985ct: folds 
Ouga Buga: folds 
matiko09: folds 
Uncalled bet (€1.50) returned to aquarua7
aquarua7 collected €2.50 from pot
aquarua7: doesn't show hand 
*** SUMMARY ***
Total pot €2.50 | Rake €0 
Seat 1: aquarua7 collected (€2.50)
Seat 2: cap. marb folded before Flop (didn't bet)
Seat 3: ApkawaDavit folded before Flop (didn't bet)
Seat 4: fireball2112 folded before Flop (didn't bet)
Seat 5: hurtNCYDE folded before Flop (didn't bet)
Seat 6: Nunzio1985ct (button) folded before Flop (didn't bet)
Seat 7: Ouga Buga (small blind) folded before Flop
Seat 8: matiko09 (big blind) folded before Flop
Seat 9: Racushniak folded before Flop (didn't bet)





PokerStars Hand #152661880614:  Hold'em No Limit ($0.50/$1.00 USD) - 2016/04/30 18:25:38 CET [2016/04/30 12:25:38 ET]
Table 'Arcturus' 9-max Seat #4 is the button
Seat 1: matiko09 ($100 in chips) 
Seat 3: Spid1 ($109.20 in chips) 
Seat 4: cap. marb ($46.38 in chips) 
Seat 5: Ilov3NBA ($103.12 in chips) 
Seat 6: WrongButton ($100 in chips) 
Seat 7: terrytsui111 ($86.88 in chips) 
Seat 8: ApkawaDavit ($100 in chips) 
Seat 9: fishkida ($180.95 in chips) 
Ilov3NBA: posts small blind $0.50
WrongButton: posts big blind $1
hurtNCYDE: sits out 
*** HOLE CARDS ***
Dealt to matiko09 [Ah 7c]
terrytsui111: folds 
ApkawaDavit: folds 
fishkida: folds 
matiko09: folds 
Spid1: folds 
terrytsui111 leaves the table
cap. marb: folds 
Ilov3NBA: folds 
Uncalled bet ($0.50) returned to WrongButton
WrongButton collected $1 from pot
*** SUMMARY ***
Total pot $1 | Rake $0 
Seat 1: matiko09 folded before Flop (didn't bet)
Seat 3: Spid1 folded before Flop (didn't bet)
Seat 4: cap. marb (button) folded before Flop (didn't bet)
Seat 5: Ilov3NBA (small blind) folded before Flop
Seat 6: WrongButton (big blind) collected ($1)
Seat 7: terrytsui111 folded before Flop (didn't bet)
Seat 8: ApkawaDavit folded before Flop (didn't bet)
Seat 9: fishkida folded before Flop (didn't bet)





PokerStars Hand #152661882547:  Hold'em No Limit ($0.50/$1.00 USD) - 2016/04/30 18:25:40 CET [2016/04/30 12:25:40 ET]
Table 'Dagmar' 9-max Seat #9 is the button
Seat 1: matiko09 ($100 in chips) 
Seat 2: Spid1 ($167.45 in chips) 
Seat 3: ApkawaDavit ($124.20 in chips) 
Seat 4: legnulk ($178.77 in chips) 
Seat 6: arctur17 ($120.64 in chips) 
Seat 7: kswmh ($95.62 in chips) 
Seat 8: maxxmeister ($101 in chips) 
Seat 9: okkernoot111 ($149.35 in chips) 
matiko09: posts small blind $0.50
Spid1: posts big blind $1
cap. marb: sits out 
*** HOLE CARDS ***
Dealt to matiko09 [8h 3s]
ApkawaDavit: raises $2 to $3
legnulk: folds 
arctur17: calls $3
kswmh: folds 
maxxmeister: calls $3
okkernoot111: folds 
matiko09: folds 
Spid1: folds 
*** FLOP *** [Js 2c Ac]
ApkawaDavit: checks 
arctur17: checks 
maxxmeister: bets $9
ApkawaDavit: folds 
arctur17: calls $9
*** TURN *** [Js 2c Ac] [Ah]
arctur17: checks 
maxxmeister: bets $26
arctur17: folds 
Uncalled bet ($26) returned to maxxmeister
maxxmeister collected $27.08 from pot
maxxmeister: doesn't show hand 
*** SUMMARY ***
Total pot $28.50 | Rake $1.42 
Board [Js 2c Ac Ah]
Seat 1: matiko09 (small blind) folded before Flop
Seat 2: Spid1 (big blind) folded before Flop
Seat 3: ApkawaDavit folded on the Flop
Seat 4: legnulk folded before Flop (didn't bet)
Seat 6: arctur17 folded on the Turn
Seat 7: kswmh folded before Flop (didn't bet)
Seat 8: maxxmeister collected ($27.08)
Seat 9: okkernoot111 (button) folded before Flop (didn't bet)





PokerStars Hand #152661890608:  Hold'em No Limit ($0.50/$1.00 USD) - 2016/04/30 18:25:51 CET [2016/04/30 12:25:51 ET]
Table 'Malautra II' 9-max Seat #1 is the button
Seat 1: Fivez ($118.68 in chips) 
Seat 2: Ilov3NBA ($177.78 in chips) 
Seat 3: WrongButton ($101.50 in chips) 
Seat 5: hurtNCYDE ($100 in chips) 
Seat 6: matiko09 ($101.50 in chips) 
Seat 8: Nito Lansky ($74.95 in chips) 
Seat 9: cap. marb ($39.50 in chips) 
Ilov3NBA: posts small blind $0.50
WrongButton: posts big blind $1
RoadtoNepal: sits out 
*** HOLE CARDS ***
Dealt to matiko09 [2c 3s]
hurtNCYDE: folds 
matiko09: folds 
Nito Lansky: calls $1
cap. marb: folds 
Fivez: folds 
Ilov3NBA: raises $3.50 to $4.50
WrongButton: folds 
Nito Lansky: calls $3.50
*** FLOP *** [8c 3d Ac]
Ilov3NBA: bets $7.03
Nito Lansky: calls $7.03
*** TURN *** [8c 3d Ac] [9c]
Ilov3NBA: checks 
Nito Lansky: bets $10
Ilov3NBA: calls $10
*** RIVER *** [8c 3d Ac 9c] [9d]
Spid1 joins the table at seat #7 
Spid1 leaves the table
Ilov3NBA: checks 
Nito Lansky: bets $15
Ilov3NBA: calls $15
*** SHOW DOWN ***
Nito Lansky: shows [Qs As] (two pair, Aces and Nines)
Ilov3NBA: mucks hand 
Nito Lansky collected $71.56 from pot
*** SUMMARY ***
Total pot $74.06 | Rake $2.50 
Board [8c 3d Ac 9c 9d]
Seat 1: Fivez (button) folded before Flop (didn't bet)
Seat 2: Ilov3NBA (small blind) mucked [Ah Jh]
Seat 3: WrongButton (big blind) folded before Flop
Seat 5: hurtNCYDE folded before Flop (didn't bet)
Seat 6: matiko09 folded before Flop (didn't bet)
Seat 8: Nito Lansky showed [Qs As] and won ($71.56) with two pair, Aces and Nines
Seat 9: cap. marb folded before Flop (didn't bet)





PokerStars Hand #152661894096:  Hold'em No Limit ($0.50/$1.00 USD) - 2016/04/30 18:25:55 CET [2016/04/30 12:25:55 ET]
Table 'Tamariwa' 9-max Seat #1 is the button
Seat 1: koksskrt ($100 in chips) 
Seat 2: GGROBB ($79.30 in chips) 
Seat 3: matiko09 ($100 in chips) 
Seat 4: cap. marb ($45.76 in chips) 
Seat 5: Lobbyist98 ($105.66 in chips) 
Seat 6: El tourist ($56.06 in chips) 
Seat 8: JWU418 ($69.91 in chips) 
Seat 9: ApkawaDavit ($159.90 in chips) 
GGROBB: posts small blind $0.50
matiko09: posts big blind $1
*** HOLE CARDS ***
Dealt to matiko09 [Ks 9s]
cap. marb: raises $1.12 to $2.12
Lobbyist98: folds 
El tourist: calls $2.12
JWU418: folds 
ApkawaDavit: folds 
koksskrt: folds 
GGROBB: folds 
matiko09: folds 
*** FLOP *** [2d 3s 4d]
cap. marb: checks 
El tourist: bets $3
cap. marb: folds 
Uncalled bet ($3) returned to El tourist
El tourist collected $5.45 from pot
El tourist: doesn't show hand 
*** SUMMARY ***
Total pot $5.74 | Rake $0.29 
Board [2d 3s 4d]
Seat 1: koksskrt (button) folded before Flop (didn't bet)
Seat 2: GGROBB (small blind) folded before Flop
Seat 3: matiko09 (big blind) folded before Flop
Seat 4: cap. marb folded on the Flop
Seat 5: Lobbyist98 folded before Flop (didn't bet)
Seat 6: El tourist collected ($5.45)
Seat 8: JWU418 folded before Flop (didn't bet)
Seat 9: ApkawaDavit folded before Flop (didn't bet)





PokerStars Hand #152661903118:  Hold'em No Limit ($0.50/$1.00 USD) - 2016/04/30 18:26:07 CET [2016/04/30 12:26:07 ET]
Table 'Lova II' 9-max Seat #9 is the button
Seat 2: bilukm ($281.74 in chips) 
Seat 3: matiko09 ($102.72 in chips) 
Seat 4: VanDobeln ($127.95 in chips) 
Seat 5: Ilov3NBA ($193.50 in chips) 
Seat 6: di0d80 ($100 in chips) 
Seat 7: meysam270 ($42.93 in chips) 
Seat 8: cap. marb ($58.89 in chips) 
Seat 9: hurtNCYDE ($100 in chips) 
bilukm: posts small blind $0.50
matiko09: posts big blind $1
*** HOLE CARDS ***
Dealt to matiko09 [Qs Kd]
VanDobeln: folds 
Ilov3NBA: folds 
di0d80: folds 
meysam270: folds 
cap. marb: folds 
hurtNCYDE: raises $1.50 to $2.50
bilukm: folds 
matiko09: calls $1.50
*** FLOP *** [5c 4c 4s]
matiko09: checks 
hurtNCYDE: bets $1.77
matiko09: calls $1.77
*** TURN *** [5c 4c 4s] [4d]
matiko09: checks 
hurtNCYDE: bets $10.50
matiko09: folds 
Uncalled bet ($10.50) returned to hurtNCYDE
hurtNCYDE collected $8.59 from pot
*** SUMMARY ***
Total pot $9.04 | Rake $0.45 
Board [5c 4c 4s 4d]
Seat 2: bilukm (small blind) folded before Flop
Seat 3: matiko09 (big blind) folded on the Turn
Seat 4: VanDobeln folded before Flop (didn't bet)
Seat 5: Ilov3NBA folded before Flop (didn't bet)
Seat 6: di0d80 folded before Flop (didn't bet)
Seat 7: meysam270 folded before Flop (didn't bet)
Seat 8: cap. marb folded before Flop (didn't bet)
Seat 9: hurtNCYDE (button) collected ($8.59)





PokerStars Hand #152661906883:  Hold'em No Limit (€0.50/€1.00 EUR) - 2016/04/30 18:26:12 CET [2016/04/30 12:26:12 ET]
Table 'Benda' 9-max Seat #7 is the button
Seat 1: aquarua7 (€213.31 in chips) 
Seat 2: cap. marb (€39.50 in chips) 
Seat 3: ApkawaDavit (€106.20 in chips) 
Seat 4: fireball2112 (€78.18 in chips) 
Seat 5: hurtNCYDE (€102.25 in chips) 
Seat 6: Nunzio1985ct (€38.41 in chips) 
Seat 7: Ouga Buga (€100.18 in chips) 
Seat 8: matiko09 (€100 in chips) 
Seat 9: Racushniak (€157.45 in chips) 
matiko09: posts small blind €0.50
Racushniak: posts big blind €1
*** HOLE CARDS ***
Dealt to matiko09 [3s 6h]
aquarua7: folds 
cap. marb: folds 
ApkawaDavit: raises €2 to €3
fireball2112: folds 
hurtNCYDE: folds 
Nunzio1985ct: folds 
Ouga Buga: raises €6.50 to €9.50
matiko09: folds 
Racushniak: folds 
ApkawaDavit: folds 
Uncalled bet (€6.50) returned to Ouga Buga
Ouga Buga collected €7.50 from pot
Ouga Buga: doesn't show hand 
*** SUMMARY ***
Total pot €7.50 | Rake €0 
Seat 1: aquarua7 folded before Flop (didn't bet)
Seat 2: cap. marb folded before Flop (didn't bet)
Seat 3: ApkawaDavit folded before Flop
Seat 4: fireball2112 folded before Flop (didn't bet)
Seat 5: hurtNCYDE folded before Flop (didn't bet)
Seat 6: Nunzio1985ct folded before Flop (didn't bet)
Seat 7: Ouga Buga (button) collected (€7.50)
Seat 8: matiko09 (small blind) folded before Flop
Seat 9: Racushniak (big blind) folded before Flop





PokerStars Hand #152661907816:  Hold'em No Limit ($0.50/$1.00 USD) - 2016/04/30 18:26:13 CET [2016/04/30 12:26:13 ET]
Table 'Arcturus' 9-max Seat #5 is the button
Seat 1: matiko09 ($100 in chips) 
Seat 3: Spid1 ($109.20 in chips) 
Seat 4: cap. marb ($46.38 in chips) 
Seat 5: Ilov3NBA ($102.62 in chips) 
Seat 6: WrongButton ($100.50 in chips) 
Seat 8: ApkawaDavit ($100 in chips) 
Seat 9: fishkida ($180.95 in chips) 
WrongButton: posts small blind $0.50
ApkawaDavit: posts big blind $1
hurtNCYDE: sits out 
*** HOLE CARDS ***
Dealt to matiko09 [Th 5h]
fishkida: folds 
matiko09: folds 
Spid1: folds 
fishkida leaves the table
cap. marb: folds 
koksskrt joins the table at seat #9 
koksskrt leaves the table
Ilov3NBA: folds 
WrongButton: folds 
Uncalled bet ($0.50) returned to ApkawaDavit
ApkawaDavit collected $1 from pot
ApkawaDavit: doesn't show hand 
*** SUMMARY ***
Total pot $1 | Rake $0 
Seat 1: matiko09 folded before Flop (didn't bet)
Seat 3: Spid1 folded before Flop (didn't bet)
Seat 4: cap. marb folded before Flop (didn't bet)
Seat 5: Ilov3NBA (button) folded before Flop (didn't bet)
Seat 6: WrongButton (small blind) folded before Flop
Seat 8: ApkawaDavit (big blind) collected ($1)
Seat 9: fishkida folded before Flop (didn't bet)





PokerStars Hand #152661910550:  Hold'em No Limit ($0.50/$1.00 USD) - 2016/04/30 18:26:17 CET [2016/04/30 12:26:17 ET]
Table 'Alshat' 9-max Seat #5 is the button
Seat 1: marko3213 ($64 in chips) 
Seat 3: matiko09 ($100 in chips) 
Seat 4: cap. marb ($38.50 in chips) 
Seat 5: edragonl1 ($81.40 in chips) 
Seat 6: Stopton ($80 in chips) 
Seat 7: ilaviiitech ($100 in chips) 
Seat 8: WrongButton ($102.28 in chips) 
Seat 9: ApkawaDavit ($117 in chips) 
Stopton: posts small blind $0.50
ilaviiitech: posts big blind $1
*** HOLE CARDS ***
Dealt to matiko09 [Kc 2s]
WrongButton: folds 
ApkawaDavit: folds 
marko3213: raises $2 to $3
matiko09: folds 
cap. marb: folds 
edragonl1: folds 
Stopton: folds 
ilaviiitech: folds 
Uncalled bet ($2) returned to marko3213
marko3213 collected $2.50 from pot
*** SUMMARY ***
Total pot $2.50 | Rake $0 
Seat 1: marko3213 collected ($2.50)
Seat 3: matiko09 folded before Flop (didn't bet)
Seat 4: cap. marb folded before Flop (didn't bet)
Seat 5: edragonl1 (button) folded before Flop (didn't bet)
Seat 6: Stopton (small blind) folded before Flop
Seat 7: ilaviiitech (big blind) folded before Flop
Seat 8: WrongButton folded before Flop (didn't bet)
Seat 9: ApkawaDavit folded before Flop (didn't bet)





PokerStars Hand #152661924007:  Hold'em No Limit ($0.50/$1.00 USD) - 2016/04/30 18:26:35 CET [2016/04/30 12:26:35 ET]
Table 'Raissa II' 9-max Seat #7 is the button
Seat 1: cap. marb ($43.56 in chips) 
Seat 2: azzad2007 ($121.40 in chips) 
Seat 3: iRivuLose ($106.21 in chips) 
Seat 4: koksskrt ($100 in chips) 
Seat 5: korlito69 ($54.23 in chips) 
Seat 6: hurtNCYDE ($100 in chips) 
Seat 7: matiko09 ($101.35 in chips) 
Seat 9: Ilov3NBA ($100 in chips) 
Ilov3NBA: posts small blind $0.50
cap. marb: posts big blind $1
*** HOLE CARDS ***
Dealt to matiko09 [2d 4s]
azzad2007: folds 
iRivuLose: folds 
koksskrt: folds 
korlito69: raises $2 to $3
hurtNCYDE: folds 
matiko09: folds 
Ilov3NBA: folds 
cap. marb: folds 
Uncalled bet ($2) returned to korlito69
korlito69 collected $2.50 from pot
korlito69: doesn't show hand 
*** SUMMARY ***
Total pot $2.50 | Rake $0 
Seat 1: cap. marb (big blind) folded before Flop
Seat 2: azzad2007 folded before Flop (didn't bet)
Seat 3: iRivuLose folded before Flop (didn't bet)
Seat 4: koksskrt folded before Flop (didn't bet)
Seat 5: korlito69 collected ($2.50)
Seat 6: hurtNCYDE folded before Flop (didn't bet)
Seat 7: matiko09 (button) folded before Flop (didn't bet)
Seat 9: Ilov3NBA (small blind) folded before Flop





PokerStars Hand #152661924358:  Hold'em No Limit (€0.50/€1.00 EUR) - 2016/04/30 18:26:35 CET [2016/04/30 12:26:35 ET]
Table 'Benda' 9-max Seat #8 is the button
Seat 1: aquarua7 (€213.31 in chips) 
Seat 2: cap. marb (€39.50 in chips) 
Seat 3: ApkawaDavit (€103.20 in chips) 
Seat 4: fireball2112 (€78.18 in chips) 
Seat 5: hurtNCYDE (€102.25 in chips) 
Seat 6: Nunzio1985ct (€38.41 in chips) 
Seat 7: Ouga Buga (€104.68 in chips) 
Seat 8: matiko09 (€100 in chips) 
Seat 9: Racushniak (€156.45 in chips) 
Racushniak: posts small blind €0.50
aquarua7: posts big blind €1
*** HOLE CARDS ***
Dealt to matiko09 [5d Kc]
cap. marb: folds 
ApkawaDavit: folds 
fireball2112: folds 
hurtNCYDE: raises €1.50 to €2.50
Nunzio1985ct: folds 
Ouga Buga: folds 
matiko09: folds 
Racushniak: folds 
aquarua7: folds 
Uncalled bet (€1.50) returned to hurtNCYDE
hurtNCYDE collected €2.50 from pot
*** SUMMARY ***
Total pot €2.50 | Rake €0 
Seat 1: aquarua7 (big blind) folded before Flop
Seat 2: cap. marb folded before Flop (didn't bet)
Seat 3: ApkawaDavit folded before Flop (didn't bet)
Seat 4: fireball2112 folded before Flop (didn't bet)
Seat 5: hurtNCYDE collected (€2.50)
Seat 6: Nunzio1985ct folded before Flop (didn't bet)
Seat 7: Ouga Buga folded before Flop (didn't bet)
Seat 8: matiko09 (button) folded before Flop (didn't bet)
Seat 9: Racushniak (small blind) folded before Flop





PokerStars Hand #152661933307:  Hold'em No Limit ($0.50/$1.00 USD) - 2016/04/30 18:26:47 CET [2016/04/30 12:26:47 ET]
Table 'Dagmar' 9-max Seat #1 is the button
Seat 1: matiko09 ($100 in chips) 
Seat 2: Spid1 ($166.45 in chips) 
Seat 3: ApkawaDavit ($121.20 in chips) 
Seat 4: legnulk ($178.77 in chips) 
Seat 6: arctur17 ($108.64 in chips) 
Seat 7: kswmh ($95.62 in chips) 
Seat 8: maxxmeister ($116.08 in chips) 
Seat 9: okkernoot111 ($149.35 in chips) 
Spid1: posts small blind $0.50
ApkawaDavit: posts big blind $1
cap. marb: sits out 
*** HOLE CARDS ***
Dealt to matiko09 [6s 3s]
legnulk: calls $1
arctur17: folds 
kswmh: folds 
maxxmeister: folds 
okkernoot111: folds 
matiko09: folds 
Spid1: folds 
ApkawaDavit: checks 
*** FLOP *** [8h 7h 7s]
ApkawaDavit: checks 
legnulk: bets $2
ApkawaDavit: folds 
Uncalled bet ($2) returned to legnulk
legnulk collected $2.38 from pot
*** SUMMARY ***
Total pot $2.50 | Rake $0.12 
Board [8h 7h 7s]
Seat 1: matiko09 (button) folded before Flop (didn't bet)
Seat 2: Spid1 (small blind) folded before Flop
Seat 3: ApkawaDavit (big blind) folded on the Flop
Seat 4: legnulk collected ($2.38)
Seat 6: arctur17 folded before Flop (didn't bet)
Seat 7: kswmh folded before Flop (didn't bet)
Seat 8: maxxmeister folded before Flop (didn't bet)
Seat 9: okkernoot111 folded before Flop (didn't bet)





PokerStars Hand #152661938093:  Hold'em No Limit ($0.50/$1.00 USD) - 2016/04/30 18:26:53 CET [2016/04/30 12:26:53 ET]
Table 'Alshat' 9-max Seat #6 is the button
Seat 1: marko3213 ($66.50 in chips) 
Seat 3: matiko09 ($100 in chips) 
Seat 4: cap. marb ($38.50 in chips) 
Seat 5: edragonl1 ($81.40 in chips) 
Seat 6: Stopton ($79.50 in chips) 
Seat 7: ilaviiitech ($100 in chips) 
Seat 8: WrongButton ($102.28 in chips) 
Seat 9: ApkawaDavit ($117 in chips) 
ilaviiitech: posts small blind $0.50
WrongButton: posts big blind $1
*** HOLE CARDS ***
Dealt to matiko09 [Jh 7c]
ApkawaDavit: folds 
marko3213: folds 
matiko09: folds 
cap. marb: raises $1.12 to $2.12
edragonl1: calls $2.12
Stopton: folds 
ilaviiitech: folds 
WrongButton: calls $1.12
*** FLOP *** [4s 9h 6s]
WrongButton: checks 
cap. marb: checks 
edragonl1: bets $3
WrongButton: folds 
cap. marb: folds 
Uncalled bet ($3) returned to edragonl1
edragonl1 collected $6.52 from pot
edragonl1: doesn't show hand 
*** SUMMARY ***
Total pot $6.86 | Rake $0.34 
Board [4s 9h 6s]
Seat 1: marko3213 folded before Flop (didn't bet)
Seat 3: matiko09 folded before Flop (didn't bet)
Seat 4: cap. marb folded on the Flop
Seat 5: edragonl1 collected ($6.52)
Seat 6: Stopton (button) folded before Flop (didn't bet)
Seat 7: ilaviiitech (small blind) folded before Flop
Seat 8: WrongButton (big blind) folded on the Flop
Seat 9: ApkawaDavit folded before Flop (didn't bet)





PokerStars Hand #152661939990:  Hold'em No Limit ($0.50/$1.00 USD) - 2016/04/30 18:26:56 CET [2016/04/30 12:26:56 ET]
Table 'Tamariwa' 9-max Seat #2 is the button
Seat 1: koksskrt ($100 in chips) 
Seat 2: GGROBB ($78.80 in chips) 
Seat 3: matiko09 ($100 in chips) 
Seat 4: cap. marb ($43.64 in chips) 
Seat 5: Lobbyist98 ($105.66 in chips) 
Seat 6: El tourist ($59.39 in chips) 
Seat 8: JWU418 ($69.91 in chips) 
Seat 9: ApkawaDavit ($159.90 in chips) 
matiko09: posts small blind $0.50
cap. marb: posts big blind $1
*** HOLE CARDS ***
Dealt to matiko09 [2d 9d]
Lobbyist98: folds 
El tourist: folds 
JWU418: folds 
ApkawaDavit: folds 
koksskrt: folds 
GGROBB: folds 
matiko09: folds 
Uncalled bet ($0.50) returned to cap. marb
cap. marb collected $1 from pot
cap. marb: doesn't show hand 
*** SUMMARY ***
Total pot $1 | Rake $0 
Seat 1: koksskrt folded before Flop (didn't bet)
Seat 2: GGROBB (button) folded before Flop (didn't bet)
Seat 3: matiko09 (small blind) folded before Flop
Seat 4: cap. marb (big blind) collected ($1)
Seat 5: Lobbyist98 folded before Flop (didn't bet)
Seat 6: El tourist folded before Flop (didn't bet)
Seat 8: JWU418 folded before Flop (didn't bet)
Seat 9: ApkawaDavit folded before Flop (didn't bet)





PokerStars Hand #152661946217:  Hold'em No Limit (€0.50/€1.00 EUR) - 2016/04/30 18:27:04 CET [2016/04/30 12:27:04 ET]
Table 'Benda' 9-max Seat #9 is the button
Seat 1: aquarua7 (€212.31 in chips) 
Seat 2: cap. marb (€39.50 in chips) 
Seat 3: ApkawaDavit (€103.20 in chips) 
Seat 4: fireball2112 (€78.18 in chips) 
Seat 5: hurtNCYDE (€103.75 in chips) 
Seat 6: Nunzio1985ct (€38.41 in chips) 
Seat 7: Ouga Buga (€104.68 in chips) 
Seat 8: matiko09 (€100 in chips) 
Seat 9: Racushniak (€155.95 in chips) 
aquarua7: posts small blind €0.50
cap. marb: posts big blind €1
*** HOLE CARDS ***
Dealt to matiko09 [3s Kc]
ApkawaDavit: folds 
fireball2112: folds 
hurtNCYDE: folds 
Nunzio1985ct: calls €1
Ouga Buga: raises €2.50 to €3.50
matiko09: folds 
Racushniak: folds 
aquarua7: folds 
cap. marb: folds 
Nunzio1985ct: calls €2.50
*** FLOP *** [8c Th Qc]
Nunzio1985ct: checks 
Ouga Buga: checks 
*** TURN *** [8c Th Qc] [3d]
Nunzio1985ct: bets €2
Ouga Buga: folds 
Uncalled bet (€2) returned to Nunzio1985ct
Nunzio1985ct collected €8.08 from pot
*** SUMMARY ***
Total pot €8.50 | Rake €0.42 
Board [8c Th Qc 3d]
Seat 1: aquarua7 (small blind) folded before Flop
Seat 2: cap. marb (big blind) folded before Flop
Seat 3: ApkawaDavit folded before Flop (didn't bet)
Seat 4: fireball2112 folded before Flop (didn't bet)
Seat 5: hurtNCYDE folded before Flop (didn't bet)
Seat 6: Nunzio1985ct collected (€8.08)
Seat 7: Ouga Buga folded on the Turn
Seat 8: matiko09 folded before Flop (didn't bet)
Seat 9: Racushniak (button) folded before Flop (didn't bet)





PokerStars Hand #152661952787:  Hold'em No Limit ($0.50/$1.00 USD) - 2016/04/30 18:27:13 CET [2016/04/30 12:27:13 ET]
Table 'Tamariwa' 9-max Seat #3 is the button
Seat 1: koksskrt ($100 in chips) 
Seat 2: GGROBB ($78.80 in chips) 
Seat 3: matiko09 ($100 in chips) 
Seat 4: cap. marb ($44.14 in chips) 
Seat 5: Lobbyist98 ($105.66 in chips) 
Seat 6: El tourist ($59.39 in chips) 
Seat 8: JWU418 ($69.91 in chips) 
Seat 9: ApkawaDavit ($159.90 in chips) 
cap. marb: posts small blind $0.50
Lobbyist98: posts big blind $1
*** HOLE CARDS ***
Dealt to matiko09 [9s Ts]
El tourist: raises $1 to $2
JWU418: folds 
ApkawaDavit: raises $5.50 to $7.50
koksskrt: folds 
GGROBB: raises $11.50 to $19
matiko09: folds 
cap. marb: folds 
Lobbyist98: folds 
El tourist: folds 
ApkawaDavit: raises $12 to $31
GGROBB: calls $12
*** FLOP *** [4c 6s 7s]
ApkawaDavit: bets $8
GGROBB: calls $8
*** TURN *** [4c 6s 7s] [6d]
ApkawaDavit: bets $8
GGROBB: raises $31.80 to $39.80 and is all-in
ApkawaDavit: calls $31.80
*** RIVER *** [4c 6s 7s 6d] [8d]
*** SHOW DOWN ***
ApkawaDavit: shows [As Ad] (two pair, Aces and Sixes)
GGROBB: shows [Kc Kd] (two pair, Kings and Sixes)
ApkawaDavit collected $158.60 from pot
*** SUMMARY ***
Total pot $161.10 | Rake $2.50 
Board [4c 6s 7s 6d 8d]
Seat 1: koksskrt folded before Flop (didn't bet)
Seat 2: GGROBB showed [Kc Kd] and lost with two pair, Kings and Sixes
Seat 3: matiko09 (button) folded before Flop (didn't bet)
Seat 4: cap. marb (small blind) folded before Flop
Seat 5: Lobbyist98 (big blind) folded before Flop
Seat 6: El tourist folded before Flop
Seat 8: JWU418 folded before Flop (didn't bet)
Seat 9: ApkawaDavit showed [As Ad] and won ($158.60) with two pair, Aces and Sixes





PokerStars Hand #152661955238:  Hold'em No Limit ($0.50/$1.00 USD) - 2016/04/30 18:27:16 CET [2016/04/30 12:27:16 ET]
Table 'Lova II' 9-max Seat #2 is the button
Seat 2: bilukm ($281.24 in chips) 
Seat 3: matiko09 ($100 in chips) 
Seat 4: VanDobeln ($127.95 in chips) 
Seat 5: Ilov3NBA ($193.50 in chips) 
Seat 6: di0d80 ($100 in chips) 
Seat 7: meysam270 ($42.93 in chips) 
Seat 8: cap. marb ($58.89 in chips) 
Seat 9: hurtNCYDE ($104.32 in chips) 
matiko09: posts small blind $0.50
VanDobeln: posts big blind $1
*** HOLE CARDS ***
Dealt to matiko09 [Qd 8h]
Ilov3NBA: folds 
di0d80: folds 
meysam270: folds 
cap. marb: folds 
hurtNCYDE: folds 
bilukm: calls $1
matiko09: calls $0.50
VanDobeln: checks 
*** FLOP *** [9s Qs Ah]
matiko09: checks 
VanDobeln: checks 
bilukm: checks 
*** TURN *** [9s Qs Ah] [6s]
matiko09: checks 
VanDobeln: checks 
bilukm: checks 
*** RIVER *** [9s Qs Ah 6s] [Qc]
matiko09: bets $1.48
VanDobeln: folds 
bilukm: folds 
Uncalled bet ($1.48) returned to matiko09
matiko09 collected $2.85 from pot
matiko09: doesn't show hand 
*** SUMMARY ***
Total pot $3 | Rake $0.15 
Board [9s Qs Ah 6s Qc]
Seat 2: bilukm (button) folded on the River
Seat 3: matiko09 (small blind) collected ($2.85)
Seat 4: VanDobeln (big blind) folded on the River
Seat 5: Ilov3NBA folded before Flop (didn't bet)
Seat 6: di0d80 folded before Flop (didn't bet)
Seat 7: meysam270 folded before Flop (didn't bet)
Seat 8: cap. marb folded before Flop (didn't bet)
Seat 9: hurtNCYDE folded before Flop (didn't bet)





PokerStars Hand #152661962009:  Hold'em No Limit ($0.50/$1.00 USD) - 2016/04/30 18:27:25 CET [2016/04/30 12:27:25 ET]
Table 'Raissa II' 9-max Seat #9 is the button
Seat 1: cap. marb ($42.56 in chips) 
Seat 2: azzad2007 ($121.40 in chips) 
Seat 3: iRivuLose ($106.21 in chips) 
Seat 4: koksskrt ($100 in chips) 
Seat 5: korlito69 ($55.73 in chips) 
Seat 6: hurtNCYDE ($100 in chips) 
Seat 7: matiko09 ($101.35 in chips) 
Seat 9: Ilov3NBA ($100 in chips) 
cap. marb: posts small blind $0.50
azzad2007: posts big blind $1
*** HOLE CARDS ***
Dealt to matiko09 [3h 6h]
iRivuLose: raises $1.10 to $2.10
koksskrt: folds 
korlito69: calls $2.10
hurtNCYDE: raises $7.90 to $10
matiko09: folds 
Ilov3NBA: folds 
cap. marb: folds 
azzad2007: folds 
iRivuLose: folds 
korlito69: folds 
Uncalled bet ($7.90) returned to hurtNCYDE
hurtNCYDE collected $7.80 from pot
hurtNCYDE: doesn't show hand 
*** SUMMARY ***
Total pot $7.80 | Rake $0 
Seat 1: cap. marb (small blind) folded before Flop
Seat 2: azzad2007 (big blind) folded before Flop
Seat 3: iRivuLose folded before Flop
Seat 4: koksskrt folded before Flop (didn't bet)
Seat 5: korlito69 folded before Flop
Seat 6: hurtNCYDE collected ($7.80)
Seat 7: matiko09 folded before Flop (didn't bet)
Seat 9: Ilov3NBA (button) folded before Flop (didn't bet)





PokerStars Hand #152661965714:  Hold'em No Limit ($0.50/$1.00 USD) - 2016/04/30 18:27:30 CET [2016/04/30 12:27:30 ET]
Table 'Dagmar' 9-max Seat #2 is the button
Seat 1: matiko09 ($100 in chips) 
Seat 2: Spid1 ($165.95 in chips) 
Seat 3: ApkawaDavit ($120.20 in chips) 
Seat 4: legnulk ($180.15 in chips) 
Seat 6: arctur17 ($108.64 in chips) 
Seat 7: kswmh ($95.62 in chips) 
Seat 8: maxxmeister ($116.08 in chips) 
Seat 9: okkernoot111 ($149.35 in chips) 
ApkawaDavit: posts small blind $0.50
legnulk: posts big blind $1
cap. marb: sits out 
*** HOLE CARDS ***
Dealt to matiko09 [6d Jc]
arctur17: raises $2 to $3
kswmh: calls $3
maxxmeister: folds 
okkernoot111: folds 
matiko09: folds 
Spid1: folds 
ApkawaDavit: folds 
legnulk: calls $2
*** FLOP *** [3s 6c Kh]
legnulk: checks 
arctur17: checks 
kswmh: checks 
*** TURN *** [3s 6c Kh] [Jd]
legnulk: checks 
arctur17: checks 
kswmh: checks 
*** RIVER *** [3s 6c Kh Jd] [5h]
legnulk: checks 
arctur17: checks 
kswmh: checks 
*** SHOW DOWN ***
legnulk: shows [9d 9s] (a pair of Nines)
arctur17: shows [Td Th] (a pair of Tens)
kswmh: mucks hand 
arctur17 collected $9.02 from pot
*** SUMMARY ***
Total pot $9.50 | Rake $0.48 
Board [3s 6c Kh Jd 5h]
Seat 1: matiko09 folded before Flop (didn't bet)
Seat 2: Spid1 (button) folded before Flop (didn't bet)
Seat 3: ApkawaDavit (small blind) folded before Flop
Seat 4: legnulk (big blind) showed [9d 9s] and lost with a pair of Nines
Seat 6: arctur17 showed [Td Th] and won ($9.02) with a pair of Tens
Seat 7: kswmh mucked [4c As]
Seat 8: maxxmeister folded before Flop (didn't bet)
Seat 9: okkernoot111 folded before Flop (didn't bet)





PokerStars Hand #152661972274:  Hold'em No Limit ($0.50/$1.00 USD) - 2016/04/30 18:27:38 CET [2016/04/30 12:27:38 ET]
Table 'Alshat' 9-max Seat #7 is the button
Seat 1: marko3213 ($66.50 in chips) 
Seat 3: matiko09 ($100 in chips) 
Seat 4: cap. marb ($36.38 in chips) 
Seat 5: edragonl1 ($85.80 in chips) 
Seat 6: Stopton ($79.50 in chips) 
Seat 7: ilaviiitech ($100 in chips) 
Seat 8: WrongButton ($100.16 in chips) 
Seat 9: ApkawaDavit ($117 in chips) 
WrongButton: posts small blind $0.50
ApkawaDavit: posts big blind $1
*** HOLE CARDS ***
Dealt to matiko09 [Jd Ac]
marko3213: folds 
matiko09: raises $2 to $3
cap. marb: folds 
edragonl1: calls $3
Stopton: folds 
ilaviiitech: folds 
WrongButton: calls $2.50
ApkawaDavit: folds 
*** FLOP *** [4h 4c Qd]
WrongButton: checks 
matiko09: bets $6
edragonl1: calls $6
WrongButton: folds 
*** TURN *** [4h 4c Qd] [7c]
matiko09: checks 
edragonl1: bets $5
matiko09: folds 
Uncalled bet ($5) returned to edragonl1
edragonl1 collected $20.90 from pot
edragonl1: doesn't show hand 
*** SUMMARY ***
Total pot $22 | Rake $1.10 
Board [4h 4c Qd 7c]
Seat 1: marko3213 folded before Flop (didn't bet)
Seat 3: matiko09 folded on the Turn
Seat 4: cap. marb folded before Flop (didn't bet)
Seat 5: edragonl1 collected ($20.90)
Seat 6: Stopton folded before Flop (didn't bet)
Seat 7: ilaviiitech (button) folded before Flop (didn't bet)
Seat 8: WrongButton (small blind) folded on the Flop
Seat 9: ApkawaDavit (big blind) folded before Flop





PokerStars Hand #152661987685:  Hold'em No Limit ($0.50/$1.00 USD) - 2016/04/30 18:27:59 CET [2016/04/30 12:27:59 ET]
Table 'Suleika II' 9-max Seat #3 is the button
Seat 1: ilaviiitech ($100 in chips) 
Seat 2: R1aki ($103.65 in chips) 
Seat 3: JACQUILF ($100 in chips) 
Seat 4: Spid1 ($100 in chips) 
Seat 5: matiko09 ($100 in chips) 
Seat 9: Lasse1793 ($48.38 in chips) 
Spid1: posts small blind $0.50
matiko09: posts big blind $1
cap. marb: sits out 
WrongButton: sits out 
*** HOLE CARDS ***
Dealt to matiko09 [3s Ad]
Lasse1793: raises $2 to $3
ilaviiitech: folds 
R1aki: folds 
JACQUILF: calls $3
Spid1: folds 
matiko09: folds 
*** FLOP *** [2c Qs 2d]
Lasse1793 is connected 
Lasse1793: bets $5
JACQUILF: folds 
Uncalled bet ($5) returned to Lasse1793
Lasse1793 collected $7.12 from pot
Lasse1793: doesn't show hand 
*** SUMMARY ***
Total pot $7.50 | Rake $0.38 
Board [2c Qs 2d]
Seat 1: ilaviiitech folded before Flop (didn't bet)
Seat 2: R1aki folded before Flop (didn't bet)
Seat 3: JACQUILF (button) folded on the Flop
Seat 4: Spid1 (small blind) folded before Flop
Seat 5: matiko09 (big blind) folded before Flop
Seat 9: Lasse1793 collected ($7.12)





PokerStars Hand #152661995035:  Hold'em No Limit ($0.50/$1.00 USD) - 2016/04/30 18:28:09 CET [2016/04/30 12:28:09 ET]
Table 'Dagmar' 9-max Seat #3 is the button
Seat 1: matiko09 ($100 in chips) 
Seat 2: Spid1 ($165.95 in chips) 
Seat 3: ApkawaDavit ($119.70 in chips) 
Seat 4: legnulk ($177.15 in chips) 
Seat 5: cap. marb ($40 in chips) 
Seat 6: arctur17 ($114.66 in chips) 
Seat 7: kswmh ($92.62 in chips) 
Seat 8: maxxmeister ($116.08 in chips) 
Seat 9: okkernoot111 ($149.35 in chips) 
legnulk: posts small blind $0.50
cap. marb: posts big blind $1
*** HOLE CARDS ***
Dealt to matiko09 [Ah 5d]
arctur17: folds 
kswmh: raises $1 to $2
maxxmeister: folds 
okkernoot111: folds 
matiko09: folds 
Spid1: folds 
ApkawaDavit: folds 
legnulk: folds 
cap. marb: folds 
Uncalled bet ($1) returned to kswmh
kswmh collected $2.50 from pot
kswmh: doesn't show hand 
*** SUMMARY ***
Total pot $2.50 | Rake $0 
Seat 1: matiko09 folded before Flop (didn't bet)
Seat 2: Spid1 folded before Flop (didn't bet)
Seat 3: ApkawaDavit (button) folded before Flop (didn't bet)
Seat 4: legnulk (small blind) folded before Flop
Seat 5: cap. marb (big blind) folded before Flop
Seat 6: arctur17 folded before Flop (didn't bet)
Seat 7: kswmh collected ($2.50)
Seat 8: maxxmeister folded before Flop (didn't bet)
Seat 9: okkernoot111 folded before Flop (didn't bet)





PokerStars Hand #152661996355:  Hold'em No Limit ($0.50/$1.00 USD) - 2016/04/30 18:28:11 CET [2016/04/30 12:28:11 ET]
Table 'Raissa II' 9-max Seat #1 is the button
Seat 1: cap. marb ($42.06 in chips) 
Seat 2: azzad2007 ($120.40 in chips) 
Seat 3: iRivuLose ($104.11 in chips) 
Seat 4: koksskrt ($100 in chips) 
Seat 5: korlito69 ($53.63 in chips) 
Seat 6: hurtNCYDE ($105.70 in chips) 
Seat 7: matiko09 ($101.35 in chips) 
Seat 9: Ilov3NBA ($100 in chips) 
azzad2007: posts small blind $0.50
iRivuLose: posts big blind $1
*** HOLE CARDS ***
Dealt to matiko09 [4s Js]
koksskrt: folds 
korlito69: folds 
hurtNCYDE: folds 
matiko09: folds 
Ilov3NBA: folds 
cap. marb: raises $1.12 to $2.12
azzad2007: folds 
iRivuLose: calls $1.12
*** FLOP *** [8s 3h 5c]
iRivuLose: checks 
cap. marb: bets $2.97
iRivuLose: folds 
Uncalled bet ($2.97) returned to cap. marb
cap. marb collected $4.50 from pot
cap. marb: doesn't show hand 
*** SUMMARY ***
Total pot $4.74 | Rake $0.24 
Board [8s 3h 5c]
Seat 1: cap. marb (button) collected ($4.50)
Seat 2: azzad2007 (small blind) folded before Flop
Seat 3: iRivuLose (big blind) folded on the Flop
Seat 4: koksskrt folded before Flop (didn't bet)
Seat 5: korlito69 folded before Flop (didn't bet)
Seat 6: hurtNCYDE folded before Flop (didn't bet)
Seat 7: matiko09 folded before Flop (didn't bet)
Seat 9: Ilov3NBA folded before Flop (didn't bet)





PokerStars Hand #152662008756:  Hold'em No Limit ($0.50/$1.00 USD) - 2016/04/30 18:28:27 CET [2016/04/30 12:28:27 ET]
Table 'Dagmar' 9-max Seat #4 is the button
Seat 1: matiko09 ($100 in chips) 
Seat 2: Spid1 ($165.95 in chips) 
Seat 3: ApkawaDavit ($119.70 in chips) 
Seat 4: legnulk ($176.65 in chips) 
Seat 5: cap. marb ($39 in chips) 
Seat 6: arctur17 ($114.66 in chips) 
Seat 7: kswmh ($94.12 in chips) 
Seat 8: maxxmeister ($116.08 in chips) 
Seat 9: okkernoot111 ($149.35 in chips) 
cap. marb: posts small blind $0.50
arctur17: posts big blind $1
*** HOLE CARDS ***
Dealt to matiko09 [2d 4h]
kswmh: folds 
maxxmeister: folds 
okkernoot111: folds 
matiko09: folds 
Spid1: folds 
ApkawaDavit: folds 
legnulk: raises $2 to $3
cap. marb: folds 
arctur17: calls $2
*** FLOP *** [8s Td Ts]
arctur17: checks 
legnulk: bets $4.63
arctur17: calls $4.63
*** TURN *** [8s Td Ts] [3s]
arctur17: checks 
legnulk: checks 
*** RIVER *** [8s Td Ts 3s] [Tc]
arctur17: checks 
legnulk: checks 
*** SHOW DOWN ***
arctur17: shows [9d Qs] (three of a kind, Tens)
legnulk: shows [Qc Ks] (three of a kind, Tens - King kicker)
legnulk collected $14.97 from pot
*** SUMMARY ***
Total pot $15.76 | Rake $0.79 
Board [8s Td Ts 3s Tc]
Seat 1: matiko09 folded before Flop (didn't bet)
Seat 2: Spid1 folded before Flop (didn't bet)
Seat 3: ApkawaDavit folded before Flop (didn't bet)
Seat 4: legnulk (button) showed [Qc Ks] and won ($14.97) with three of a kind, Tens
Seat 5: cap. marb (small blind) folded before Flop
Seat 6: arctur17 (big blind) showed [9d Qs] and lost with three of a kind, Tens
Seat 7: kswmh folded before Flop (didn't bet)
Seat 8: maxxmeister folded before Flop (didn't bet)
Seat 9: okkernoot111 folded before Flop (didn't bet)





PokerStars Hand #152662009265:  Hold'em No Limit ($0.50/$1.00 USD) - 2016/04/30 18:28:28 CET [2016/04/30 12:28:28 ET]
Table 'Lova II' 9-max Seat #3 is the button
Seat 2: bilukm ($280.24 in chips) 
Seat 3: matiko09 ($101.85 in chips) 
Seat 4: VanDobeln ($126.95 in chips) 
Seat 5: Ilov3NBA ($193.50 in chips) 
Seat 6: di0d80 ($100 in chips) 
Seat 7: meysam270 ($42.93 in chips) 
Seat 8: cap. marb ($58.89 in chips) 
Seat 9: hurtNCYDE ($104.32 in chips) 
VanDobeln: posts small blind $0.50
Ilov3NBA: posts big blind $1
*** HOLE CARDS ***
Dealt to matiko09 [Jc Ks]
di0d80: folds 
meysam270: folds 
cap. marb: folds 
hurtNCYDE: folds 
bilukm: folds 
matiko09: raises $1.27 to $2.27
VanDobeln: folds 
Ilov3NBA: calls $1.27
*** FLOP *** [Td 4c 8s]
Ilov3NBA: checks 
matiko09: bets $3.11
Ilov3NBA: folds 
Uncalled bet ($3.11) returned to matiko09
matiko09 collected $4.79 from pot
matiko09: doesn't show hand 
*** SUMMARY ***
Total pot $5.04 | Rake $0.25 
Board [Td 4c 8s]
Seat 2: bilukm folded before Flop (didn't bet)
Seat 3: matiko09 (button) collected ($4.79)
Seat 4: VanDobeln (small blind) folded before Flop
Seat 5: Ilov3NBA (big blind) folded on the Flop
Seat 6: di0d80 folded before Flop (didn't bet)
Seat 7: meysam270 folded before Flop (didn't bet)
Seat 8: cap. marb folded before Flop (didn't bet)
Seat 9: hurtNCYDE folded before Flop (didn't bet)





PokerStars Hand #152662010882:  Hold'em No Limit (€0.50/€1.00 EUR) - 2016/04/30 18:28:30 CET [2016/04/30 12:28:30 ET]
Table 'Benda' 9-max Seat #1 is the button
Seat 1: aquarua7 (€211.81 in chips) 
Seat 2: cap. marb (€38.50 in chips) 
Seat 3: ApkawaDavit (€103.20 in chips) 
Seat 4: fireball2112 (€78.18 in chips) 
Seat 5: hurtNCYDE (€103.75 in chips) 
Seat 6: Nunzio1985ct (€42.99 in chips) 
Seat 7: Ouga Buga (€101.18 in chips) 
Seat 8: matiko09 (€100 in chips) 
Seat 9: Racushniak (€155.95 in chips) 
cap. marb: posts small blind €0.50
ApkawaDavit: posts big blind €1
*** HOLE CARDS ***
Dealt to matiko09 [Kd Jc]
fireball2112: folds 
hurtNCYDE: folds 
Nunzio1985ct: folds 
Ouga Buga: folds 
matiko09: raises €2 to €3
Racushniak: folds 
aquarua7: folds 
cap. marb: folds 
ApkawaDavit: folds 
Uncalled bet (€2) returned to matiko09
matiko09 collected €2.50 from pot
matiko09: doesn't show hand 
*** SUMMARY ***
Total pot €2.50 | Rake €0 
Seat 1: aquarua7 (button) folded before Flop (didn't bet)
Seat 2: cap. marb (small blind) folded before Flop
Seat 3: ApkawaDavit (big blind) folded before Flop
Seat 4: fireball2112 folded before Flop (didn't bet)
Seat 5: hurtNCYDE folded before Flop (didn't bet)
Seat 6: Nunzio1985ct folded before Flop (didn't bet)
Seat 7: Ouga Buga folded before Flop (didn't bet)
Seat 8: matiko09 collected (€2.50)
Seat 9: Racushniak folded before Flop (didn't bet)





PokerStars Hand #152662025262:  Hold'em No Limit ($0.50/$1.00 USD) - 2016/04/30 18:28:49 CET [2016/04/30 12:28:49 ET]
Table 'Suleika II' 9-max Seat #4 is the button
Seat 1: ilaviiitech ($100 in chips) 
Seat 2: R1aki ($103.65 in chips) 
Seat 3: JACQUILF ($100 in chips) 
Seat 4: Spid1 ($100 in chips) 
Seat 5: matiko09 ($100 in chips) 
Seat 6: cap. marb ($40 in chips) 
Seat 9: Lasse1793 ($52.50 in chips) 
matiko09: posts small blind $0.50
cap. marb: posts big blind $1
WrongButton: sits out 
*** HOLE CARDS ***
Dealt to matiko09 [2d 7s]
Lasse1793: folds 
ilaviiitech: folds 
Lasse1793 leaves the table
Pacifistas leaves the table
R1aki: folds 
JACQUILF: folds 
Spid1: folds 
WrongButton leaves the table
matiko09: folds 
Uncalled bet ($0.50) returned to cap. marb
cap. marb collected $1 from pot
cap. marb: doesn't show hand 
*** SUMMARY ***
Total pot $1 | Rake $0 
Seat 1: ilaviiitech folded before Flop (didn't bet)
Seat 2: R1aki folded before Flop (didn't bet)
Seat 3: JACQUILF folded before Flop (didn't bet)
Seat 4: Spid1 (button) folded before Flop (didn't bet)
Seat 5: matiko09 (small blind) folded before Flop
Seat 6: cap. marb (big blind) collected ($1)
Seat 9: Lasse1793 folded before Flop (didn't bet)





PokerStars Hand #152662032882:  Hold'em No Limit (€0.50/€1.00 EUR) - 2016/04/30 18:28:59 CET [2016/04/30 12:28:59 ET]
Table 'Benda' 9-max Seat #2 is the button
Seat 1: aquarua7 (€211.81 in chips) 
Seat 2: cap. marb (€38 in chips) 
Seat 3: ApkawaDavit (€102.20 in chips) 
Seat 4: fireball2112 (€78.18 in chips) 
Seat 5: hurtNCYDE (€103.75 in chips) 
Seat 6: Nunzio1985ct (€42.99 in chips) 
Seat 7: Ouga Buga (€101.18 in chips) 
Seat 8: matiko09 (€101.50 in chips) 
Seat 9: Racushniak (€155.95 in chips) 
ApkawaDavit: posts small blind €0.50
fireball2112: posts big blind €1
*** HOLE CARDS ***
Dealt to matiko09 [Qh 4h]
hurtNCYDE: folds 
Nunzio1985ct: folds 
Ouga Buga: folds 
matiko09: folds 
Racushniak: folds 
aquarua7: folds 
cap. marb: folds 
ApkawaDavit: folds 
Uncalled bet (€0.50) returned to fireball2112
fireball2112 collected €1 from pot
fireball2112: doesn't show hand 
*** SUMMARY ***
Total pot €1 | Rake €0 
Seat 1: aquarua7 folded before Flop (didn't bet)
Seat 2: cap. marb (button) folded before Flop (didn't bet)
Seat 3: ApkawaDavit (small blind) folded before Flop
Seat 4: fireball2112 (big blind) collected (€1)
Seat 5: hurtNCYDE folded before Flop (didn't bet)
Seat 6: Nunzio1985ct folded before Flop (didn't bet)
Seat 7: Ouga Buga folded before Flop (didn't bet)
Seat 8: matiko09 folded before Flop (didn't bet)
Seat 9: Racushniak folded before Flop (didn't bet)





PokerStars Hand #152662034521:  Hold'em No Limit ($0.50/$1.00 USD) - 2016/04/30 18:29:02 CET [2016/04/30 12:29:02 ET]
Table 'Tamariwa' 9-max Seat #4 is the button
Seat 1: koksskrt ($100 in chips) 
Seat 3: matiko09 ($100 in chips) 
Seat 4: cap. marb ($43.64 in chips) 
Seat 5: Lobbyist98 ($104.66 in chips) 
Seat 6: El tourist ($57.39 in chips) 
Seat 8: JWU418 ($69.91 in chips) 
Seat 9: ApkawaDavit ($239.70 in chips) 
Lobbyist98: posts small blind $0.50
El tourist: posts big blind $1
*** HOLE CARDS ***
Dealt to matiko09 [3d Qh]
GGROBB leaves the table
hurtNCYDE joins the table at seat #2 
hurtNCYDE leaves the table
JWU418: folds 
ApkawaDavit: folds 
koksskrt: folds 
matiko09: folds 
ryanshades joins the table at seat #2 
cap. marb: raises $1.12 to $2.12
Lobbyist98: folds 
El tourist: calls $1.12
*** FLOP *** [Jc 3h 9s]
El tourist: checks 
cap. marb: bets $2.97
El tourist: calls $2.97
*** TURN *** [Jc 3h 9s] [3c]
El tourist: bets $4
cap. marb: raises $8.50 to $12.50
El tourist: calls $8.50
*** RIVER *** [Jc 3h 9s 3c] [Th]
El tourist: bets $10
cap. marb: raises $16.05 to $26.05 and is all-in
El tourist: calls $16.05
*** SHOW DOWN ***
cap. marb: shows [3s Ac] (three of a kind, Threes)
El tourist: mucks hand 
cap. marb collected $85.28 from pot
*** SUMMARY ***
Total pot $87.78 | Rake $2.50 
Board [Jc 3h 9s 3c Th]
Seat 1: koksskrt folded before Flop (didn't bet)
Seat 3: matiko09 folded before Flop (didn't bet)
Seat 4: cap. marb (button) showed [3s Ac] and won ($85.28) with three of a kind, Threes
Seat 5: Lobbyist98 (small blind) folded before Flop
Seat 6: El tourist (big blind) mucked [Jd Tc]
Seat 8: JWU418 folded before Flop (didn't bet)
Seat 9: ApkawaDavit folded before Flop (didn't bet)





PokerStars Hand #152662038284:  Hold'em No Limit ($0.50/$1.00 USD) - 2016/04/30 18:29:07 CET [2016/04/30 12:29:07 ET]
Table 'Raissa II' 9-max Seat #2 is the button
Seat 1: cap. marb ($44.44 in chips) 
Seat 2: azzad2007 ($119.90 in chips) 
Seat 3: iRivuLose ($101.99 in chips) 
Seat 4: koksskrt ($100 in chips) 
Seat 5: korlito69 ($53.63 in chips) 
Seat 6: hurtNCYDE ($105.70 in chips) 
Seat 7: matiko09 ($101.35 in chips) 
Seat 9: Ilov3NBA ($100 in chips) 
iRivuLose: posts small blind $0.50
koksskrt: posts big blind $1
*** HOLE CARDS ***
Dealt to matiko09 [6h Jd]
korlito69: raises $1 to $2
hurtNCYDE: folds 
matiko09: folds 
Ilov3NBA: folds 
cap. marb: folds 
azzad2007: folds 
iRivuLose: folds 
koksskrt: folds 
Uncalled bet ($1) returned to korlito69
korlito69 collected $2.50 from pot
korlito69: doesn't show hand 
*** SUMMARY ***
Total pot $2.50 | Rake $0 
Seat 1: cap. marb folded before Flop (didn't bet)
Seat 2: azzad2007 (button) folded before Flop (didn't bet)
Seat 3: iRivuLose (small blind) folded before Flop
Seat 4: koksskrt (big blind) folded before Flop
Seat 5: korlito69 collected ($2.50)
Seat 6: hurtNCYDE folded before Flop (didn't bet)
Seat 7: matiko09 folded before Flop (didn't bet)
Seat 9: Ilov3NBA folded before Flop (didn't bet)





PokerStars Hand #152662046851:  Hold'em No Limit ($0.50/$1.00 USD) - 2016/04/30 18:29:18 CET [2016/04/30 12:29:18 ET]
Table 'Suleika II' 9-max Seat #5 is the button
Seat 1: ilaviiitech ($100 in chips) 
Seat 2: R1aki ($103.65 in chips) 
Seat 3: JACQUILF ($100 in chips) 
Seat 4: Spid1 ($100 in chips) 
Seat 5: matiko09 ($100 in chips) 
Seat 6: cap. marb ($40.50 in chips) 
cap. marb: posts small blind $0.50
ilaviiitech: posts big blind $1
*** HOLE CARDS ***
Dealt to matiko09 [6h 8h]
hurtNCYDE joins the table at seat #7 
hurtNCYDE leaves the table
R1aki: folds 
R1aki leaves the table
JACQUILF: raises $2 to $3
Spid1: folds 
matiko09: folds 
cap. marb: folds 
ilaviiitech: folds 
Uncalled bet ($2) returned to JACQUILF
JACQUILF collected $2.50 from pot
JACQUILF: doesn't show hand 
*** SUMMARY ***
Total pot $2.50 | Rake $0 
Seat 1: ilaviiitech (big blind) folded before Flop
Seat 2: R1aki folded before Flop (didn't bet)
Seat 3: JACQUILF collected ($2.50)
Seat 4: Spid1 folded before Flop (didn't bet)
Seat 5: matiko09 (button) folded before Flop (didn't bet)
Seat 6: cap. marb (small blind) folded before Flop





PokerStars Hand #152662048401:  Hold'em No Limit ($0.50/$1.00 USD) - 2016/04/30 18:29:20 CET [2016/04/30 12:29:20 ET]
Table 'Goto' 9-max Seat #8 is the button
Seat 1: naaaate_diaz ($119.07 in chips) 
Seat 2: matiko09 ($114.42 in chips) 
Seat 3: cap. marb ($38.75 in chips) 
Seat 4: koksskrt ($100 in chips) 
Seat 5: Ilov3NBA ($102.25 in chips) 
Seat 6: puszi77 ($270.98 in chips) 
Seat 7: hurtNCYDE ($100 in chips) 
Seat 8: splicanin1 ($97 in chips) 
naaaate_diaz: posts small blind $0.50
matiko09: posts big blind $1
*** HOLE CARDS ***
Dealt to matiko09 [4d Tc]
cap. marb: folds 
koksskrt: folds 
Ilov3NBA: folds 
puszi77: calls $1
hurtNCYDE: folds 
splicanin1: folds 
naaaate_diaz: calls $0.50
matiko09: checks 
*** FLOP *** [4h 9c 4s]
naaaate_diaz: checks 
matiko09: bets $1.85
puszi77: folds 
naaaate_diaz: folds 
Uncalled bet ($1.85) returned to matiko09
matiko09 collected $2.85 from pot
matiko09: doesn't show hand 
*** SUMMARY ***
Total pot $3 | Rake $0.15 
Board [4h 9c 4s]
Seat 1: naaaate_diaz (small blind) folded on the Flop
Seat 2: matiko09 (big blind) collected ($2.85)
Seat 3: cap. marb folded before Flop (didn't bet)
Seat 4: koksskrt folded before Flop (didn't bet)
Seat 5: Ilov3NBA folded before Flop (didn't bet)
Seat 6: puszi77 folded on the Flop
Seat 7: hurtNCYDE folded before Flop (didn't bet)
Seat 8: splicanin1 (button) folded before Flop (didn't bet)





PokerStars Hand #152662055236:  Hold'em No Limit (€0.50/€1.00 EUR) - 2016/04/30 18:29:30 CET [2016/04/30 12:29:30 ET]
Table 'Benda' 9-max Seat #3 is the button
Seat 1: aquarua7 (€211.81 in chips) 
Seat 2: cap. marb (€38 in chips) 
Seat 3: ApkawaDavit (€101.70 in chips) 
Seat 4: fireball2112 (€78.68 in chips) 
Seat 5: hurtNCYDE (€103.75 in chips) 
Seat 6: Nunzio1985ct (€42.99 in chips) 
Seat 7: Ouga Buga (€101.18 in chips) 
Seat 8: matiko09 (€101.50 in chips) 
Seat 9: Racushniak (€155.95 in chips) 
fireball2112: posts small blind €0.50
hurtNCYDE: posts big blind €1
*** HOLE CARDS ***
Dealt to matiko09 [9h 7h]
Nunzio1985ct: folds 
Ouga Buga: folds 
matiko09: folds 
Racushniak: folds 
aquarua7: raises €1.50 to €2.50
cap. marb: folds 
ApkawaDavit: folds 
fireball2112: folds 
hurtNCYDE: calls €1.50
*** FLOP *** [5d 3d Kh]
hurtNCYDE: checks 
aquarua7: checks 
*** TURN *** [5d 3d Kh] [6s]
hurtNCYDE: bets €1.77
aquarua7: folds 
Uncalled bet (€1.77) returned to hurtNCYDE
hurtNCYDE collected €5.22 from pot
*** SUMMARY ***
Total pot €5.50 | Rake €0.28 
Board [5d 3d Kh 6s]
Seat 1: aquarua7 folded on the Turn
Seat 2: cap. marb folded before Flop (didn't bet)
Seat 3: ApkawaDavit (button) folded before Flop (didn't bet)
Seat 4: fireball2112 (small blind) folded before Flop
Seat 5: hurtNCYDE (big blind) collected (€5.22)
Seat 6: Nunzio1985ct folded before Flop (didn't bet)
Seat 7: Ouga Buga folded before Flop (didn't bet)
Seat 8: matiko09 folded before Flop (didn't bet)
Seat 9: Racushniak folded before Flop (didn't bet)





PokerStars Hand #152662055967:  Hold'em No Limit ($0.50/$1.00 USD) - 2016/04/30 18:29:31 CET [2016/04/30 12:29:31 ET]
Table 'Raissa II' 9-max Seat #3 is the button
Seat 1: cap. marb ($44.44 in chips) 
Seat 2: azzad2007 ($119.90 in chips) 
Seat 3: iRivuLose ($101.49 in chips) 
Seat 4: koksskrt ($100 in chips) 
Seat 5: korlito69 ($55.13 in chips) 
Seat 6: hurtNCYDE ($105.70 in chips) 
Seat 7: matiko09 ($101.35 in chips) 
Seat 9: Ilov3NBA ($100 in chips) 
koksskrt: posts small blind $0.50
korlito69: posts big blind $1
*** HOLE CARDS ***
Dealt to matiko09 [6c 3h]
hurtNCYDE: folds 
matiko09: folds 
Ilov3NBA: raises $2 to $3
cap. marb: folds 
azzad2007: folds 
iRivuLose: folds 
koksskrt: folds 
korlito69: calls $2
*** FLOP *** [2h 3c 7d]
korlito69: checks 
Ilov3NBA: checks 
*** TURN *** [2h 3c 7d] [Js]
korlito69: checks 
Ilov3NBA: checks 
*** RIVER *** [2h 3c 7d Js] [6s]
korlito69: checks 
Ilov3NBA: checks 
*** SHOW DOWN ***
korlito69: shows [Tc Qh] (high card Queen)
Ilov3NBA: shows [Kh As] (high card Ace)
Ilov3NBA collected $6.18 from pot
*** SUMMARY ***
Total pot $6.50 | Rake $0.32 
Board [2h 3c 7d Js 6s]
Seat 1: cap. marb folded before Flop (didn't bet)
Seat 2: azzad2007 folded before Flop (didn't bet)
Seat 3: iRivuLose (button) folded before Flop (didn't bet)
Seat 4: koksskrt (small blind) folded before Flop
Seat 5: korlito69 (big blind) showed [Tc Qh] and lost with high card Queen
Seat 6: hurtNCYDE folded before Flop (didn't bet)
Seat 7: matiko09 folded before Flop (didn't bet)
Seat 9: Ilov3NBA showed [Kh As] and won ($6.18) with high card Ace





PokerStars Hand #152662059268:  Hold'em No Limit ($0.50/$1.00 USD) - 2016/04/30 18:29:35 CET [2016/04/30 12:29:35 ET]
Table 'Lova II' 9-max Seat #4 is the button
Seat 2: bilukm ($280.24 in chips) 
Seat 3: matiko09 ($104.37 in chips) 
Seat 4: VanDobeln ($126.45 in chips) 
Seat 5: Ilov3NBA ($191.23 in chips) 
Seat 8: cap. marb ($58.89 in chips) 
Seat 9: hurtNCYDE ($104.32 in chips) 
Ilov3NBA: posts small blind $0.50
di0d80: is sitting out 
meysam270: is sitting out 
cap. marb: posts big blind $1
*** HOLE CARDS ***
Dealt to matiko09 [9h 7s]
hurtNCYDE: folds 
bilukm: calls $1
matiko09: folds 
VanDobeln: folds 
meysam270 leaves the table
Szevasztopol joins the table at seat #7 
Ilov3NBA: raises $3 to $4
cap. marb: folds 
bilukm: calls $3
*** FLOP *** [5c Tc Ac]
Ilov3NBA: bets $7
bilukm: calls $7
*** TURN *** [5c Tc Ac] [Jh]
Ilov3NBA: bets $18.50
bilukm: calls $18.50
*** RIVER *** [5c Tc Ac Jh] [Qc]
Ilov3NBA: checks 
bilukm: checks 
*** SHOW DOWN ***
Ilov3NBA: shows [5d 5s] (three of a kind, Fives)
bilukm: shows [6c 4c] (a flush, Ace high)
bilukm collected $57.50 from pot
*** SUMMARY ***
Total pot $60 | Rake $2.50 
Board [5c Tc Ac Jh Qc]
Seat 2: bilukm showed [6c 4c] and won ($57.50) with a flush, Ace high
Seat 3: matiko09 folded before Flop (didn't bet)
Seat 4: VanDobeln (button) folded before Flop (didn't bet)
Seat 5: Ilov3NBA (small blind) showed [5d 5s] and lost with three of a kind, Fives
Seat 8: cap. marb (big blind) folded before Flop
Seat 9: hurtNCYDE folded before Flop (didn't bet)





PokerStars Hand #152662063621:  Hold'em No Limit ($0.50/$1.00 USD) - 2016/04/30 18:29:41 CET [2016/04/30 12:29:41 ET]
Table 'Dagmar' 9-max Seat #5 is the button
Seat 1: matiko09 ($100 in chips) 
Seat 2: Spid1 ($165.95 in chips) 
Seat 3: ApkawaDavit ($119.70 in chips) 
Seat 4: legnulk ($183.99 in chips) 
Seat 5: cap. marb ($38.50 in chips) 
Seat 6: arctur17 ($107.03 in chips) 
Seat 7: kswmh ($94.12 in chips) 
Seat 8: maxxmeister ($116.08 in chips) 
Seat 9: okkernoot111 ($149.35 in chips) 
arctur17: posts small blind $0.50
kswmh: posts big blind $1
*** HOLE CARDS ***
Dealt to matiko09 [9d Ac]
maxxmeister: folds 
maxxmeister leaves the table
Ilov3NBA joins the table at seat #8 
okkernoot111: folds 
matiko09: folds 
Spid1: folds 
ApkawaDavit: folds 
legnulk: raises $2 to $3
cap. marb: folds 
arctur17: folds 
kswmh: calls $2
*** FLOP *** [Ks 9c As]
kswmh: bets $1
legnulk: raises $4 to $5
kswmh: calls $4
*** TURN *** [Ks 9c As] [Jh]
kswmh: bets $1
legnulk: calls $1
*** RIVER *** [Ks 9c As Jh] [8c]
kswmh: bets $1
legnulk: calls $1
*** SHOW DOWN ***
kswmh: shows [Kd Th] (a pair of Kings)
legnulk: mucks hand 
kswmh collected $19.48 from pot
*** SUMMARY ***
Total pot $20.50 | Rake $1.02 
Board [Ks 9c As Jh 8c]
Seat 1: matiko09 folded before Flop (didn't bet)
Seat 2: Spid1 folded before Flop (didn't bet)
Seat 3: ApkawaDavit folded before Flop (didn't bet)
Seat 4: legnulk mucked [Td 8h]
Seat 5: cap. marb (button) folded before Flop (didn't bet)
Seat 6: arctur17 (small blind) folded before Flop
Seat 7: kswmh (big blind) showed [Kd Th] and won ($19.48) with a pair of Kings
Seat 8: maxxmeister folded before Flop (didn't bet)
Seat 9: okkernoot111 folded before Flop (didn't bet)





PokerStars Hand #152662087658:  Hold'em No Limit ($0.50/$1.00 USD) - 2016/04/30 18:30:10 CET [2016/04/30 12:30:10 ET]
Table 'Goto' 9-max Seat #1 is the button
Seat 1: naaaate_diaz ($118.07 in chips) 
Seat 2: matiko09 ($116.27 in chips) 
Seat 3: cap. marb ($38.75 in chips) 
Seat 4: koksskrt ($100 in chips) 
Seat 5: Ilov3NBA ($102.25 in chips) 
Seat 6: puszi77 ($269.98 in chips) 
Seat 7: hurtNCYDE ($100 in chips) 
Seat 8: splicanin1 ($97 in chips) 
matiko09: posts small blind $0.50
cap. marb: posts big blind $1
*** HOLE CARDS ***
Dealt to matiko09 [6h 7c]
koksskrt: folds 
Ilov3NBA: folds 
puszi77: calls $1
hurtNCYDE: folds 
splicanin1: calls $1
naaaate_diaz: folds 
matiko09: folds 
cap. marb: checks 
*** FLOP *** [9s As Tc]
cap. marb: checks 
puszi77: checks 
splicanin1: bets $2
cap. marb: folds 
puszi77: calls $2
*** TURN *** [9s As Tc] [Td]
puszi77: checks 
splicanin1: checks 
*** RIVER *** [9s As Tc Td] [Ad]
puszi77: checks 
splicanin1: checks 
*** SHOW DOWN ***
puszi77: shows [Th Jh] (a full house, Tens full of Aces)
splicanin1: shows [Ac 9c] (a full house, Aces full of Tens)
splicanin1 collected $7.12 from pot
*** SUMMARY ***
Total pot $7.50 | Rake $0.38 
Board [9s As Tc Td Ad]
Seat 1: naaaate_diaz (button) folded before Flop (didn't bet)
Seat 2: matiko09 (small blind) folded before Flop
Seat 3: cap. marb (big blind) folded on the Flop
Seat 4: koksskrt folded before Flop (didn't bet)
Seat 5: Ilov3NBA folded before Flop (didn't bet)
Seat 6: puszi77 showed [Th Jh] and lost with a full house, Tens full of Aces
Seat 7: hurtNCYDE folded before Flop (didn't bet)
Seat 8: splicanin1 showed [Ac 9c] and won ($7.12) with a full house, Aces full of Tens





PokerStars Hand #152662099878:  Hold'em No Limit ($0.50/$1.00 USD) - 2016/04/30 18:30:26 CET [2016/04/30 12:30:26 ET]
Table 'Tamariwa' 9-max Seat #5 is the button
Seat 1: koksskrt ($100 in chips) 
Seat 2: ryanshades ($80 in chips) 
Seat 3: matiko09 ($100 in chips) 
Seat 4: cap. marb ($85.28 in chips) 
Seat 5: Lobbyist98 ($104.16 in chips) 
Seat 6: El tourist ($13.75 in chips) 
Seat 8: JWU418 ($69.91 in chips) 
Seat 9: ApkawaDavit ($239.70 in chips) 
El tourist: posts small blind $0.50
JWU418: posts big blind $1
ryanshades: posts big blind $1
*** HOLE CARDS ***
Dealt to matiko09 [8s Ac]
ApkawaDavit: folds 
koksskrt: folds 
ryanshades: checks 
matiko09: raises $3 to $4
cap. marb: folds 
Lobbyist98: calls $4
El tourist: calls $3.50
JWU418: folds 
ryanshades: folds 
*** FLOP *** [Tc 4d 3c]
El tourist: checks 
matiko09: checks 
Lobbyist98: checks 
*** TURN *** [Tc 4d 3c] [Ts]
El tourist: checks 
matiko09: checks 
Lobbyist98: checks 
*** RIVER *** [Tc 4d 3c Ts] [6h]
El tourist: checks 
matiko09: checks 
Lobbyist98: checks 
*** SHOW DOWN ***
El tourist: shows [8h 7h] (a pair of Tens)
matiko09: shows [8s Ac] (a pair of Tens - Ace kicker)
Lobbyist98: shows [Ah Ks] (a pair of Tens - Ace+King kicker)
Lobbyist98 collected $13.30 from pot
*** SUMMARY ***
Total pot $14 | Rake $0.70 
Board [Tc 4d 3c Ts 6h]
Seat 1: koksskrt folded before Flop (didn't bet)
Seat 2: ryanshades folded before Flop
Seat 3: matiko09 showed [8s Ac] and lost with a pair of Tens
Seat 4: cap. marb folded before Flop (didn't bet)
Seat 5: Lobbyist98 (button) showed [Ah Ks] and won ($13.30) with a pair of Tens
Seat 6: El tourist (small blind) showed [8h 7h] and lost with a pair of Tens
Seat 8: JWU418 (big blind) folded before Flop
Seat 9: ApkawaDavit folded before Flop (didn't bet)





PokerStars Hand #152662101382:  Hold'em No Limit (€0.50/€1.00 EUR) - 2016/04/30 18:30:28 CET [2016/04/30 12:30:28 ET]
Table 'Benda' 9-max Seat #4 is the button
Seat 1: aquarua7 (€209.31 in chips) 
Seat 2: cap. marb (€38 in chips) 
Seat 3: ApkawaDavit (€101.70 in chips) 
Seat 4: fireball2112 (€78.18 in chips) 
Seat 5: hurtNCYDE (€106.47 in chips) 
Seat 6: Nunzio1985ct (€42.99 in chips) 
Seat 7: Ouga Buga (€101.18 in chips) 
Seat 8: matiko09 (€101.50 in chips) 
Seat 9: Racushniak (€155.95 in chips) 
hurtNCYDE: posts small blind €0.50
Nunzio1985ct: posts big blind €1
*** HOLE CARDS ***
Dealt to matiko09 [6d 4c]
Ouga Buga: folds 
matiko09: folds 
Racushniak: folds 
aquarua7: raises €1.50 to €2.50
cap. marb: raises €3.50 to €6
ApkawaDavit: folds 
fireball2112: folds 
hurtNCYDE: folds 
Nunzio1985ct: folds 
aquarua7: calls €3.50
*** FLOP *** [4d 6s 2d]
aquarua7: checks 
cap. marb: bets €7
aquarua7: raises €196.31 to €203.31 and is all-in
cap. marb: calls €25 and is all-in
Uncalled bet (€171.31) returned to aquarua7
*** TURN *** [4d 6s 2d] [2h]
*** RIVER *** [4d 6s 2d 2h] [7d]
*** SHOW DOWN ***
aquarua7: shows [Ac 6c] (two pair, Sixes and Deuces)
cap. marb: shows [Js Jc] (two pair, Jacks and Deuces)
cap. marb collected €75.25 from pot
*** SUMMARY ***
Total pot €77.50 | Rake €2.25 
Board [4d 6s 2d 2h 7d]
Seat 1: aquarua7 showed [Ac 6c] and lost with two pair, Sixes and Deuces
Seat 2: cap. marb showed [Js Jc] and won (€75.25) with two pair, Jacks and Deuces
Seat 3: ApkawaDavit folded before Flop (didn't bet)
Seat 4: fireball2112 (button) folded before Flop (didn't bet)
Seat 5: hurtNCYDE (small blind) folded before Flop
Seat 6: Nunzio1985ct (big blind) folded before Flop
Seat 7: Ouga Buga folded before Flop (didn't bet)
Seat 8: matiko09 folded before Flop (didn't bet)
Seat 9: Racushniak folded before Flop (didn't bet)





PokerStars Hand #152662109179:  Hold'em No Limit ($0.50/$1.00 USD) - 2016/04/30 18:30:38 CET [2016/04/30 12:30:38 ET]
Table 'Dagmar' 9-max Seat #6 is the button
Seat 1: matiko09 ($100 in chips) 
Seat 2: Spid1 ($165.95 in chips) 
Seat 3: ApkawaDavit ($119.70 in chips) 
Seat 4: legnulk ($173.99 in chips) 
Seat 5: cap. marb ($38.50 in chips) 
Seat 6: arctur17 ($106.53 in chips) 
Seat 7: kswmh ($103.60 in chips) 
Seat 8: Ilov3NBA ($100 in chips) 
Seat 9: okkernoot111 ($149.35 in chips) 
kswmh: posts small blind $0.50
Ilov3NBA: posts big blind $1
*** HOLE CARDS ***
Dealt to matiko09 [8s Qh]
okkernoot111: folds 
matiko09: folds 
Spid1: folds 
ApkawaDavit: folds 
legnulk: folds 
cap. marb: folds 
arctur17: folds 
kswmh: raises $1 to $2
Ilov3NBA: folds 
Uncalled bet ($1) returned to kswmh
kswmh collected $2 from pot
kswmh: doesn't show hand 
*** SUMMARY ***
Total pot $2 | Rake $0 
Seat 1: matiko09 folded before Flop (didn't bet)
Seat 2: Spid1 folded before Flop (didn't bet)
Seat 3: ApkawaDavit folded before Flop (didn't bet)
Seat 4: legnulk folded before Flop (didn't bet)
Seat 5: cap. marb folded before Flop (didn't bet)
Seat 6: arctur17 (button) folded before Flop (didn't bet)
Seat 7: kswmh (small blind) collected ($2)
Seat 8: Ilov3NBA (big blind) folded before Flop
Seat 9: okkernoot111 folded before Flop (didn't bet)





PokerStars Hand #152662113750:  Hold'em No Limit ($0.50/$1.00 USD) - 2016/04/30 18:30:44 CET [2016/04/30 12:30:44 ET]
Table 'Lova II' 9-max Seat #5 is the button
Seat 2: bilukm ($308.24 in chips) 
Seat 3: matiko09 ($104.37 in chips) 
Seat 4: VanDobeln ($126.45 in chips) 
Seat 5: Ilov3NBA ($161.73 in chips) 
Seat 8: cap. marb ($57.89 in chips) 
Seat 9: hurtNCYDE ($104.32 in chips) 
Szevasztopol will be allowed to play after the button
cap. marb: posts small blind $0.50
hurtNCYDE: posts big blind $1
*** HOLE CARDS ***
Dealt to matiko09 [8d 2c]
bilukm: folds 
matiko09: folds 
VanDobeln: folds 
Ilov3NBA: raises $1 to $2
cap. marb: folds 
hurtNCYDE: calls $1
*** FLOP *** [Qc 5s Tc]
hurtNCYDE: checks 
Ilov3NBA: checks 
*** TURN *** [Qc 5s Tc] [9d]
hurtNCYDE: checks 
Ilov3NBA: bets $3.16
hurtNCYDE: folds 
Uncalled bet ($3.16) returned to Ilov3NBA
Ilov3NBA collected $4.28 from pot
Ilov3NBA: doesn't show hand 
*** SUMMARY ***
Total pot $4.50 | Rake $0.22 
Board [Qc 5s Tc 9d]
Seat 2: bilukm folded before Flop (didn't bet)
Seat 3: matiko09 folded before Flop (didn't bet)
Seat 4: VanDobeln folded before Flop (didn't bet)
Seat 5: Ilov3NBA (button) collected ($4.28)
Seat 8: cap. marb (small blind) folded before Flop
Seat 9: hurtNCYDE (big blind) folded on the Turn





PokerStars Hand #152662124918:  Hold'em No Limit ($0.50/$1.00 USD) - 2016/04/30 18:30:58 CET [2016/04/30 12:30:58 ET]
Table 'Raissa II' 9-max Seat #4 is the button
Seat 1: cap. marb ($44.44 in chips) 
Seat 2: azzad2007 ($119.90 in chips) 
Seat 3: iRivuLose ($101.49 in chips) 
Seat 4: koksskrt ($100 in chips) 
Seat 5: korlito69 ($52.13 in chips) 
Seat 6: hurtNCYDE ($105.70 in chips) 
Seat 7: matiko09 ($101.35 in chips) 
Seat 9: Ilov3NBA ($103.18 in chips) 
korlito69: posts small blind $0.50
hurtNCYDE: posts big blind $1
*** HOLE CARDS ***
Dealt to matiko09 [4s Jh]
matiko09: folds 
Ilov3NBA: folds 
cap. marb: folds 
azzad2007: raises $2 to $3
iRivuLose: folds 
koksskrt: raises $6 to $9
korlito69: folds 
hurtNCYDE: folds 
azzad2007: folds 
Uncalled bet ($6) returned to koksskrt
koksskrt collected $7.50 from pot
koksskrt: doesn't show hand 
*** SUMMARY ***
Total pot $7.50 | Rake $0 
Seat 1: cap. marb folded before Flop (didn't bet)
Seat 2: azzad2007 folded before Flop
Seat 3: iRivuLose folded before Flop (didn't bet)
Seat 4: koksskrt (button) collected ($7.50)
Seat 5: korlito69 (small blind) folded before Flop
Seat 6: hurtNCYDE (big blind) folded before Flop
Seat 7: matiko09 folded before Flop (didn't bet)
Seat 9: Ilov3NBA folded before Flop (didn't bet)





PokerStars Hand #152662132933:  Hold'em No Limit ($0.50/$1.00 USD) - 2016/04/30 18:31:08 CET [2016/04/30 12:31:08 ET]
Table 'Dagmar' 9-max Seat #7 is the button
Seat 1: matiko09 ($100 in chips) 
Seat 2: Spid1 ($165.95 in chips) 
Seat 3: ApkawaDavit ($119.70 in chips) 
Seat 4: legnulk ($173.99 in chips) 
Seat 5: cap. marb ($38.50 in chips) 
Seat 6: arctur17 ($106.53 in chips) 
Seat 7: kswmh ($104.60 in chips) 
Seat 8: Ilov3NBA ($100 in chips) 
Seat 9: okkernoot111 ($149.35 in chips) 
Ilov3NBA: posts small blind $0.50
okkernoot111: posts big blind $1
*** HOLE CARDS ***
Dealt to matiko09 [9d Kh]
matiko09: folds 
Spid1: folds 
ApkawaDavit: folds 
legnulk: folds 
cap. marb: raises $1.12 to $2.12
arctur17: folds 
kswmh: calls $2.12
Ilov3NBA: calls $1.62
okkernoot111: folds 
*** FLOP *** [6h 3h Kd]
Ilov3NBA: checks 
cap. marb: bets $4.61
kswmh: folds 
Ilov3NBA: raises $6.89 to $11.50
cap. marb: raises $24.88 to $36.38 and is all-in
Ilov3NBA: calls $24.88
*** TURN *** [6h 3h Kd] [9s]
*** RIVER *** [6h 3h Kd 9s] [5c]
*** SHOW DOWN ***
Ilov3NBA: shows [6s 6c] (three of a kind, Sixes)
cap. marb: mucks hand 
Ilov3NBA collected $77.62 from pot
*** SUMMARY ***
Total pot $80.12 | Rake $2.50 
Board [6h 3h Kd 9s 5c]
Seat 1: matiko09 folded before Flop (didn't bet)
Seat 2: Spid1 folded before Flop (didn't bet)
Seat 3: ApkawaDavit folded before Flop (didn't bet)
Seat 4: legnulk folded before Flop (didn't bet)
Seat 5: cap. marb mucked [Ah Ks]
Seat 6: arctur17 folded before Flop (didn't bet)
Seat 7: kswmh (button) folded on the Flop
Seat 8: Ilov3NBA (small blind) showed [6s 6c] and won ($77.62) with three of a kind, Sixes
Seat 9: okkernoot111 (big blind) folded before Flop





PokerStars Hand #152662142443:  Hold'em No Limit (€0.50/€1.00 EUR) - 2016/04/30 18:31:20 CET [2016/04/30 12:31:20 ET]
Table 'Benda' 9-max Seat #5 is the button
Seat 1: aquarua7 (€171.31 in chips) 
Seat 2: cap. marb (€75.25 in chips) 
Seat 3: ApkawaDavit (€101.70 in chips) 
Seat 4: fireball2112 (€78.18 in chips) 
Seat 5: hurtNCYDE (€105.97 in chips) 
Seat 6: Nunzio1985ct (€41.99 in chips) 
Seat 7: Ouga Buga (€101.18 in chips) 
Seat 8: matiko09 (€101.50 in chips) 
Seat 9: Racushniak (€155.95 in chips) 
Nunzio1985ct: posts small blind €0.50
Ouga Buga: posts big blind €1
*** HOLE CARDS ***
Dealt to matiko09 [Jc Th]
matiko09: folds 
Racushniak: folds 
aquarua7: folds 
cap. marb: folds 
ApkawaDavit: folds 
fireball2112: folds 
hurtNCYDE: folds 
Nunzio1985ct: raises €3 to €4
Ouga Buga: calls €3
*** FLOP *** [Qh Jd Jh]
aquarua7 leaves the table
Nunzio1985ct: checks 
WrongButton joins the table at seat #1 
Ouga Buga: checks 
*** TURN *** [Qh Jd Jh] [3s]
Nunzio1985ct: bets €2
Ouga Buga: folds 
Uncalled bet (€2) returned to Nunzio1985ct
Nunzio1985ct collected €7.60 from pot
*** SUMMARY ***
Total pot €8 | Rake €0.40 
Board [Qh Jd Jh 3s]
Seat 1: aquarua7 folded before Flop (didn't bet)
Seat 2: cap. marb folded before Flop (didn't bet)
Seat 3: ApkawaDavit folded before Flop (didn't bet)
Seat 4: fireball2112 folded before Flop (didn't bet)
Seat 5: hurtNCYDE (button) folded before Flop (didn't bet)
Seat 6: Nunzio1985ct (small blind) collected (€7.60)
Seat 7: Ouga Buga (big blind) folded on the Turn
Seat 8: matiko09 folded before Flop (didn't bet)
Seat 9: Racushniak folded before Flop (didn't bet)





PokerStars Hand #152662153497:  Hold'em No Limit ($0.50/$1.00 USD) - 2016/04/30 18:31:34 CET [2016/04/30 12:31:34 ET]
Table 'Goto' 9-max Seat #2 is the button
Seat 1: naaaate_diaz ($118.07 in chips) 
Seat 2: matiko09 ($115.77 in chips) 
Seat 3: cap. marb ($37.75 in chips) 
Seat 4: koksskrt ($100 in chips) 
Seat 5: Ilov3NBA ($102.25 in chips) 
Seat 6: puszi77 ($266.98 in chips) 
Seat 7: hurtNCYDE ($100 in chips) 
Seat 8: splicanin1 ($101.12 in chips) 
cap. marb: posts small blind $0.50
koksskrt: posts big blind $1
Pacifistas: sits out 
*** HOLE CARDS ***
Dealt to matiko09 [3c Ks]
Ilov3NBA: folds 
puszi77: folds 
hurtNCYDE: folds 
splicanin1: folds 
naaaate_diaz: folds 
matiko09: folds 
cap. marb: raises $1.50 to $2.50
koksskrt: folds 
Uncalled bet ($1.50) returned to cap. marb
cap. marb collected $2 from pot
cap. marb: doesn't show hand 
*** SUMMARY ***
Total pot $2 | Rake $0 
Seat 1: naaaate_diaz folded before Flop (didn't bet)
Seat 2: matiko09 (button) folded before Flop (didn't bet)
Seat 3: cap. marb (small blind) collected ($2)
Seat 4: koksskrt (big blind) folded before Flop
Seat 5: Ilov3NBA folded before Flop (didn't bet)
Seat 6: puszi77 folded before Flop (didn't bet)
Seat 7: hurtNCYDE folded before Flop (didn't bet)
Seat 8: splicanin1 folded before Flop (didn't bet)





PokerStars Hand #152662161089:  Hold'em No Limit ($0.50/$1.00 USD) - 2016/04/30 18:31:43 CET [2016/04/30 12:31:43 ET]
Table 'Raissa II' 9-max Seat #5 is the button
Seat 1: cap. marb ($44.44 in chips) 
Seat 2: azzad2007 ($116.90 in chips) 
Seat 3: iRivuLose ($101.49 in chips) 
Seat 4: koksskrt ($104.50 in chips) 
Seat 5: korlito69 ($51.63 in chips) 
Seat 6: hurtNCYDE ($104.70 in chips) 
Seat 7: matiko09 ($101.35 in chips) 
Seat 9: Ilov3NBA ($103.18 in chips) 
hurtNCYDE: posts small blind $0.50
matiko09: posts big blind $1
Pacifistas: sits out 
*** HOLE CARDS ***
Dealt to matiko09 [7h Kh]
Ilov3NBA: folds 
cap. marb: folds 
azzad2007: folds 
iRivuLose: raises $1.10 to $2.10
koksskrt: folds 
korlito69: folds 
hurtNCYDE: folds 
matiko09: folds 
Uncalled bet ($1.10) returned to iRivuLose
iRivuLose collected $2.50 from pot
iRivuLose: doesn't show hand 
*** SUMMARY ***
Total pot $2.50 | Rake $0 
Seat 1: cap. marb folded before Flop (didn't bet)
Seat 2: azzad2007 folded before Flop (didn't bet)
Seat 3: iRivuLose collected ($2.50)
Seat 4: koksskrt folded before Flop (didn't bet)
Seat 5: korlito69 (button) folded before Flop (didn't bet)
Seat 6: hurtNCYDE (small blind) folded before Flop
Seat 7: matiko09 (big blind) folded before Flop
Seat 9: Ilov3NBA folded before Flop (didn't bet)





PokerStars Hand #152662163733:  Hold'em No Limit ($0.50/$1.00 USD) - 2016/04/30 18:31:47 CET [2016/04/30 12:31:47 ET]
Table 'Lova II' 9-max Seat #8 is the button
Seat 1: Pacifistas ($100 in chips) 
Seat 2: bilukm ($308.24 in chips) 
Seat 3: matiko09 ($104.37 in chips) 
Seat 4: VanDobeln ($126.45 in chips) 
Seat 5: Ilov3NBA ($164.01 in chips) 
Seat 8: cap. marb ($57.39 in chips) 
Seat 9: hurtNCYDE ($102.32 in chips) 
hurtNCYDE: posts small blind $0.50
Pacifistas: posts big blind $1
Szevasztopol: sits out 
*** HOLE CARDS ***
Dealt to matiko09 [7c Qc]
bilukm: folds 
matiko09: folds 
VanDobeln: folds 
Ilov3NBA: folds 
cap. marb: raises $1.12 to $2.12
hurtNCYDE: folds 
Pacifistas: folds 
Uncalled bet ($1.12) returned to cap. marb
cap. marb collected $2.50 from pot
cap. marb: doesn't show hand 
*** SUMMARY ***
Total pot $2.50 | Rake $0 
Seat 1: Pacifistas (big blind) folded before Flop
Seat 2: bilukm folded before Flop (didn't bet)
Seat 3: matiko09 folded before Flop (didn't bet)
Seat 4: VanDobeln folded before Flop (didn't bet)
Seat 5: Ilov3NBA folded before Flop (didn't bet)
Seat 8: cap. marb (button) collected ($2.50)
Seat 9: hurtNCYDE (small blind) folded before Flop





PokerStars Hand #152662169123:  Hold'em No Limit ($0.50/$1.00 USD) - 2016/04/30 18:31:53 CET [2016/04/30 12:31:53 ET]
Table 'Tamariwa' 9-max Seat #6 is the button
Seat 1: koksskrt ($100 in chips) 
Seat 2: ryanshades ($79 in chips) 
Seat 3: matiko09 ($100 in chips) 
Seat 4: cap. marb ($85.28 in chips) 
Seat 5: Lobbyist98 ($113.46 in chips) 
Seat 6: El tourist ($9.75 in chips) 
Seat 8: JWU418 ($68.91 in chips) 
Seat 9: ApkawaDavit ($239.70 in chips) 
Pacifistas will be allowed to play after the button
JWU418: posts small blind $0.50
ApkawaDavit: posts big blind $1
*** HOLE CARDS ***
Dealt to matiko09 [7h Ad]
koksskrt: folds 
ryanshades: folds 
matiko09: folds 
cap. marb: folds 
Lobbyist98: raises $2 to $3
El tourist: folds 
JWU418: folds 
ApkawaDavit: folds 
Uncalled bet ($2) returned to Lobbyist98
Lobbyist98 collected $2.50 from pot
Lobbyist98: doesn't show hand 
*** SUMMARY ***
Total pot $2.50 | Rake $0 
Seat 1: koksskrt folded before Flop (didn't bet)
Seat 2: ryanshades folded before Flop (didn't bet)
Seat 3: matiko09 folded before Flop (didn't bet)
Seat 4: cap. marb folded before Flop (didn't bet)
Seat 5: Lobbyist98 collected ($2.50)
Seat 6: El tourist (button) folded before Flop (didn't bet)
Seat 8: JWU418 (small blind) folded before Flop
Seat 9: ApkawaDavit (big blind) folded before Flop





PokerStars Hand #152662169875:  Hold'em No Limit ($0.50/$1.00 USD) - 2016/04/30 18:31:54 CET [2016/04/30 12:31:54 ET]
Table 'Goto' 9-max Seat #3 is the button
Seat 1: naaaate_diaz ($118.07 in chips) 
Seat 2: matiko09 ($115.77 in chips) 
Seat 3: cap. marb ($38.75 in chips) 
Seat 4: koksskrt ($100 in chips) 
Seat 5: Ilov3NBA ($102.25 in chips) 
Seat 6: puszi77 ($266.98 in chips) 
Seat 7: hurtNCYDE ($100 in chips) 
Seat 8: splicanin1 ($101.12 in chips) 
koksskrt: posts small blind $0.50
Ilov3NBA: posts big blind $1
Pacifistas: sits out 
*** HOLE CARDS ***
Dealt to matiko09 [5h 7h]
puszi77: folds 
hurtNCYDE: folds 
splicanin1: folds 
naaaate_diaz: raises $2 to $3
matiko09: folds 
cap. marb: folds 
koksskrt: calls $2.50
Ilov3NBA: folds 
*** FLOP *** [3c 9c Ac]
koksskrt: checks 
naaaate_diaz: checks 
*** TURN *** [3c 9c Ac] [4s]
koksskrt: bets $4.50
naaaate_diaz: calls $4.50
*** RIVER *** [3c 9c Ac 4s] [Jh]
koksskrt: bets $10
naaaate_diaz: raises $20 to $30
koksskrt: folds 
Uncalled bet ($20) returned to naaaate_diaz
naaaate_diaz collected $34.20 from pot
naaaate_diaz: doesn't show hand 
*** SUMMARY ***
Total pot $36 | Rake $1.80 
Board [3c 9c Ac 4s Jh]
Seat 1: naaaate_diaz collected ($34.20)
Seat 2: matiko09 folded before Flop (didn't bet)
Seat 3: cap. marb (button) folded before Flop (didn't bet)
Seat 4: koksskrt (small blind) folded on the River
Seat 5: Ilov3NBA (big blind) folded before Flop
Seat 6: puszi77 folded before Flop (didn't bet)
Seat 7: hurtNCYDE folded before Flop (didn't bet)
Seat 8: splicanin1 folded before Flop (didn't bet)





PokerStars Hand #152662177400:  Hold'em No Limit (€0.50/€1.00 EUR) - 2016/04/30 18:32:04 CET [2016/04/30 12:32:04 ET]
Table 'Benda' 9-max Seat #6 is the button
Seat 2: cap. marb (€75.25 in chips) 
Seat 3: ApkawaDavit (€101.70 in chips) 
Seat 4: fireball2112 (€78.18 in chips) 
Seat 5: hurtNCYDE (€105.97 in chips) 
Seat 6: Nunzio1985ct (€45.59 in chips) 
Seat 7: Ouga Buga (€100 in chips) 
Seat 8: matiko09 (€101.50 in chips) 
Seat 9: Racushniak (€155.95 in chips) 
Ouga Buga: posts small blind €0.50
matiko09: posts big blind €1
WrongButton: sits out 
*** HOLE CARDS ***
Dealt to matiko09 [Jc 6c]
Racushniak has timed out
Racushniak: folds 
cap. marb: folds 
ApkawaDavit: folds 
fireball2112: folds 
hurtNCYDE: folds 
Nunzio1985ct: folds 
Ouga Buga: raises €2 to €3
matiko09: folds 
Uncalled bet (€2) returned to Ouga Buga
Ouga Buga collected €2 from pot
Ouga Buga: doesn't show hand 
*** SUMMARY ***
Total pot €2 | Rake €0 
Seat 2: cap. marb folded before Flop (didn't bet)
Seat 3: ApkawaDavit folded before Flop (didn't bet)
Seat 4: fireball2112 folded before Flop (didn't bet)
Seat 5: hurtNCYDE folded before Flop (didn't bet)
Seat 6: Nunzio1985ct (button) folded before Flop (didn't bet)
Seat 7: Ouga Buga (small blind) collected (€2)
Seat 8: matiko09 (big blind) folded before Flop
Seat 9: Racushniak folded before Flop (didn't bet)





PokerStars Hand #152662180022:  Hold'em No Limit ($0.50/$1.00 USD) - 2016/04/30 18:32:07 CET [2016/04/30 12:32:07 ET]
Table 'Raissa II' 9-max Seat #6 is the button
Seat 1: cap. marb ($44.44 in chips) 
Seat 2: azzad2007 ($116.90 in chips) 
Seat 3: iRivuLose ($102.99 in chips) 
Seat 4: koksskrt ($104.50 in chips) 
Seat 5: korlito69 ($51.63 in chips) 
Seat 6: hurtNCYDE ($104.20 in chips) 
Seat 7: matiko09 ($100.35 in chips) 
Seat 8: Pacifistas ($100 in chips) 
Seat 9: Ilov3NBA ($103.18 in chips) 
matiko09: posts small blind $0.50
Pacifistas: posts big blind $1
*** HOLE CARDS ***
Dealt to matiko09 [9c 6h]
Ilov3NBA: folds 
cap. marb: folds 
azzad2007: folds 
iRivuLose: folds 
koksskrt: folds 
korlito69: raises $3 to $4
hurtNCYDE: folds 
matiko09: folds 
Pacifistas: folds 
Uncalled bet ($3) returned to korlito69
korlito69 collected $2.50 from pot
korlito69: doesn't show hand 
*** SUMMARY ***
Total pot $2.50 | Rake $0 
Seat 1: cap. marb folded before Flop (didn't bet)
Seat 2: azzad2007 folded before Flop (didn't bet)
Seat 3: iRivuLose folded before Flop (didn't bet)
Seat 4: koksskrt folded before Flop (didn't bet)
Seat 5: korlito69 collected ($2.50)
Seat 6: hurtNCYDE (button) folded before Flop (didn't bet)
Seat 7: matiko09 (small blind) folded before Flop
Seat 8: Pacifistas (big blind) folded before Flop
Seat 9: Ilov3NBA folded before Flop (didn't bet)





PokerStars Hand #152662187436:  Hold'em No Limit ($0.50/$1.00 USD) - 2016/04/30 18:32:16 CET [2016/04/30 12:32:16 ET]
Table 'Lova II' 9-max Seat #9 is the button
Seat 1: Pacifistas ($100 in chips) 
Seat 2: bilukm ($308.24 in chips) 
Seat 3: matiko09 ($104.37 in chips) 
Seat 4: VanDobeln ($126.45 in chips) 
Seat 5: Ilov3NBA ($164.01 in chips) 
Seat 8: cap. marb ($58.89 in chips) 
Seat 9: hurtNCYDE ($101.82 in chips) 
Pacifistas: posts small blind $0.50
bilukm: posts big blind $1
Szevasztopol: sits out 
*** HOLE CARDS ***
Dealt to matiko09 [2c Js]
matiko09: folds 
VanDobeln: folds 
Ilov3NBA: folds 
cap. marb: folds 
hurtNCYDE: raises $1.50 to $2.50
Pacifistas: folds 
bilukm: folds 
Uncalled bet ($1.50) returned to hurtNCYDE
hurtNCYDE collected $2.50 from pot
*** SUMMARY ***
Total pot $2.50 | Rake $0 
Seat 1: Pacifistas (small blind) folded before Flop
Seat 2: bilukm (big blind) folded before Flop
Seat 3: matiko09 folded before Flop (didn't bet)
Seat 4: VanDobeln folded before Flop (didn't bet)
Seat 5: Ilov3NBA folded before Flop (didn't bet)
Seat 8: cap. marb folded before Flop (didn't bet)
Seat 9: hurtNCYDE (button) collected ($2.50)





PokerStars Hand #152662190641:  Hold'em No Limit ($0.50/$1.00 USD) - 2016/04/30 18:32:20 CET [2016/04/30 12:32:20 ET]
Table 'Dagmar' 9-max Seat #8 is the button
Seat 1: matiko09 ($100 in chips) 
Seat 2: Spid1 ($165.95 in chips) 
Seat 3: ApkawaDavit ($119.70 in chips) 
Seat 4: legnulk ($173.99 in chips) 
Seat 5: cap. marb ($40 in chips) 
Seat 6: arctur17 ($106.53 in chips) 
Seat 7: kswmh ($102.48 in chips) 
Seat 8: Ilov3NBA ($139.12 in chips) 
Seat 9: okkernoot111 ($148.35 in chips) 
okkernoot111: posts small blind $0.50
matiko09: posts big blind $1
*** HOLE CARDS ***
Dealt to matiko09 [6s 5s]
Spid1: folds 
ApkawaDavit: folds 
legnulk: raises $2 to $3
cap. marb: folds 
arctur17: folds 
kswmh: calls $3
Ilov3NBA: folds 
okkernoot111: folds 
matiko09: folds 
*** FLOP *** [Tc 9d 3s]
legnulk: bets $5.34
kswmh: folds 
Uncalled bet ($5.34) returned to legnulk
legnulk collected $7.12 from pot
*** SUMMARY ***
Total pot $7.50 | Rake $0.38 
Board [Tc 9d 3s]
Seat 1: matiko09 (big blind) folded before Flop
Seat 2: Spid1 folded before Flop (didn't bet)
Seat 3: ApkawaDavit folded before Flop (didn't bet)
Seat 4: legnulk collected ($7.12)
Seat 5: cap. marb folded before Flop (didn't bet)
Seat 6: arctur17 folded before Flop (didn't bet)
Seat 7: kswmh folded on the Flop
Seat 8: Ilov3NBA (button) folded before Flop (didn't bet)
Seat 9: okkernoot111 (small blind) folded before Flop





PokerStars Hand #152662190753:  Hold'em No Limit ($0.50/$1.00 USD) - 2016/04/30 18:32:20 CET [2016/04/30 12:32:20 ET]
Table 'Tamariwa' 9-max Seat #8 is the button
Seat 1: koksskrt ($100 in chips) 
Seat 2: ryanshades ($79 in chips) 
Seat 3: matiko09 ($100 in chips) 
Seat 4: cap. marb ($85.28 in chips) 
Seat 5: Lobbyist98 ($114.96 in chips) 
Seat 6: El tourist ($9.75 in chips) 
Seat 8: JWU418 ($68.41 in chips) 
Seat 9: ApkawaDavit ($238.70 in chips) 
ApkawaDavit: posts small blind $0.50
koksskrt: posts big blind $1
Pacifistas: sits out 
*** HOLE CARDS ***
Dealt to matiko09 [Qc Jh]
ryanshades: folds 
matiko09: folds 
cap. marb: folds 
Lobbyist98: folds 
El tourist: folds 
JWU418: raises $1.50 to $2.50
ApkawaDavit: folds 
koksskrt: folds 
Uncalled bet ($1.50) returned to JWU418
JWU418 collected $2.50 from pot
JWU418: doesn't show hand 
*** SUMMARY ***
Total pot $2.50 | Rake $0 
Seat 1: koksskrt (big blind) folded before Flop
Seat 2: ryanshades folded before Flop (didn't bet)
Seat 3: matiko09 folded before Flop (didn't bet)
Seat 4: cap. marb folded before Flop (didn't bet)
Seat 5: Lobbyist98 folded before Flop (didn't bet)
Seat 6: El tourist folded before Flop (didn't bet)
Seat 8: JWU418 (button) collected ($2.50)
Seat 9: ApkawaDavit (small blind) folded before Flop





PokerStars Hand #152662202989:  Hold'em No Limit ($0.50/$1.00 USD) - 2016/04/30 18:32:36 CET [2016/04/30 12:32:36 ET]
Table 'Raissa II' 9-max Seat #7 is the button
Seat 1: cap. marb ($44.44 in chips) 
Seat 2: azzad2007 ($116.90 in chips) 
Seat 3: iRivuLose ($102.99 in chips) 
Seat 4: koksskrt ($104.50 in chips) 
Seat 5: korlito69 ($53.13 in chips) 
Seat 6: hurtNCYDE ($104.20 in chips) 
Seat 7: matiko09 ($100 in chips) 
Seat 8: Pacifistas ($100 in chips) 
Pacifistas: posts small blind $0.50
Ilov3NBA: is sitting out 
cap. marb: posts big blind $1
*** HOLE CARDS ***
Dealt to matiko09 [Kh Tc]
Ilov3NBA leaves the table
azzad2007: folds 
WrongButton joins the table at seat #9 
iRivuLose: folds 
koksskrt: folds 
korlito69: folds 
hurtNCYDE: folds 
matiko09: raises $1.27 to $2.27
Pacifistas: raises $4.93 to $7.20
cap. marb: folds 
matiko09: calls $4.93
*** FLOP *** [4d 2d 9h]
Pacifistas: bets $9
matiko09: folds 
Uncalled bet ($9) returned to Pacifistas
Pacifistas collected $14.63 from pot
Pacifistas: doesn't show hand 
*** SUMMARY ***
Total pot $15.40 | Rake $0.77 
Board [4d 2d 9h]
Seat 1: cap. marb (big blind) folded before Flop
Seat 2: azzad2007 folded before Flop (didn't bet)
Seat 3: iRivuLose folded before Flop (didn't bet)
Seat 4: koksskrt folded before Flop (didn't bet)
Seat 5: korlito69 folded before Flop (didn't bet)
Seat 6: hurtNCYDE folded before Flop (didn't bet)
Seat 7: matiko09 (button) folded on the Flop
Seat 8: Pacifistas (small blind) collected ($14.63)





PokerStars Hand #152662206077:  Hold'em No Limit ($0.50/$1.00 USD) - 2016/04/30 18:32:39 CET [2016/04/30 12:32:39 ET]
Table 'Lova II' 9-max Seat #1 is the button
Seat 1: Pacifistas ($100 in chips) 
Seat 2: bilukm ($307.24 in chips) 
Seat 3: matiko09 ($104.37 in chips) 
Seat 4: VanDobeln ($126.45 in chips) 
Seat 5: Ilov3NBA ($164.01 in chips) 
Seat 8: cap. marb ($58.89 in chips) 
Seat 9: hurtNCYDE ($103.32 in chips) 
bilukm: posts small blind $0.50
matiko09: posts big blind $1
Szevasztopol: sits out 
*** HOLE CARDS ***
Dealt to matiko09 [Kd 8c]
VanDobeln: folds 
Ilov3NBA: folds 
cap. marb: folds 
hurtNCYDE: raises $1.50 to $2.50
Pacifistas: calls $2.50
bilukm: calls $2
matiko09: folds 
*** FLOP *** [Kh 9h 6c]
bilukm: checks 
hurtNCYDE: checks 
Pacifistas: checks 
*** TURN *** [Kh 9h 6c] [5s]
bilukm: checks 
hurtNCYDE: checks 
Pacifistas: checks 
*** RIVER *** [Kh 9h 6c 5s] [7c]
bilukm: checks 
hurtNCYDE: checks 
Pacifistas: checks 
*** SHOW DOWN ***
bilukm: shows [As Ts] (high card Ace)
hurtNCYDE: shows [Qc Ac] (high card Ace - King+Queen kicker)
Pacifistas: shows [4s 4d] (a pair of Fours)
Pacifistas collected $8.08 from pot
*** SUMMARY ***
Total pot $8.50 | Rake $0.42 
Board [Kh 9h 6c 5s 7c]
Seat 1: Pacifistas (button) showed [4s 4d] and won ($8.08) with a pair of Fours
Seat 2: bilukm (small blind) showed [As Ts] and lost with high card Ace
Seat 3: matiko09 (big blind) folded before Flop
Seat 4: VanDobeln folded before Flop (didn't bet)
Seat 5: Ilov3NBA folded before Flop (didn't bet)
Seat 8: cap. marb folded before Flop (didn't bet)
Seat 9: hurtNCYDE showed [Qc Ac] and lost with high card Ace





PokerStars Hand #152662213457:  Hold'em No Limit (€0.50/€1.00 EUR) - 2016/04/30 18:32:49 CET [2016/04/30 12:32:49 ET]
Table 'Benda' 9-max Seat #7 is the button
Seat 2: cap. marb (€75.25 in chips) 
Seat 3: ApkawaDavit (€101.70 in chips) 
Seat 4: fireball2112 (€78.18 in chips) 
Seat 5: hurtNCYDE (€105.97 in chips) 
Seat 6: Nunzio1985ct (€45.59 in chips) 
Seat 7: Ouga Buga (€101 in chips) 
Seat 8: matiko09 (€100.50 in chips) 
Seat 9: Racushniak (€155.95 in chips) 
matiko09: posts small blind €0.50
Racushniak: posts big blind €1
WrongButton: sits out 
*** HOLE CARDS ***
Dealt to matiko09 [Ts 2c]
cap. marb: folds 
ApkawaDavit: folds 
fireball2112: folds 
hurtNCYDE: folds 
Nunzio1985ct: folds 
Ouga Buga: raises €1.50 to €2.50
matiko09: folds 
Racushniak: calls €1.50
*** FLOP *** [8s 8d Ac]
Racushniak: checks 
Ouga Buga: bets €1.87
Racushniak: calls €1.87
*** TURN *** [8s 8d Ac] [Kc]
Racushniak: checks 
Ouga Buga: checks 
*** RIVER *** [8s 8d Ac Kc] [Tc]
Racushniak: bets €6
Ouga Buga: folds 
Uncalled bet (€6) returned to Racushniak
Racushniak collected €8.78 from pot
Racushniak: doesn't show hand 
*** SUMMARY ***
Total pot €9.24 | Rake €0.46 
Board [8s 8d Ac Kc Tc]
Seat 2: cap. marb folded before Flop (didn't bet)
Seat 3: ApkawaDavit folded before Flop (didn't bet)
Seat 4: fireball2112 folded before Flop (didn't bet)
Seat 5: hurtNCYDE folded before Flop (didn't bet)
Seat 6: Nunzio1985ct folded before Flop (didn't bet)
Seat 7: Ouga Buga (button) folded on the River
Seat 8: matiko09 (small blind) folded before Flop
Seat 9: Racushniak (big blind) collected (€8.78)





PokerStars Hand #152662221891:  Hold'em No Limit ($0.50/$1.00 USD) - 2016/04/30 18:32:59 CET [2016/04/30 12:32:59 ET]
Table 'Dagmar' 9-max Seat #9 is the button
Seat 1: matiko09 ($100 in chips) 
Seat 2: Spid1 ($165.95 in chips) 
Seat 3: ApkawaDavit ($119.70 in chips) 
Seat 4: legnulk ($178.11 in chips) 
Seat 5: cap. marb ($40 in chips) 
Seat 6: arctur17 ($106.53 in chips) 
Seat 7: kswmh ($99.48 in chips) 
Seat 8: Ilov3NBA ($139.12 in chips) 
Seat 9: okkernoot111 ($147.85 in chips) 
matiko09: posts small blind $0.50
Spid1: posts big blind $1
*** HOLE CARDS ***
Dealt to matiko09 [Qh 6d]
ApkawaDavit: folds 
legnulk: folds 
cap. marb: folds 
arctur17: folds 
kswmh: folds 
Ilov3NBA: raises $1.50 to $2.50
okkernoot111: calls $2.50
matiko09: folds 
Spid1: folds 
*** FLOP *** [Td As Kh]
Ilov3NBA: checks 
okkernoot111: checks 
*** TURN *** [Td As Kh] [7h]
Ilov3NBA: checks 
okkernoot111: checks 
*** RIVER *** [Td As Kh 7h] [Tc]
Ilov3NBA: bets $3.39
okkernoot111: folds 
Uncalled bet ($3.39) returned to Ilov3NBA
Ilov3NBA collected $6.18 from pot
Ilov3NBA: doesn't show hand 
*** SUMMARY ***
Total pot $6.50 | Rake $0.32 
Board [Td As Kh 7h Tc]
Seat 1: matiko09 (small blind) folded before Flop
Seat 2: Spid1 (big blind) folded before Flop
Seat 3: ApkawaDavit folded before Flop (didn't bet)
Seat 4: legnulk folded before Flop (didn't bet)
Seat 5: cap. marb folded before Flop (didn't bet)
Seat 6: arctur17 folded before Flop (didn't bet)
Seat 7: kswmh folded before Flop (didn't bet)
Seat 8: Ilov3NBA collected ($6.18)
Seat 9: okkernoot111 (button) folded on the River





PokerStars Hand #152662223347:  Hold'em No Limit ($0.50/$1.00 USD) - 2016/04/30 18:33:01 CET [2016/04/30 12:33:01 ET]
Table 'Tamariwa' 9-max Seat #9 is the button
Seat 1: koksskrt ($100 in chips) 
Seat 2: ryanshades ($79 in chips) 
Seat 3: matiko09 ($100 in chips) 
Seat 4: cap. marb ($85.28 in chips) 
Seat 5: Lobbyist98 ($114.96 in chips) 
Seat 6: El tourist ($9.75 in chips) 
Seat 8: JWU418 ($69.91 in chips) 
Seat 9: ApkawaDavit ($238.20 in chips) 
koksskrt: posts small blind $0.50
ryanshades: posts big blind $1
Pacifistas: sits out 
*** HOLE CARDS ***
Dealt to matiko09 [5c 3s]
matiko09: folds 
cap. marb: folds 
Lobbyist98: folds 
El tourist: folds 
JWU418: folds 
ApkawaDavit: folds 
koksskrt: raises $1.50 to $2.50
ryanshades: folds 
Uncalled bet ($1.50) returned to koksskrt
koksskrt collected $2 from pot
koksskrt: doesn't show hand 
*** SUMMARY ***
Total pot $2 | Rake $0 
Seat 1: koksskrt (small blind) collected ($2)
Seat 2: ryanshades (big blind) folded before Flop
Seat 3: matiko09 folded before Flop (didn't bet)
Seat 4: cap. marb folded before Flop (didn't bet)
Seat 5: Lobbyist98 folded before Flop (didn't bet)
Seat 6: El tourist folded before Flop (didn't bet)
Seat 8: JWU418 folded before Flop (didn't bet)
Seat 9: ApkawaDavit (button) folded before Flop (didn't bet)





PokerStars Hand #152662245429:  Hold'em No Limit ($0.50/$1.00 USD) - 2016/04/30 18:33:29 CET [2016/04/30 12:33:29 ET]
Table 'Tamariwa' 9-max Seat #1 is the button
Seat 1: koksskrt ($101 in chips) 
Seat 2: ryanshades ($78 in chips) 
Seat 3: matiko09 ($100 in chips) 
Seat 4: cap. marb ($85.28 in chips) 
Seat 5: Lobbyist98 ($114.96 in chips) 
Seat 6: El tourist ($9.75 in chips) 
Seat 8: JWU418 ($69.91 in chips) 
Seat 9: ApkawaDavit ($238.20 in chips) 
ryanshades: posts small blind $0.50
matiko09: posts big blind $1
Pacifistas: sits out 
*** HOLE CARDS ***
Dealt to matiko09 [6c 8s]
cap. marb: folds 
Lobbyist98: folds 
El tourist: folds 
JWU418: folds 
ApkawaDavit: folds 
Lobbyist98 leaves the table
koksskrt: raises $1 to $2
bigacsiga joins the table at seat #5 
ryanshades: raises $4 to $6
matiko09: folds 
koksskrt: calls $4
*** FLOP *** [Jc 9h As]
ryanshades: bets $14
koksskrt: folds 
Uncalled bet ($14) returned to ryanshades
ryanshades collected $12.35 from pot
ryanshades: doesn't show hand 
*** SUMMARY ***
Total pot $13 | Rake $0.65 
Board [Jc 9h As]
Seat 1: koksskrt (button) folded on the Flop
Seat 2: ryanshades (small blind) collected ($12.35)
Seat 3: matiko09 (big blind) folded before Flop
Seat 4: cap. marb folded before Flop (didn't bet)
Seat 5: Lobbyist98 folded before Flop (didn't bet)
Seat 6: El tourist folded before Flop (didn't bet)
Seat 8: JWU418 folded before Flop (didn't bet)
Seat 9: ApkawaDavit folded before Flop (didn't bet)





PokerStars Hand #152662248280:  Hold'em No Limit ($0.50/$1.00 USD) - 2016/04/30 18:33:33 CET [2016/04/30 12:33:33 ET]
Table 'Raissa II' 9-max Seat #8 is the button
Seat 1: cap. marb ($43.44 in chips) 
Seat 2: azzad2007 ($116.90 in chips) 
Seat 3: iRivuLose ($102.99 in chips) 
Seat 4: koksskrt ($104.50 in chips) 
Seat 5: korlito69 ($53.13 in chips) 
Seat 6: hurtNCYDE ($104.20 in chips) 
Seat 7: matiko09 ($100 in chips) 
Seat 8: Pacifistas ($107.43 in chips) 
WrongButton will be allowed to play after the button
cap. marb: posts small blind $0.50
azzad2007: posts big blind $1
*** HOLE CARDS ***
Dealt to matiko09 [7s 3s]
iRivuLose: folds 
koksskrt: folds 
korlito69: folds 
hurtNCYDE: folds 
matiko09: folds 
Pacifistas: raises $1.50 to $2.50
cap. marb: folds 
azzad2007: calls $1.50
*** FLOP *** [Jc Js 4s]
azzad2007: checks 
Pacifistas: bets $3.34
azzad2007: folds 
Uncalled bet ($3.34) returned to Pacifistas
Pacifistas collected $5.22 from pot
Pacifistas: doesn't show hand 
*** SUMMARY ***
Total pot $5.50 | Rake $0.28 
Board [Jc Js 4s]
Seat 1: cap. marb (small blind) folded before Flop
Seat 2: azzad2007 (big blind) folded on the Flop
Seat 3: iRivuLose folded before Flop (didn't bet)
Seat 4: koksskrt folded before Flop (didn't bet)
Seat 5: korlito69 folded before Flop (didn't bet)
Seat 6: hurtNCYDE folded before Flop (didn't bet)
Seat 7: matiko09 folded before Flop (didn't bet)
Seat 8: Pacifistas (button) collected ($5.22)





PokerStars Hand #152662251568:  Hold'em No Limit (€0.50/€1.00 EUR) - 2016/04/30 18:33:37 CET [2016/04/30 12:33:37 ET]
Table 'Benda' 9-max Seat #8 is the button
Seat 1: WrongButton (€100 in chips) 
Seat 2: cap. marb (€75.25 in chips) 
Seat 3: ApkawaDavit (€101.70 in chips) 
Seat 4: fireball2112 (€78.18 in chips) 
Seat 5: hurtNCYDE (€105.97 in chips) 
Seat 6: Nunzio1985ct (€45.59 in chips) 
Seat 7: Ouga Buga (€100 in chips) 
Seat 8: matiko09 (€100 in chips) 
Seat 9: Racushniak (€160.36 in chips) 
Racushniak: posts small blind €0.50
WrongButton: posts big blind €1
*** HOLE CARDS ***
Dealt to matiko09 [6d Ks]
cap. marb: folds 
ApkawaDavit: folds 
fireball2112: folds 
hurtNCYDE: folds 
Nunzio1985ct: folds 
Ouga Buga: folds 
matiko09: folds 
Racushniak: raises €2 to €3
WrongButton: calls €2
*** FLOP *** [8d Jd 8h]
Racushniak: bets €1.88
WrongButton: calls €1.88
*** TURN *** [8d Jd 8h] [Ad]
Racushniak: checks 
WrongButton: bets €5
Racushniak: folds 
Uncalled bet (€5) returned to WrongButton
WrongButton collected €9.27 from pot
*** SUMMARY ***
Total pot €9.76 | Rake €0.49 
Board [8d Jd 8h Ad]
Seat 1: WrongButton (big blind) collected (€9.27)
Seat 2: cap. marb folded before Flop (didn't bet)
Seat 3: ApkawaDavit folded before Flop (didn't bet)
Seat 4: fireball2112 folded before Flop (didn't bet)
Seat 5: hurtNCYDE folded before Flop (didn't bet)
Seat 6: Nunzio1985ct folded before Flop (didn't bet)
Seat 7: Ouga Buga folded before Flop (didn't bet)
Seat 8: matiko09 (button) folded before Flop (didn't bet)
Seat 9: Racushniak (small blind) folded on the Turn





PokerStars Hand #152662255403:  Hold'em No Limit ($0.50/$1.00 USD) - 2016/04/30 18:33:42 CET [2016/04/30 12:33:42 ET]
Table 'Lova II' 9-max Seat #2 is the button
Seat 1: Pacifistas ($105.58 in chips) 
Seat 2: bilukm ($304.74 in chips) 
Seat 3: matiko09 ($103.37 in chips) 
Seat 4: VanDobeln ($126.45 in chips) 
Seat 5: Ilov3NBA ($164.01 in chips) 
Seat 8: cap. marb ($58.89 in chips) 
Seat 9: hurtNCYDE ($100.82 in chips) 
matiko09: posts small blind $0.50
VanDobeln: posts big blind $1
Szevasztopol: sits out 
*** HOLE CARDS ***
Dealt to matiko09 [5c 4c]
Ilov3NBA: folds 
cap. marb: folds 
hurtNCYDE: folds 
Pacifistas: raises $1.50 to $2.50
bilukm: folds 
matiko09: folds 
VanDobeln: folds 
Uncalled bet ($1.50) returned to Pacifistas
Pacifistas collected $2.50 from pot
Pacifistas: doesn't show hand 
*** SUMMARY ***
Total pot $2.50 | Rake $0 
Seat 1: Pacifistas collected ($2.50)
Seat 2: bilukm (button) folded before Flop (didn't bet)
Seat 3: matiko09 (small blind) folded before Flop
Seat 4: VanDobeln (big blind) folded before Flop
Seat 5: Ilov3NBA folded before Flop (didn't bet)
Seat 8: cap. marb folded before Flop (didn't bet)
Seat 9: hurtNCYDE folded before Flop (didn't bet)





PokerStars Hand #152662258425:  Hold'em No Limit ($0.50/$1.00 USD) - 2016/04/30 18:33:45 CET [2016/04/30 12:33:45 ET]
Table 'Goto' 9-max Seat #4 is the button
Seat 1: naaaate_diaz ($134.77 in chips) 
Seat 2: matiko09 ($115.77 in chips) 
Seat 3: cap. marb ($38.75 in chips) 
Seat 4: koksskrt ($100 in chips) 
Seat 5: Ilov3NBA ($101.25 in chips) 
Seat 6: puszi77 ($266.98 in chips) 
Seat 7: hurtNCYDE ($100 in chips) 
Seat 8: splicanin1 ($101.12 in chips) 
Ilov3NBA: posts small blind $0.50
puszi77: posts big blind $1
Pacifistas: sits out 
*** HOLE CARDS ***
Dealt to matiko09 [Ad 5c]
hurtNCYDE: folds 
splicanin1: folds 
naaaate_diaz: folds 
matiko09: folds 
cap. marb: folds 
koksskrt: raises $1 to $2
Ilov3NBA: folds 
puszi77: calls $1
*** FLOP *** [9c 9d 4c]
puszi77: checks 
koksskrt: bets $2.69
puszi77: folds 
Uncalled bet ($2.69) returned to koksskrt
koksskrt collected $4.28 from pot
koksskrt: doesn't show hand 
*** SUMMARY ***
Total pot $4.50 | Rake $0.22 
Board [9c 9d 4c]
Seat 1: naaaate_diaz folded before Flop (didn't bet)
Seat 2: matiko09 folded before Flop (didn't bet)
Seat 3: cap. marb folded before Flop (didn't bet)
Seat 4: koksskrt (button) collected ($4.28)
Seat 5: Ilov3NBA (small blind) folded before Flop
Seat 6: puszi77 (big blind) folded on the Flop
Seat 7: hurtNCYDE folded before Flop (didn't bet)
Seat 8: splicanin1 folded before Flop (didn't bet)





PokerStars Hand #152662270802:  Hold'em No Limit ($0.50/$1.00 USD) - 2016/04/30 18:34:01 CET [2016/04/30 12:34:01 ET]
Table 'Dagmar' 9-max Seat #1 is the button
Seat 1: matiko09 ($100 in chips) 
Seat 2: Spid1 ($164.95 in chips) 
Seat 3: ApkawaDavit ($119.70 in chips) 
Seat 4: legnulk ($178.11 in chips) 
Seat 5: cap. marb ($40 in chips) 
Seat 6: arctur17 ($106.53 in chips) 
Seat 7: kswmh ($99.48 in chips) 
Seat 8: Ilov3NBA ($142.80 in chips) 
Seat 9: okkernoot111 ($145.35 in chips) 
Spid1: posts small blind $0.50
ApkawaDavit: posts big blind $1
*** HOLE CARDS ***
Dealt to matiko09 [9h 5d]
legnulk: calls $1
cap. marb: raises $3 to $4
arctur17: folds 
kswmh: folds 
Ilov3NBA: folds 
okkernoot111: folds 
matiko09: folds 
Spid1: folds 
ApkawaDavit: folds 
legnulk: calls $3
*** FLOP *** [Qh 6d 6c]
legnulk: checks 
cap. marb: bets $5.50
legnulk: folds 
Uncalled bet ($5.50) returned to cap. marb
cap. marb collected $9.02 from pot
cap. marb: doesn't show hand 
*** SUMMARY ***
Total pot $9.50 | Rake $0.48 
Board [Qh 6d 6c]
Seat 1: matiko09 (button) folded before Flop (didn't bet)
Seat 2: Spid1 (small blind) folded before Flop
Seat 3: ApkawaDavit (big blind) folded before Flop
Seat 4: legnulk folded on the Flop
Seat 5: cap. marb collected ($9.02)
Seat 6: arctur17 folded before Flop (didn't bet)
Seat 7: kswmh folded before Flop (didn't bet)
Seat 8: Ilov3NBA folded before Flop (didn't bet)
Seat 9: okkernoot111 folded before Flop (didn't bet)





PokerStars Hand #152662277773:  Hold'em No Limit ($0.50/$1.00 USD) - 2016/04/30 18:34:10 CET [2016/04/30 12:34:10 ET]
Table 'Lova II' 9-max Seat #3 is the button
Seat 1: Pacifistas ($107.08 in chips) 
Seat 2: bilukm ($304.74 in chips) 
Seat 3: matiko09 ($102.87 in chips) 
Seat 4: VanDobeln ($125.45 in chips) 
Seat 5: Ilov3NBA ($164.01 in chips) 
Seat 8: cap. marb ($58.89 in chips) 
Seat 9: hurtNCYDE ($100.82 in chips) 
VanDobeln: posts small blind $0.50
Ilov3NBA: posts big blind $1
Szevasztopol: sits out 
*** HOLE CARDS ***
Dealt to matiko09 [3s 6c]
cap. marb: folds 
hurtNCYDE: folds 
Pacifistas: raises $2 to $3
bilukm: folds 
matiko09: folds 
VanDobeln: folds 
di0d80 leaves the table
Ilov3NBA: folds 
Uncalled bet ($2) returned to Pacifistas
Pacifistas collected $2.50 from pot
Pacifistas: doesn't show hand 
*** SUMMARY ***
Total pot $2.50 | Rake $0 
Seat 1: Pacifistas collected ($2.50)
Seat 2: bilukm folded before Flop (didn't bet)
Seat 3: matiko09 (button) folded before Flop (didn't bet)
Seat 4: VanDobeln (small blind) folded before Flop
Seat 5: Ilov3NBA (big blind) folded before Flop
Seat 8: cap. marb folded before Flop (didn't bet)
Seat 9: hurtNCYDE folded before Flop (didn't bet)





PokerStars Hand #152662278678:  Hold'em No Limit ($0.50/$1.00 USD) - 2016/04/30 18:34:11 CET [2016/04/30 12:34:11 ET]
Table 'Kalliope II' 9-max Seat #1 is the button
Seat 1: cap. marb ($36.11 in chips) 
Seat 2: MijasMarco ($62 in chips) 
Seat 3: matiko09 ($100 in chips) 
Seat 4: Ilov3NBA ($124.92 in chips) 
Seat 5: SIMONE280201 ($58.91 in chips) 
Seat 6: hurtNCYDE ($124.64 in chips) 
Seat 7: ApkawaDavit ($161.35 in chips) 
Seat 8: RoadtoNepal ($102.22 in chips) 
Seat 9: scaihaze ($94.90 in chips) 
MijasMarco: posts small blind $0.50
matiko09: posts big blind $1
*** HOLE CARDS ***
Dealt to matiko09 [Qd 5s]
Ilov3NBA: folds 
SIMONE280201: folds 
hurtNCYDE: folds 
ApkawaDavit: folds 
RoadtoNepal: folds 
scaihaze: folds 
cap. marb: folds 
MijasMarco: folds 
Uncalled bet ($0.50) returned to matiko09
matiko09 collected $1 from pot
matiko09: doesn't show hand 
*** SUMMARY ***
Total pot $1 | Rake $0 
Seat 1: cap. marb (button) folded before Flop (didn't bet)
Seat 2: MijasMarco (small blind) folded before Flop
Seat 3: matiko09 (big blind) collected ($1)
Seat 4: Ilov3NBA folded before Flop (didn't bet)
Seat 5: SIMONE280201 folded before Flop (didn't bet)
Seat 6: hurtNCYDE folded before Flop (didn't bet)
Seat 7: ApkawaDavit folded before Flop (didn't bet)
Seat 8: RoadtoNepal folded before Flop (didn't bet)
Seat 9: scaihaze folded before Flop (didn't bet)





PokerStars Hand #152662283890:  Hold'em No Limit ($0.50/$1.00 USD) - 2016/04/30 18:34:17 CET [2016/04/30 12:34:17 ET]
Table 'Tamariwa' 9-max Seat #2 is the button
Seat 1: koksskrt ($100 in chips) 
Seat 2: ryanshades ($84.35 in chips) 
Seat 3: matiko09 ($100 in chips) 
Seat 4: cap. marb ($85.28 in chips) 
Seat 6: El tourist ($9.75 in chips) 
Seat 8: JWU418 ($69.91 in chips) 
Seat 9: ApkawaDavit ($238.20 in chips) 
matiko09: posts small blind $0.50
cap. marb: posts big blind $1
bigacsiga: sits out 
Pacifistas: sits out 
*** HOLE CARDS ***
Dealt to matiko09 [Qc As]
El tourist: folds 
JWU418: folds 
ApkawaDavit: folds 
koksskrt: folds 
ryanshades: folds 
matiko09: raises $1.50 to $2.50
cap. marb: raises $5.50 to $8
matiko09: calls $5.50
*** FLOP *** [Qh 5d 7s]
matiko09: checks 
cap. marb: bets $11.50
matiko09: calls $11.50
*** TURN *** [Qh 5d 7s] [5h]
matiko09: checks 
cap. marb: bets $24
matiko09: calls $24
*** RIVER *** [Qh 5d 7s 5h] [Kc]
matiko09: checks 
cap. marb: bets $41.78 and is all-in
matiko09: folds 
Uncalled bet ($41.78) returned to cap. marb
cap. marb collected $84.50 from pot
cap. marb: doesn't show hand 
*** SUMMARY ***
Total pot $87 | Rake $2.50 
Board [Qh 5d 7s 5h Kc]
Seat 1: koksskrt folded before Flop (didn't bet)
Seat 2: ryanshades (button) folded before Flop (didn't bet)
Seat 3: matiko09 (small blind) folded on the River
Seat 4: cap. marb (big blind) collected ($84.50)
Seat 6: El tourist folded before Flop (didn't bet)
Seat 8: JWU418 folded before Flop (didn't bet)
Seat 9: ApkawaDavit folded before Flop (didn't bet)





PokerStars Hand #152662298479:  Hold'em No Limit ($0.50/$1.00 USD) - 2016/04/30 18:34:36 CET [2016/04/30 12:34:36 ET]
Table 'Kalliope II' 9-max Seat #2 is the button
Seat 1: cap. marb ($36.11 in chips) 
Seat 2: MijasMarco ($61.50 in chips) 
Seat 3: matiko09 ($100.50 in chips) 
Seat 4: Ilov3NBA ($124.92 in chips) 
Seat 5: SIMONE280201 ($58.91 in chips) 
Seat 6: hurtNCYDE ($124.64 in chips) 
Seat 7: ApkawaDavit ($161.35 in chips) 
Seat 8: RoadtoNepal ($102.22 in chips) 
Seat 9: scaihaze ($94.90 in chips) 
matiko09: posts small blind $0.50
Ilov3NBA: posts big blind $1
*** HOLE CARDS ***
Dealt to matiko09 [2d 7h]
SIMONE280201: folds 
hurtNCYDE: folds 
ApkawaDavit: folds 
RoadtoNepal: folds 
scaihaze: folds 
cap. marb: raises $1.12 to $2.12
MijasMarco: folds 
matiko09: folds 
Ilov3NBA: folds 
Uncalled bet ($1.12) returned to cap. marb
cap. marb collected $2.50 from pot
cap. marb: doesn't show hand 
*** SUMMARY ***
Total pot $2.50 | Rake $0 
Seat 1: cap. marb collected ($2.50)
Seat 2: MijasMarco (button) folded before Flop (didn't bet)
Seat 3: matiko09 (small blind) folded before Flop
Seat 4: Ilov3NBA (big blind) folded before Flop
Seat 5: SIMONE280201 folded before Flop (didn't bet)
Seat 6: hurtNCYDE folded before Flop (didn't bet)
Seat 7: ApkawaDavit folded before Flop (didn't bet)
Seat 8: RoadtoNepal folded before Flop (didn't bet)
Seat 9: scaihaze folded before Flop (didn't bet)





PokerStars Hand #152662299724:  Hold'em No Limit ($0.50/$1.00 USD) - 2016/04/30 18:34:37 CET [2016/04/30 12:34:37 ET]
Table 'Raissa II' 9-max Seat #1 is the button
Seat 1: cap. marb ($42.94 in chips) 
Seat 2: azzad2007 ($114.40 in chips) 
Seat 3: iRivuLose ($102.99 in chips) 
Seat 4: koksskrt ($104.50 in chips) 
Seat 5: korlito69 ($53.13 in chips) 
Seat 6: hurtNCYDE ($104.20 in chips) 
Seat 7: matiko09 ($100 in chips) 
Seat 8: Pacifistas ($110.15 in chips) 
azzad2007: posts small blind $0.50
iRivuLose: posts big blind $1
WrongButton: sits out 
*** HOLE CARDS ***
Dealt to matiko09 [9c Tc]
koksskrt: folds 
koksskrt leaves the table
korlito69: folds 
hurtNCYDE: folds 
matiko09: raises $2 to $3
Pacifistas: folds 
cap. marb: folds 
azzad2007: folds 
iRivuLose: folds 
Uncalled bet ($2) returned to matiko09
matiko09 collected $2.50 from pot
matiko09: doesn't show hand 
*** SUMMARY ***
Total pot $2.50 | Rake $0 
Seat 1: cap. marb (button) folded before Flop (didn't bet)
Seat 2: azzad2007 (small blind) folded before Flop
Seat 3: iRivuLose (big blind) folded before Flop
Seat 4: koksskrt folded before Flop (didn't bet)
Seat 5: korlito69 folded before Flop (didn't bet)
Seat 6: hurtNCYDE folded before Flop (didn't bet)
Seat 7: matiko09 collected ($2.50)
Seat 8: Pacifistas folded before Flop (didn't bet)





PokerStars Hand #152662302388:  Hold'em No Limit ($0.50/$1.00 USD) - 2016/04/30 18:34:41 CET [2016/04/30 12:34:41 ET]
Table 'Lova II' 9-max Seat #4 is the button
Seat 1: Pacifistas ($108.58 in chips) 
Seat 2: bilukm ($304.74 in chips) 
Seat 3: matiko09 ($102.87 in chips) 
Seat 4: VanDobeln ($124.95 in chips) 
Seat 5: Ilov3NBA ($163.01 in chips) 
Seat 7: Szevasztopol ($100 in chips) 
Seat 8: cap. marb ($58.89 in chips) 
Seat 9: hurtNCYDE ($100.82 in chips) 
Ilov3NBA: posts small blind $0.50
Szevasztopol: posts big blind $1
*** HOLE CARDS ***
Dealt to matiko09 [8d 4c]
cap. marb: folds 
hurtNCYDE: folds 
Pacifistas: folds 
bilukm: folds 
matiko09: folds 
VanDobeln: folds 
RoadtoNepal joins the table at seat #6 
Ilov3NBA: folds 
Uncalled bet ($0.50) returned to Szevasztopol
Szevasztopol collected $1 from pot
Szevasztopol: doesn't show hand 
*** SUMMARY ***
Total pot $1 | Rake $0 
Seat 1: Pacifistas folded before Flop (didn't bet)
Seat 2: bilukm folded before Flop (didn't bet)
Seat 3: matiko09 folded before Flop (didn't bet)
Seat 4: VanDobeln (button) folded before Flop (didn't bet)
Seat 5: Ilov3NBA (small blind) folded before Flop
Seat 7: Szevasztopol (big blind) collected ($1)
Seat 8: cap. marb folded before Flop (didn't bet)
Seat 9: hurtNCYDE folded before Flop (didn't bet)





PokerStars Hand #152662303168:  Hold'em No Limit ($0.50/$1.00 USD) - 2016/04/30 18:34:42 CET [2016/04/30 12:34:42 ET]
Table 'Dagmar' 9-max Seat #2 is the button
Seat 1: matiko09 ($100 in chips) 
Seat 2: Spid1 ($164.45 in chips) 
Seat 3: ApkawaDavit ($118.70 in chips) 
Seat 5: cap. marb ($45.02 in chips) 
Seat 6: arctur17 ($106.53 in chips) 
Seat 7: kswmh ($99.48 in chips) 
Seat 8: Ilov3NBA ($142.80 in chips) 
Seat 9: okkernoot111 ($145.35 in chips) 
ApkawaDavit: posts small blind $0.50
legnulk: is sitting out 
cap. marb: posts big blind $1
*** HOLE CARDS ***
Dealt to matiko09 [7s 8c]
arctur17: folds 
kswmh: folds 
Ilov3NBA: folds 
legnulk leaves the table
okkernoot111: folds 
matiko09: folds 
Spid1: raises $1.50 to $2.50
ApkawaDavit: folds 
cap. marb: folds 
Uncalled bet ($1.50) returned to Spid1
Spid1 collected $2.50 from pot
Spid1: doesn't show hand 
*** SUMMARY ***
Total pot $2.50 | Rake $0 
Seat 1: matiko09 folded before Flop (didn't bet)
Seat 2: Spid1 (button) collected ($2.50)
Seat 3: ApkawaDavit (small blind) folded before Flop
Seat 5: cap. marb (big blind) folded before Flop
Seat 6: arctur17 folded before Flop (didn't bet)
Seat 7: kswmh folded before Flop (didn't bet)
Seat 8: Ilov3NBA folded before Flop (didn't bet)
Seat 9: okkernoot111 folded before Flop (didn't bet)





PokerStars Hand #152662318669:  Hold'em No Limit ($0.50/$1.00 USD) - 2016/04/30 18:35:01 CET [2016/04/30 12:35:01 ET]
Table 'Goto' 9-max Seat #5 is the button
Seat 1: naaaate_diaz ($134.77 in chips) 
Seat 2: matiko09 ($115.77 in chips) 
Seat 3: cap. marb ($38.75 in chips) 
Seat 4: koksskrt ($102.28 in chips) 
Seat 5: Ilov3NBA ($100.75 in chips) 
Seat 6: puszi77 ($264.98 in chips) 
Seat 7: hurtNCYDE ($100 in chips) 
Seat 8: splicanin1 ($101.12 in chips) 
puszi77: posts small blind $0.50
hurtNCYDE: posts big blind $1
Pacifistas: sits out 
*** HOLE CARDS ***
Dealt to matiko09 [4c 7d]
splicanin1: folds 
naaaate_diaz: folds 
matiko09: folds 
cap. marb: folds 
koksskrt: raises $1.50 to $2.50
Ilov3NBA: folds 
puszi77: folds 
hurtNCYDE: folds 
Uncalled bet ($1.50) returned to koksskrt
koksskrt collected $2.50 from pot
koksskrt: doesn't show hand 
*** SUMMARY ***
Total pot $2.50 | Rake $0 
Seat 1: naaaate_diaz folded before Flop (didn't bet)
Seat 2: matiko09 folded before Flop (didn't bet)
Seat 3: cap. marb folded before Flop (didn't bet)
Seat 4: koksskrt collected ($2.50)
Seat 5: Ilov3NBA (button) folded before Flop (didn't bet)
Seat 6: puszi77 (small blind) folded before Flop
Seat 7: hurtNCYDE (big blind) folded before Flop
Seat 8: splicanin1 folded before Flop (didn't bet)





PokerStars Hand #152662319140:  Hold'em No Limit ($0.50/$1.00 USD) - 2016/04/30 18:35:02 CET [2016/04/30 12:35:02 ET]
Table 'Lova II' 9-max Seat #5 is the button
Seat 1: Pacifistas ($108.58 in chips) 
Seat 2: bilukm ($304.74 in chips) 
Seat 3: matiko09 ($102.87 in chips) 
Seat 4: VanDobeln ($124.95 in chips) 
Seat 5: Ilov3NBA ($162.51 in chips) 
Seat 7: Szevasztopol ($100.50 in chips) 
Seat 8: cap. marb ($58.89 in chips) 
Seat 9: hurtNCYDE ($100.82 in chips) 
RoadtoNepal will be allowed to play after the button
Szevasztopol: posts small blind $0.50
cap. marb: posts big blind $1
*** HOLE CARDS ***
Dealt to matiko09 [5d Jh]
hurtNCYDE: raises $1.50 to $2.50
Pacifistas: folds 
bilukm: folds 
RoadtoNepal leaves the table
matiko09: folds 
VanDobeln: folds 
Ilov3NBA: folds 
HITYESCA joins the table at seat #6 
Szevasztopol: folds 
cap. marb: folds 
Uncalled bet ($1.50) returned to hurtNCYDE
hurtNCYDE collected $2.50 from pot
*** SUMMARY ***
Total pot $2.50 | Rake $0 
Seat 1: Pacifistas folded before Flop (didn't bet)
Seat 2: bilukm folded before Flop (didn't bet)
Seat 3: matiko09 folded before Flop (didn't bet)
Seat 4: VanDobeln folded before Flop (didn't bet)
Seat 5: Ilov3NBA (button) folded before Flop (didn't bet)
Seat 7: Szevasztopol (small blind) folded before Flop
Seat 8: cap. marb (big blind) folded before Flop
Seat 9: hurtNCYDE collected ($2.50)





PokerStars Hand #152662325871:  Hold'em No Limit ($0.50/$1.00 USD) - 2016/04/30 18:35:10 CET [2016/04/30 12:35:10 ET]
Table 'Dagmar' 9-max Seat #3 is the button
Seat 1: matiko09 ($100 in chips) 
Seat 2: Spid1 ($165.95 in chips) 
Seat 3: ApkawaDavit ($118.20 in chips) 
Seat 5: cap. marb ($44.02 in chips) 
Seat 6: arctur17 ($106.53 in chips) 
Seat 7: kswmh ($99.48 in chips) 
Seat 8: Ilov3NBA ($142.80 in chips) 
Seat 9: okkernoot111 ($145.35 in chips) 
cap. marb: posts small blind $0.50
arctur17: posts big blind $1
*** HOLE CARDS ***
Dealt to matiko09 [6c Kc]
kswmh: folds 
Ilov3NBA: folds 
okkernoot111: folds 
matiko09: folds 
RoadtoNepal joins the table at seat #4 
Spid1: folds 
ApkawaDavit: raises $1 to $2
cap. marb: raises $4 to $6
arctur17: folds 
ApkawaDavit: folds 
Uncalled bet ($4) returned to cap. marb
cap. marb collected $5 from pot
cap. marb: doesn't show hand 
*** SUMMARY ***
Total pot $5 | Rake $0 
Seat 1: matiko09 folded before Flop (didn't bet)
Seat 2: Spid1 folded before Flop (didn't bet)
Seat 3: ApkawaDavit (button) folded before Flop
Seat 5: cap. marb (small blind) collected ($5)
Seat 6: arctur17 (big blind) folded before Flop
Seat 7: kswmh folded before Flop (didn't bet)
Seat 8: Ilov3NBA folded before Flop (didn't bet)
Seat 9: okkernoot111 folded before Flop (didn't bet)





PokerStars Hand #152662327782:  Hold'em No Limit ($0.50/$1.00 USD) - 2016/04/30 18:35:12 CET [2016/04/30 12:35:12 ET]
Table 'Raissa II' 9-max Seat #2 is the button
Seat 1: cap. marb ($42.94 in chips) 
Seat 2: azzad2007 ($113.90 in chips) 
Seat 3: iRivuLose ($101.99 in chips) 
Seat 5: korlito69 ($53.13 in chips) 
Seat 6: hurtNCYDE ($104.20 in chips) 
Seat 7: matiko09 ($101.50 in chips) 
Seat 8: Pacifistas ($110.15 in chips) 
iRivuLose: posts small blind $0.50
korlito69: posts big blind $1
WrongButton: sits out 
*** HOLE CARDS ***
Dealt to matiko09 [9d 2s]
HITYESCA joins the table at seat #4 
hurtNCYDE: raises $1.50 to $2.50
matiko09: folds 
Pacifistas: folds 
cap. marb: folds 
azzad2007: folds 
iRivuLose: folds 
korlito69: calls $1.50
*** FLOP *** [Ah Ks 2d]
korlito69: checks 
hurtNCYDE: bets $1.77
korlito69: folds 
Uncalled bet ($1.77) returned to hurtNCYDE
hurtNCYDE collected $5.22 from pot
*** SUMMARY ***
Total pot $5.50 | Rake $0.28 
Board [Ah Ks 2d]
Seat 1: cap. marb folded before Flop (didn't bet)
Seat 2: azzad2007 (button) folded before Flop (didn't bet)
Seat 3: iRivuLose (small blind) folded before Flop
Seat 5: korlito69 (big blind) folded on the Flop
Seat 6: hurtNCYDE collected ($5.22)
Seat 7: matiko09 folded before Flop (didn't bet)
Seat 8: Pacifistas folded before Flop (didn't bet)





PokerStars Hand #152662334914:  Hold'em No Limit (€0.50/€1.00 EUR) - 2016/04/30 18:35:21 CET [2016/04/30 12:35:21 ET]
Table 'Benda' 9-max Seat #9 is the button
Seat 1: WrongButton (€104.39 in chips) 
Seat 2: cap. marb (€75.25 in chips) 
Seat 3: ApkawaDavit (€101.70 in chips) 
Seat 4: fireball2112 (€78.18 in chips) 
Seat 5: hurtNCYDE (€105.97 in chips) 
Seat 6: Nunzio1985ct (€45.59 in chips) 
Seat 7: Ouga Buga (€100 in chips) 
Seat 8: matiko09 (€100 in chips) 
Seat 9: Racushniak (€155.48 in chips) 
WrongButton: posts small blind €0.50
cap. marb: posts big blind €1
*** HOLE CARDS ***
Dealt to matiko09 [9d Jc]
ApkawaDavit: folds 
fireball2112: folds 
hurtNCYDE: folds 
Nunzio1985ct: folds 
Ouga Buga: folds 
matiko09: folds 
Racushniak: raises €1.40 to €2.40
WrongButton: folds 
cap. marb: folds 
Uncalled bet (€1.40) returned to Racushniak
Racushniak collected €2.50 from pot
Racushniak: doesn't show hand 
*** SUMMARY ***
Total pot €2.50 | Rake €0 
Seat 1: WrongButton (small blind) folded before Flop
Seat 2: cap. marb (big blind) folded before Flop
Seat 3: ApkawaDavit folded before Flop (didn't bet)
Seat 4: fireball2112 folded before Flop (didn't bet)
Seat 5: hurtNCYDE folded before Flop (didn't bet)
Seat 6: Nunzio1985ct folded before Flop (didn't bet)
Seat 7: Ouga Buga folded before Flop (didn't bet)
Seat 8: matiko09 folded before Flop (didn't bet)
Seat 9: Racushniak (button) collected (€2.50)





PokerStars Hand #152662340396:  Hold'em No Limit ($0.50/$1.00 USD) - 2016/04/30 18:35:28 CET [2016/04/30 12:35:28 ET]
Table 'Kalliope II' 9-max Seat #3 is the button
Seat 1: cap. marb ($37.61 in chips) 
Seat 2: MijasMarco ($61.50 in chips) 
Seat 3: matiko09 ($100 in chips) 
Seat 4: Ilov3NBA ($123.92 in chips) 
Seat 5: SIMONE280201 ($58.91 in chips) 
Seat 6: hurtNCYDE ($124.64 in chips) 
Seat 7: ApkawaDavit ($161.35 in chips) 
Seat 8: RoadtoNepal ($102.22 in chips) 
Seat 9: scaihaze ($94.90 in chips) 
Ilov3NBA: posts small blind $0.50
SIMONE280201: posts big blind $1
*** HOLE CARDS ***
Dealt to matiko09 [Ts Qd]
hurtNCYDE: raises $1.50 to $2.50
ApkawaDavit: folds 
RoadtoNepal: folds 
scaihaze: calls $2.50
cap. marb: folds 
MijasMarco: calls $2.50
matiko09: folds 
Ilov3NBA: folds 
SIMONE280201: calls $1.50
*** FLOP *** [3h Jc Qh]
SIMONE280201: checks 
hurtNCYDE: bets $5.18
scaihaze: calls $5.18
MijasMarco: folds 
SIMONE280201: folds 
*** TURN *** [3h Jc Qh] [8s]
hurtNCYDE: checks 
scaihaze: bets $9
hurtNCYDE: calls $9
*** RIVER *** [3h Jc Qh 8s] [6c]
hurtNCYDE: checks 
scaihaze: bets $31
hurtNCYDE: folds 
Uncalled bet ($31) returned to scaihaze
scaihaze collected $36.92 from pot
scaihaze: doesn't show hand 
*** SUMMARY ***
Total pot $38.86 | Rake $1.94 
Board [3h Jc Qh 8s 6c]
Seat 1: cap. marb folded before Flop (didn't bet)
Seat 2: MijasMarco folded on the Flop
Seat 3: matiko09 (button) folded before Flop (didn't bet)
Seat 4: Ilov3NBA (small blind) folded before Flop
Seat 5: SIMONE280201 (big blind) folded on the Flop
Seat 6: hurtNCYDE folded on the River
Seat 7: ApkawaDavit folded before Flop (didn't bet)
Seat 8: RoadtoNepal folded before Flop (didn't bet)
Seat 9: scaihaze collected ($36.92)





PokerStars Hand #152662354304:  Hold'em No Limit ($0.50/$1.00 USD) - 2016/04/30 18:35:46 CET [2016/04/30 12:35:46 ET]
Table 'Goto' 9-max Seat #6 is the button
Seat 1: naaaate_diaz ($134.77 in chips) 
Seat 2: matiko09 ($115.77 in chips) 
Seat 3: cap. marb ($38.75 in chips) 
Seat 4: koksskrt ($103.78 in chips) 
Seat 5: Ilov3NBA ($100.75 in chips) 
Seat 6: puszi77 ($264.48 in chips) 
Seat 7: hurtNCYDE ($100 in chips) 
Seat 8: splicanin1 ($101.12 in chips) 
hurtNCYDE: posts small blind $0.50
splicanin1: posts big blind $1
Pacifistas: sits out 
*** HOLE CARDS ***
Dealt to matiko09 [6h 9h]
naaaate_diaz: folds 
matiko09: folds 
cap. marb: raises $1.12 to $2.12
koksskrt: folds 
Ilov3NBA: folds 
puszi77: calls $2.12
hurtNCYDE: folds 
splicanin1: folds 
*** FLOP *** [Qd Jd 4c]
cap. marb: checks 
puszi77: checks 
*** TURN *** [Qd Jd 4c] [Tc]
cap. marb: bets $3.59
puszi77: folds 
Uncalled bet ($3.59) returned to cap. marb
cap. marb collected $5.45 from pot
cap. marb: doesn't show hand 
*** SUMMARY ***
Total pot $5.74 | Rake $0.29 
Board [Qd Jd 4c Tc]
Seat 1: naaaate_diaz folded before Flop (didn't bet)
Seat 2: matiko09 folded before Flop (didn't bet)
Seat 3: cap. marb collected ($5.45)
Seat 4: koksskrt folded before Flop (didn't bet)
Seat 5: Ilov3NBA folded before Flop (didn't bet)
Seat 6: puszi77 (button) folded on the Turn
Seat 7: hurtNCYDE (small blind) folded before Flop
Seat 8: splicanin1 (big blind) folded before Flop





PokerStars Hand #152662357379:  Hold'em No Limit ($0.50/$1.00 USD) - 2016/04/30 18:35:50 CET [2016/04/30 12:35:50 ET]
Table 'Lova II' 9-max Seat #7 is the button
Seat 1: Pacifistas ($108.58 in chips) 
Seat 2: bilukm ($304.74 in chips) 
Seat 3: matiko09 ($102.87 in chips) 
Seat 4: VanDobeln ($124.95 in chips) 
Seat 5: Ilov3NBA ($162.51 in chips) 
Seat 7: Szevasztopol ($100 in chips) 
Seat 8: cap. marb ($57.89 in chips) 
cap. marb: posts small blind $0.50
hurtNCYDE: is sitting out 
hurtNCYDE leaves the table
Pacifistas: posts big blind $1
HITYESCA: sits out 
*** HOLE CARDS ***
Dealt to matiko09 [9d As]
bilukm: raises $1 to $2
matiko09: folds 
VanDobeln: folds 
Ilov3NBA: folds 
Szevasztopol: raises $4 to $6
cap. marb: folds 
Pacifistas: folds 
bilukm: calls $4
*** FLOP *** [5s Ad 6s]
bilukm: checks 
Szevasztopol: bets $7
bilukm: folds 
Uncalled bet ($7) returned to Szevasztopol
Szevasztopol collected $12.82 from pot
Szevasztopol: doesn't show hand 
*** SUMMARY ***
Total pot $13.50 | Rake $0.68 
Board [5s Ad 6s]
Seat 1: Pacifistas (big blind) folded before Flop
Seat 2: bilukm folded on the Flop
Seat 3: matiko09 folded before Flop (didn't bet)
Seat 4: VanDobeln folded before Flop (didn't bet)
Seat 5: Ilov3NBA folded before Flop (didn't bet)
Seat 7: Szevasztopol (button) collected ($12.82)
Seat 8: cap. marb (small blind) folded before Flop





PokerStars Hand #152662360361:  Hold'em No Limit (€0.50/€1.00 EUR) - 2016/04/30 18:35:54 CET [2016/04/30 12:35:54 ET]
Table 'Benda' 9-max Seat #1 is the button
Seat 1: WrongButton (€103.89 in chips) 
Seat 2: cap. marb (€74.25 in chips) 
Seat 3: ApkawaDavit (€101.70 in chips) 
Seat 4: fireball2112 (€78.18 in chips) 
Seat 5: hurtNCYDE (€105.97 in chips) 
Seat 6: Nunzio1985ct (€45.59 in chips) 
Seat 7: Ouga Buga (€100 in chips) 
Seat 8: matiko09 (€100 in chips) 
Seat 9: Racushniak (€156.98 in chips) 
cap. marb: posts small blind €0.50
ApkawaDavit: posts big blind €1
*** HOLE CARDS ***
Dealt to matiko09 [Kh 3c]
fireball2112: raises €1 to €2
hurtNCYDE: calls €2
Nunzio1985ct: folds 
Ouga Buga: folds 
matiko09: folds 
Racushniak: folds 
WrongButton: calls €2
cap. marb: folds 
ApkawaDavit: raises €11 to €13
fireball2112: calls €11
hurtNCYDE: folds 
WrongButton: calls €11
*** FLOP *** [Qs 8d 5h]
ApkawaDavit: checks 
fireball2112: bets €65.18 and is all-in
WrongButton: folds 
ApkawaDavit: calls €65.18
*** TURN *** [Qs 8d 5h] [7h]
*** RIVER *** [Qs 8d 5h 7h] [Kc]
*** SHOW DOWN ***
ApkawaDavit: shows [Qc Qd] (three of a kind, Queens)
fireball2112: shows [Ac Qh] (a pair of Queens)
ApkawaDavit collected €169.61 from pot
*** SUMMARY ***
Total pot €171.86 | Rake €2.25 
Board [Qs 8d 5h 7h Kc]
Seat 1: WrongButton (button) folded on the Flop
Seat 2: cap. marb (small blind) folded before Flop
Seat 3: ApkawaDavit (big blind) showed [Qc Qd] and won (€169.61) with three of a kind, Queens
Seat 4: fireball2112 showed [Ac Qh] and lost with a pair of Queens
Seat 5: hurtNCYDE folded before Flop
Seat 6: Nunzio1985ct folded before Flop (didn't bet)
Seat 7: Ouga Buga folded before Flop (didn't bet)
Seat 8: matiko09 folded before Flop (didn't bet)
Seat 9: Racushniak folded before Flop (didn't bet)





PokerStars Hand #152662367647:  Hold'em No Limit ($0.50/$1.00 USD) - 2016/04/30 18:36:03 CET [2016/04/30 12:36:03 ET]
Table 'Dagmar' 9-max Seat #5 is the button
Seat 1: matiko09 ($100 in chips) 
Seat 2: Spid1 ($165.95 in chips) 
Seat 3: ApkawaDavit ($116.20 in chips) 
Seat 5: cap. marb ($47.02 in chips) 
Seat 6: arctur17 ($105.53 in chips) 
Seat 7: kswmh ($99.48 in chips) 
Seat 8: Ilov3NBA ($142.80 in chips) 
Seat 9: okkernoot111 ($145.35 in chips) 
arctur17: posts small blind $0.50
kswmh: posts big blind $1
RoadtoNepal: sits out 
*** HOLE CARDS ***
Dealt to matiko09 [Jc 7s]
Ilov3NBA: raises $2 to $3
okkernoot111: folds 
matiko09: folds 
Spid1: folds 
ApkawaDavit: folds 
cap. marb: folds 
arctur17: folds 
kswmh: calls $2
*** FLOP *** [3d 2s 2c]
kswmh: checks 
Ilov3NBA: bets $3.39
kswmh: folds 
Uncalled bet ($3.39) returned to Ilov3NBA
Ilov3NBA collected $6.18 from pot
Ilov3NBA: doesn't show hand 
*** SUMMARY ***
Total pot $6.50 | Rake $0.32 
Board [3d 2s 2c]
Seat 1: matiko09 folded before Flop (didn't bet)
Seat 2: Spid1 folded before Flop (didn't bet)
Seat 3: ApkawaDavit folded before Flop (didn't bet)
Seat 5: cap. marb (button) folded before Flop (didn't bet)
Seat 6: arctur17 (small blind) folded before Flop
Seat 7: kswmh (big blind) folded on the Flop
Seat 8: Ilov3NBA collected ($6.18)
Seat 9: okkernoot111 folded before Flop (didn't bet)





PokerStars Hand #152662380512:  Hold'em No Limit ($0.50/$1.00 USD) - 2016/04/30 18:36:19 CET [2016/04/30 12:36:19 ET]
Table 'Raissa II' 9-max Seat #3 is the button
Seat 1: cap. marb ($42.94 in chips) 
Seat 2: azzad2007 ($113.90 in chips) 
Seat 3: iRivuLose ($101.49 in chips) 
Seat 5: korlito69 ($50.63 in chips) 
Seat 6: hurtNCYDE ($106.92 in chips) 
Seat 7: matiko09 ($101.50 in chips) 
Seat 8: Pacifistas ($110.15 in chips) 
HITYESCA will be allowed to play after the button
korlito69: posts small blind $0.50
hurtNCYDE: posts big blind $1
WrongButton: sits out 
*** HOLE CARDS ***
Dealt to matiko09 [Kh 3d]
matiko09: folds 
Pacifistas: folds 
cap. marb: raises $1.12 to $2.12
azzad2007: folds 
iRivuLose: raises $4.88 to $7
korlito69: folds 
hurtNCYDE: folds 
cap. marb: folds 
Uncalled bet ($4.88) returned to iRivuLose
iRivuLose collected $5.74 from pot
iRivuLose: doesn't show hand 
*** SUMMARY ***
Total pot $5.74 | Rake $0 
Seat 1: cap. marb folded before Flop
Seat 2: azzad2007 folded before Flop (didn't bet)
Seat 3: iRivuLose (button) collected ($5.74)
Seat 5: korlito69 (small blind) folded before Flop
Seat 6: hurtNCYDE (big blind) folded before Flop
Seat 7: matiko09 folded before Flop (didn't bet)
Seat 8: Pacifistas folded before Flop (didn't bet)





PokerStars Hand #152662381694:  Hold'em No Limit ($0.50/$1.00 USD) - 2016/04/30 18:36:21 CET [2016/04/30 12:36:21 ET]
Table 'Tamariwa' 9-max Seat #3 is the button
Seat 1: koksskrt ($100 in chips) 
Seat 2: ryanshades ($84.35 in chips) 
Seat 3: matiko09 ($100 in chips) 
Seat 4: cap. marb ($126.28 in chips) 
Seat 5: bigacsiga ($100 in chips) 
Seat 6: El tourist ($9.75 in chips) 
Seat 8: JWU418 ($69.91 in chips) 
Seat 9: ApkawaDavit ($238.20 in chips) 
cap. marb: posts small blind $0.50
bigacsiga: posts big blind $1
Pacifistas: sits out 
*** HOLE CARDS ***
Dealt to matiko09 [7s 6s]
El tourist: folds 
JWU418: folds 
ApkawaDavit: folds 
koksskrt: folds 
ryanshades: folds 
matiko09: raises $1.27 to $2.27
cap. marb: folds 
bigacsiga: folds 
Uncalled bet ($1.27) returned to matiko09
matiko09 collected $2.50 from pot
matiko09: doesn't show hand 
*** SUMMARY ***
Total pot $2.50 | Rake $0 
Seat 1: koksskrt folded before Flop (didn't bet)
Seat 2: ryanshades folded before Flop (didn't bet)
Seat 3: matiko09 (button) collected ($2.50)
Seat 4: cap. marb (small blind) folded before Flop
Seat 5: bigacsiga (big blind) folded before Flop
Seat 6: El tourist folded before Flop (didn't bet)
Seat 8: JWU418 folded before Flop (didn't bet)
Seat 9: ApkawaDavit folded before Flop (didn't bet)





PokerStars Hand #152662395886:  Hold'em No Limit ($0.50/$1.00 USD) - 2016/04/30 18:36:39 CET [2016/04/30 12:36:39 ET]
Table 'Ruvuma' 9-max Seat #5 is the button
Seat 1: Ilov3NBA ($106.38 in chips) 
Seat 2: Spid1 ($100.25 in chips) 
Seat 3: OneTwo81 ($101.22 in chips) 
Seat 4: splicanin1 ($102.43 in chips) 
Seat 5: 1CANSEEY0U ($62.09 in chips) 
Seat 6: Pacifistas ($111.70 in chips) 
Seat 7: matiko09 ($100 in chips) 
Seat 8: Bailey Dew ($100 in chips) 
Seat 9: ApkawaDavit ($131.28 in chips) 
Pacifistas: posts small blind $0.50
matiko09: posts big blind $1
*** HOLE CARDS ***
Dealt to matiko09 [8s 3c]
Bailey Dew: folds 
ApkawaDavit: folds 
Ilov3NBA: folds 
Spid1: folds 
OneTwo81: calls $1
splicanin1: folds 
1CANSEEY0U: raises $2 to $3
Pacifistas: folds 
matiko09: folds 
OneTwo81: calls $2
*** FLOP *** [2c 4h Qh]
OneTwo81: checks 
1CANSEEY0U: bets $4
OneTwo81: folds 
Uncalled bet ($4) returned to 1CANSEEY0U
1CANSEEY0U collected $7.12 from pot
1CANSEEY0U: doesn't show hand 
*** SUMMARY ***
Total pot $7.50 | Rake $0.38 
Board [2c 4h Qh]
Seat 1: Ilov3NBA folded before Flop (didn't bet)
Seat 2: Spid1 folded before Flop (didn't bet)
Seat 3: OneTwo81 folded on the Flop
Seat 4: splicanin1 folded before Flop (didn't bet)
Seat 5: 1CANSEEY0U (button) collected ($7.12)
Seat 6: Pacifistas (small blind) folded before Flop
Seat 7: matiko09 (big blind) folded before Flop
Seat 8: Bailey Dew folded before Flop (didn't bet)
Seat 9: ApkawaDavit folded before Flop (didn't bet)





PokerStars Hand #152662396155:  Hold'em No Limit ($0.50/$1.00 USD) - 2016/04/30 18:36:39 CET [2016/04/30 12:36:39 ET]
Table 'Selinur II' 9-max Seat #9 is the button
Seat 1: bigacsiga ($148 in chips) 
Seat 2: matiko09 ($100 in chips) 
Seat 7: azqanaz ($34.50 in chips) 
Seat 8: Pacifistas ($100 in chips) 
Seat 9: Spid1 ($100 in chips) 
bigacsiga: posts small blind $0.50
matiko09: posts big blind $1
HITYESCA: sits out 
*** HOLE CARDS ***
Dealt to matiko09 [Js Ts]
azqanaz: raises $2 to $3
Pacifistas: folds 
Spid1: folds 
bigacsiga: folds 
matiko09: folds 
Uncalled bet ($2) returned to azqanaz
azqanaz collected $2.50 from pot
*** SUMMARY ***
Total pot $2.50 | Rake $0 
Seat 1: bigacsiga (small blind) folded before Flop
Seat 2: matiko09 (big blind) folded before Flop
Seat 7: azqanaz collected ($2.50)
Seat 8: Pacifistas folded before Flop (didn't bet)
Seat 9: Spid1 (button) folded before Flop (didn't bet)





PokerStars Hand #152662400806:  Hold'em No Limit ($0.50/$1.00 USD) - 2016/04/30 18:36:45 CET [2016/04/30 12:36:45 ET]
Table 'Goto' 9-max Seat #7 is the button
Seat 1: naaaate_diaz ($134.77 in chips) 
Seat 2: matiko09 ($115.77 in chips) 
Seat 3: cap. marb ($42.08 in chips) 
Seat 4: koksskrt ($103.78 in chips) 
Seat 5: Ilov3NBA ($100.75 in chips) 
Seat 6: puszi77 ($262.36 in chips) 
Seat 7: hurtNCYDE ($100 in chips) 
Seat 8: splicanin1 ($100.12 in chips) 
Seat 9: Pacifistas ($100 in chips) 
splicanin1: posts small blind $0.50
Pacifistas: posts big blind $1
*** HOLE CARDS ***
Dealt to matiko09 [5h Jd]
naaaate_diaz: folds 
matiko09: folds 
cap. marb: folds 
koksskrt: folds 
Ilov3NBA: raises $1.50 to $2.50
puszi77: folds 
hurtNCYDE: folds 
splicanin1: folds 
Pacifistas: folds 
Uncalled bet ($1.50) returned to Ilov3NBA
Ilov3NBA collected $2.50 from pot
Ilov3NBA: doesn't show hand 
*** SUMMARY ***
Total pot $2.50 | Rake $0 
Seat 1: naaaate_diaz folded before Flop (didn't bet)
Seat 2: matiko09 folded before Flop (didn't bet)
Seat 3: cap. marb folded before Flop (didn't bet)
Seat 4: koksskrt folded before Flop (didn't bet)
Seat 5: Ilov3NBA collected ($2.50)
Seat 6: puszi77 folded before Flop (didn't bet)
Seat 7: hurtNCYDE (button) folded before Flop (didn't bet)
Seat 8: splicanin1 (small blind) folded before Flop
Seat 9: Pacifistas (big blind) folded before Flop





PokerStars Hand #152662401813:  Hold'em No Limit ($0.50/$1.00 USD) - 2016/04/30 18:36:46 CET [2016/04/30 12:36:46 ET]
Table 'Lova II' 9-max Seat #8 is the button
Seat 1: Pacifistas ($107.58 in chips) 
Seat 2: bilukm ($298.74 in chips) 
Seat 3: matiko09 ($102.87 in chips) 
Seat 4: VanDobeln ($124.95 in chips) 
Seat 5: Ilov3NBA ($162.51 in chips) 
Seat 7: Szevasztopol ($106.82 in chips) 
Seat 8: cap. marb ($57.39 in chips) 
Pacifistas: posts small blind $0.50
bilukm: posts big blind $1
HITYESCA: sits out 
*** HOLE CARDS ***
Dealt to matiko09 [Td 3c]
matiko09: folds 
VanDobeln: folds 
Ilov3NBA: folds 
Szevasztopol: folds 
cap. marb: folds 
Pacifistas: folds 
Uncalled bet ($0.50) returned to bilukm
bilukm collected $1 from pot
bilukm: doesn't show hand 
*** SUMMARY ***
Total pot $1 | Rake $0 
Seat 1: Pacifistas (small blind) folded before Flop
Seat 2: bilukm (big blind) collected ($1)
Seat 3: matiko09 folded before Flop (didn't bet)
Seat 4: VanDobeln folded before Flop (didn't bet)
Seat 5: Ilov3NBA folded before Flop (didn't bet)
Seat 7: Szevasztopol folded before Flop (didn't bet)
Seat 8: cap. marb (button) folded before Flop (didn't bet)





PokerStars Hand #152662403542:  Hold'em No Limit ($0.50/$1.00 USD) - 2016/04/30 18:36:48 CET [2016/04/30 12:36:48 ET]
Table 'Tamariwa' 9-max Seat #4 is the button
Seat 1: koksskrt ($100 in chips) 
Seat 2: ryanshades ($84.35 in chips) 
Seat 3: matiko09 ($101.50 in chips) 
Seat 4: cap. marb ($125.78 in chips) 
Seat 5: bigacsiga ($100 in chips) 
Seat 6: El tourist ($9.75 in chips) 
Seat 8: JWU418 ($69.91 in chips) 
Seat 9: ApkawaDavit ($238.20 in chips) 
bigacsiga: posts small blind $0.50
El tourist: posts big blind $1
Pacifistas: sits out 
*** HOLE CARDS ***
Dealt to matiko09 [4c 9d]
JWU418: raises $1.60 to $2.60
ApkawaDavit: folds 
koksskrt: folds 
ryanshades: folds 
matiko09: folds 
cap. marb: folds 
bigacsiga: folds 
El tourist: folds 
Uncalled bet ($1.60) returned to JWU418
JWU418 collected $2.50 from pot
JWU418: doesn't show hand 
*** SUMMARY ***
Total pot $2.50 | Rake $0 
Seat 1: koksskrt folded before Flop (didn't bet)
Seat 2: ryanshades folded before Flop (didn't bet)
Seat 3: matiko09 folded before Flop (didn't bet)
Seat 4: cap. marb (button) folded before Flop (didn't bet)
Seat 5: bigacsiga (small blind) folded before Flop
Seat 6: El tourist (big blind) folded before Flop
Seat 8: JWU418 collected ($2.50)
Seat 9: ApkawaDavit folded before Flop (didn't bet)





PokerStars Hand #152662406600:  Hold'em No Limit ($0.50/$1.00 USD) - 2016/04/30 18:36:52 CET [2016/04/30 12:36:52 ET]
Table 'Dagmar' 9-max Seat #6 is the button
Seat 1: matiko09 ($100 in chips) 
Seat 2: Spid1 ($165.95 in chips) 
Seat 3: ApkawaDavit ($116.20 in chips) 
Seat 5: cap. marb ($47.02 in chips) 
Seat 6: arctur17 ($105.03 in chips) 
Seat 7: kswmh ($96.48 in chips) 
Seat 8: Ilov3NBA ($145.98 in chips) 
Seat 9: okkernoot111 ($145.35 in chips) 
kswmh: posts small blind $0.50
Ilov3NBA: posts big blind $1
RoadtoNepal: sits out 
*** HOLE CARDS ***
Dealt to matiko09 [Ah 4s]
okkernoot111: folds 
matiko09: folds 
Spid1: raises $2 to $3
ApkawaDavit: folds 
cap. marb: folds 
arctur17: folds 
kswmh: calls $2.50
Ilov3NBA: folds 
*** FLOP *** [7s 8d Ts]
kswmh: bets $5
Spid1: calls $5
*** TURN *** [7s 8d Ts] [3d]
kswmh: bets $1
Spid1: calls $1
*** RIVER *** [7s 8d Ts 3d] [Ks]
kswmh: bets $1
Spid1: raises $10 to $11
kswmh: calls $10
*** SHOW DOWN ***
Spid1: shows [As Kc] (a pair of Kings)
kswmh: mucks hand 
Spid1 collected $38.95 from pot
*** SUMMARY ***
Total pot $41 | Rake $2.05 
Board [7s 8d Ts 3d Ks]
Seat 1: matiko09 folded before Flop (didn't bet)
Seat 2: Spid1 showed [As Kc] and won ($38.95) with a pair of Kings
Seat 3: ApkawaDavit folded before Flop (didn't bet)
Seat 5: cap. marb folded before Flop (didn't bet)
Seat 6: arctur17 (button) folded before Flop (didn't bet)
Seat 7: kswmh (small blind) mucked [9h 9c]
Seat 8: Ilov3NBA (big blind) folded before Flop
Seat 9: okkernoot111 folded before Flop (didn't bet)





PokerStars Hand #152662413974:  Hold'em No Limit ($0.50/$1.00 USD) - 2016/04/30 18:37:02 CET [2016/04/30 12:37:02 ET]
Table 'Selinur II' 9-max Seat #1 is the button
Seat 1: bigacsiga ($147.50 in chips) 
Seat 2: matiko09 ($100 in chips) 
Seat 3: HITYESCA ($100 in chips) 
Seat 7: azqanaz ($36 in chips) 
Seat 8: Pacifistas ($100 in chips) 
Seat 9: Spid1 ($100 in chips) 
matiko09: posts small blind $0.50
HITYESCA: posts big blind $1
*** HOLE CARDS ***
Dealt to matiko09 [9s 3d]
azqanaz: folds 
Pacifistas: folds 
Spid1: raises $1.50 to $2.50
bigacsiga: folds 
matiko09: folds 
HITYESCA: folds 
Uncalled bet ($1.50) returned to Spid1
Spid1 collected $2.50 from pot
*** SUMMARY ***
Total pot $2.50 | Rake $0 
Seat 1: bigacsiga (button) folded before Flop (didn't bet)
Seat 2: matiko09 (small blind) folded before Flop
Seat 3: HITYESCA (big blind) folded before Flop
Seat 7: azqanaz folded before Flop (didn't bet)
Seat 8: Pacifistas folded before Flop (didn't bet)
Seat 9: Spid1 collected ($2.50)





PokerStars Hand #152662416780:  Hold'em No Limit ($0.50/$1.00 USD) - 2016/04/30 18:37:05 CET [2016/04/30 12:37:05 ET]
Table 'Raissa II' 9-max Seat #5 is the button
Seat 1: cap. marb ($40.82 in chips) 
Seat 2: azzad2007 ($113.90 in chips) 
Seat 3: iRivuLose ($105.11 in chips) 
Seat 5: korlito69 ($50.13 in chips) 
Seat 6: hurtNCYDE ($105.92 in chips) 
Seat 7: matiko09 ($101.50 in chips) 
Seat 8: Pacifistas ($110.15 in chips) 
hurtNCYDE: posts small blind $0.50
matiko09: posts big blind $1
WrongButton: sits out 
HITYESCA: sits out 
*** HOLE CARDS ***
Dealt to matiko09 [Ac Kh]
Pacifistas: folds 
cap. marb: folds 
azzad2007: folds 
iRivuLose: folds 
korlito69: folds 
hurtNCYDE: folds 
Uncalled bet ($0.50) returned to matiko09
matiko09 collected $1 from pot
matiko09: doesn't show hand 
*** SUMMARY ***
Total pot $1 | Rake $0 
Seat 1: cap. marb folded before Flop (didn't bet)
Seat 2: azzad2007 folded before Flop (didn't bet)
Seat 3: iRivuLose folded before Flop (didn't bet)
Seat 5: korlito69 (button) folded before Flop (didn't bet)
Seat 6: hurtNCYDE (small blind) folded before Flop
Seat 7: matiko09 (big blind) collected ($1)
Seat 8: Pacifistas folded before Flop (didn't bet)





PokerStars Hand #152662420042:  Hold'em No Limit ($0.50/$1.00 USD) - 2016/04/30 18:37:10 CET [2016/04/30 12:37:10 ET]
Table 'Hippasos' 9-max Seat #9 is the button
Seat 1: MRC63S ($35.50 in chips) 
Seat 2: matiko09 ($100 in chips) 
Seat 5: boutabi ($136.58 in chips) 
Seat 6: JACQUILF ($100 in chips) 
Seat 7: ilaviiitech ($100 in chips) 
Seat 8: Spid1 ($100 in chips) 
Seat 9: ApkawaDavit ($104.62 in chips) 
MRC63S: posts small blind $0.50
matiko09: posts big blind $1
WrongButton: sits out 
*** HOLE CARDS ***
Dealt to matiko09 [6s 4s]
boutabi: raises $1 to $2
JACQUILF: folds 
ilaviiitech: calls $2
Spid1: folds 
ApkawaDavit: folds 
MRC63S: calls $1.50
matiko09: folds 
*** FLOP *** [Kh Kd Qd]
MRC63S: bets $2
boutabi: calls $2
ilaviiitech: calls $2
*** TURN *** [Kh Kd Qd] [2d]
MRC63S: bets $3
boutabi: calls $3
ilaviiitech: folds 
*** RIVER *** [Kh Kd Qd 2d] [3s]
MRC63S: checks 
boutabi: bets $21
MRC63S: calls $21
*** SHOW DOWN ***
boutabi: shows [8d Jc] (a pair of Kings)
MRC63S: shows [Js Qh] (two pair, Kings and Queens)
MRC63S collected $58.50 from pot
*** SUMMARY ***
Total pot $61 | Rake $2.50 
Board [Kh Kd Qd 2d 3s]
Seat 1: MRC63S (small blind) showed [Js Qh] and won ($58.50) with two pair, Kings and Queens
Seat 2: matiko09 (big blind) folded before Flop
Seat 5: boutabi showed [8d Jc] and lost with a pair of Kings
Seat 6: JACQUILF folded before Flop (didn't bet)
Seat 7: ilaviiitech folded on the Turn
Seat 8: Spid1 folded before Flop (didn't bet)
Seat 9: ApkawaDavit (button) folded before Flop (didn't bet)





PokerStars Hand #152662421387:  Hold'em No Limit ($0.50/$1.00 USD) - 2016/04/30 18:37:11 CET [2016/04/30 12:37:11 ET]
Table 'Lova II' 9-max Seat #1 is the button
Seat 1: Pacifistas ($107.08 in chips) 
Seat 2: bilukm ($299.24 in chips) 
Seat 3: matiko09 ($102.87 in chips) 
Seat 4: VanDobeln ($124.95 in chips) 
Seat 5: Ilov3NBA ($162.51 in chips) 
Seat 7: Szevasztopol ($106.82 in chips) 
Seat 8: cap. marb ($57.39 in chips) 
bilukm: posts small blind $0.50
matiko09: posts big blind $1
HITYESCA: sits out 
*** HOLE CARDS ***
Dealt to matiko09 [Qc Tc]
VanDobeln: folds 
Ilov3NBA: folds 
Szevasztopol: folds 
cap. marb: folds 
Pacifistas: folds 
bilukm: calls $0.50
matiko09: raises $3 to $4
bilukm: folds 
Uncalled bet ($3) returned to matiko09
matiko09 collected $2 from pot
matiko09: doesn't show hand 
*** SUMMARY ***
Total pot $2 | Rake $0 
Seat 1: Pacifistas (button) folded before Flop (didn't bet)
Seat 2: bilukm (small blind) folded before Flop
Seat 3: matiko09 (big blind) collected ($2)
Seat 4: VanDobeln folded before Flop (didn't bet)
Seat 5: Ilov3NBA folded before Flop (didn't bet)
Seat 7: Szevasztopol folded before Flop (didn't bet)
Seat 8: cap. marb folded before Flop (didn't bet)





PokerStars Hand #152662426544:  Hold'em No Limit ($0.50/$1.00 USD) - 2016/04/30 18:37:18 CET [2016/04/30 12:37:18 ET]
Table 'Tamariwa' 9-max Seat #5 is the button
Seat 1: koksskrt ($100 in chips) 
Seat 2: ryanshades ($84.35 in chips) 
Seat 3: matiko09 ($101.50 in chips) 
Seat 4: cap. marb ($125.78 in chips) 
Seat 5: bigacsiga ($100 in chips) 
Seat 6: El tourist ($8.75 in chips) 
Seat 7: Pacifistas ($100 in chips) 
Seat 8: JWU418 ($71.41 in chips) 
Seat 9: ApkawaDavit ($238.20 in chips) 
El tourist: posts small blind $0.50
Pacifistas: posts big blind $1
*** HOLE CARDS ***
Dealt to matiko09 [5c 2c]
JWU418: folds 
ApkawaDavit: folds 
koksskrt: folds 
ryanshades: folds 
matiko09: folds 
cap. marb: folds 
bigacsiga: folds 
El tourist: raises $7.75 to $8.75 and is all-in
Pacifistas: calls $7.75
*** FLOP *** [9h Kd 8c]
*** TURN *** [9h Kd 8c] [6s]
*** RIVER *** [9h Kd 8c 6s] [Jd]
*** SHOW DOWN ***
El tourist: shows [Qd Qc] (a pair of Queens)
Pacifistas: shows [Kh Js] (two pair, Kings and Jacks)
Pacifistas collected $16.62 from pot
*** SUMMARY ***
Total pot $17.50 | Rake $0.88 
Board [9h Kd 8c 6s Jd]
Seat 1: koksskrt folded before Flop (didn't bet)
Seat 2: ryanshades folded before Flop (didn't bet)
Seat 3: matiko09 folded before Flop (didn't bet)
Seat 4: cap. marb folded before Flop (didn't bet)
Seat 5: bigacsiga (button) folded before Flop (didn't bet)
Seat 6: El tourist (small blind) showed [Qd Qc] and lost with a pair of Queens
Seat 7: Pacifistas (big blind) showed [Kh Js] and won ($16.62) with two pair, Kings and Jacks
Seat 8: JWU418 folded before Flop (didn't bet)
Seat 9: ApkawaDavit folded before Flop (didn't bet)





PokerStars Hand #152662428567:  Hold'em No Limit ($0.50/$1.00 USD) - 2016/04/30 18:37:20 CET [2016/04/30 12:37:20 ET]
Table 'Ruvuma' 9-max Seat #6 is the button
Seat 1: Ilov3NBA ($106.38 in chips) 
Seat 2: Spid1 ($100.25 in chips) 
Seat 3: OneTwo81 ($98.22 in chips) 
Seat 4: splicanin1 ($102.43 in chips) 
Seat 5: 1CANSEEY0U ($66.21 in chips) 
Seat 6: Pacifistas ($111.20 in chips) 
Seat 7: matiko09 ($100 in chips) 
Seat 8: Bailey Dew ($100 in chips) 
Seat 9: ApkawaDavit ($131.28 in chips) 
matiko09: posts small blind $0.50
Bailey Dew: posts big blind $1
*** HOLE CARDS ***
Dealt to matiko09 [3h 9s]
ApkawaDavit: folds 
Ilov3NBA: folds 
Spid1: folds 
OneTwo81: folds 
splicanin1: folds 
1CANSEEY0U: calls $1
Pacifistas: folds 
matiko09: folds 
Bailey Dew: raises $3 to $4
1CANSEEY0U: calls $3
*** FLOP *** [Kc Tc 6s]
Bailey Dew: bets $6
1CANSEEY0U: calls $6
*** TURN *** [Kc Tc 6s] [4h]
Bailey Dew: bets $14.98
1CANSEEY0U: calls $14.98
*** RIVER *** [Kc Tc 6s 4h] [5c]
Bailey Dew: bets $41
1CANSEEY0U: folds [Kh]
Uncalled bet ($41) returned to Bailey Dew
Bailey Dew collected $47.96 from pot
Bailey Dew: doesn't show hand 
*** SUMMARY ***
Total pot $50.46 | Rake $2.50 
Board [Kc Tc 6s 4h 5c]
Seat 1: Ilov3NBA folded before Flop (didn't bet)
Seat 2: Spid1 folded before Flop (didn't bet)
Seat 3: OneTwo81 folded before Flop (didn't bet)
Seat 4: splicanin1 folded before Flop (didn't bet)
Seat 5: 1CANSEEY0U folded on the River
Seat 6: Pacifistas (button) folded before Flop (didn't bet)
Seat 7: matiko09 (small blind) folded before Flop
Seat 8: Bailey Dew (big blind) collected ($47.96)
Seat 9: ApkawaDavit folded before Flop (didn't bet)





PokerStars Hand #152662430894:  Hold'em No Limit ($0.50/$1.00 USD) - 2016/04/30 18:37:23 CET [2016/04/30 12:37:23 ET]
Table 'Selinur II' 9-max Seat #2 is the button
Seat 1: bigacsiga ($147.50 in chips) 
Seat 2: matiko09 ($100 in chips) 
Seat 3: HITYESCA ($100 in chips) 
Seat 7: azqanaz ($36 in chips) 
Seat 8: Pacifistas ($100 in chips) 
Seat 9: Spid1 ($101.50 in chips) 
HITYESCA: posts small blind $0.50
azqanaz: posts big blind $1
*** HOLE CARDS ***
Dealt to matiko09 [9d 6d]
Pacifistas: folds 
Spid1: folds 
bigacsiga: raises $1.50 to $2.50
matiko09: folds 
HITYESCA: folds 
azqanaz: raises $5.50 to $8
bigacsiga: folds 
Uncalled bet ($5.50) returned to azqanaz
azqanaz collected $5.50 from pot
*** SUMMARY ***
Total pot $5.50 | Rake $0 
Seat 1: bigacsiga folded before Flop
Seat 2: matiko09 (button) folded before Flop (didn't bet)
Seat 3: HITYESCA (small blind) folded before Flop
Seat 7: azqanaz (big blind) collected ($5.50)
Seat 8: Pacifistas folded before Flop (didn't bet)
Seat 9: Spid1 folded before Flop (didn't bet)





PokerStars Hand #152662430567:  Hold'em No Limit (€0.50/€1.00 EUR) - 2016/04/30 18:37:23 CET [2016/04/30 12:37:23 ET]
Table 'Benda' 9-max Seat #2 is the button
Seat 1: WrongButton (€100 in chips) 
Seat 2: cap. marb (€73.75 in chips) 
Seat 3: ApkawaDavit (€193.13 in chips) 
Seat 5: hurtNCYDE (€103.97 in chips) 
Seat 6: Nunzio1985ct (€45.59 in chips) 
Seat 7: Ouga Buga (€100 in chips) 
Seat 8: matiko09 (€100 in chips) 
Seat 9: Racushniak (€156.98 in chips) 
ApkawaDavit: posts small blind €0.50
hurtNCYDE: posts big blind €1
*** HOLE CARDS ***
Dealt to matiko09 [2s Jd]
Nunzio1985ct: folds 
Ouga Buga: folds 
fireball2112 leaves the table
matiko09: folds 
Racushniak: folds 
WrongButton: raises €2 to €3
cap. marb: folds 
ApkawaDavit: folds 
hurtNCYDE: folds 
Uncalled bet (€2) returned to WrongButton
WrongButton collected €2.50 from pot
*** SUMMARY ***
Total pot €2.50 | Rake €0 
Seat 1: WrongButton collected (€2.50)
Seat 2: cap. marb (button) folded before Flop (didn't bet)
Seat 3: ApkawaDavit (small blind) folded before Flop
Seat 5: hurtNCYDE (big blind) folded before Flop
Seat 6: Nunzio1985ct folded before Flop (didn't bet)
Seat 7: Ouga Buga folded before Flop (didn't bet)
Seat 8: matiko09 folded before Flop (didn't bet)
Seat 9: Racushniak folded before Flop (didn't bet)





PokerStars Hand #152662435270:  Hold'em No Limit ($0.50/$1.00 USD) - 2016/04/30 18:37:29 CET [2016/04/30 12:37:29 ET]
Table 'Kalliope II' 9-max Seat #4 is the button
Seat 1: cap. marb ($37.61 in chips) 
Seat 2: MijasMarco ($59 in chips) 
Seat 3: matiko09 ($100 in chips) 
Seat 4: Ilov3NBA ($123.42 in chips) 
Seat 5: SIMONE280201 ($56.41 in chips) 
Seat 6: hurtNCYDE ($107.96 in chips) 
Seat 7: ApkawaDavit ($161.35 in chips) 
Seat 8: RoadtoNepal ($102.22 in chips) 
Seat 9: scaihaze ($115.14 in chips) 
SIMONE280201: posts small blind $0.50
hurtNCYDE: posts big blind $1
*** HOLE CARDS ***
Dealt to matiko09 [Ts 3s]
ApkawaDavit: folds 
RoadtoNepal: folds 
scaihaze: folds 
cap. marb: folds 
MijasMarco: folds 
matiko09: folds 
Ilov3NBA: folds 
SIMONE280201: raises $1 to $2
hurtNCYDE: folds 
Uncalled bet ($1) returned to SIMONE280201
SIMONE280201 collected $2 from pot
*** SUMMARY ***
Total pot $2 | Rake $0 
Seat 1: cap. marb folded before Flop (didn't bet)
Seat 2: MijasMarco folded before Flop (didn't bet)
Seat 3: matiko09 folded before Flop (didn't bet)
Seat 4: Ilov3NBA (button) folded before Flop (didn't bet)
Seat 5: SIMONE280201 (small blind) collected ($2)
Seat 6: hurtNCYDE (big blind) folded before Flop
Seat 7: ApkawaDavit folded before Flop (didn't bet)
Seat 8: RoadtoNepal folded before Flop (didn't bet)
Seat 9: scaihaze folded before Flop (didn't bet)





PokerStars Hand #152662439036:  Hold'em No Limit ($0.50/$1.00 USD) - 2016/04/30 18:37:34 CET [2016/04/30 12:37:34 ET]
Table 'Raissa II' 9-max Seat #6 is the button
Seat 1: cap. marb ($40.82 in chips) 
Seat 2: azzad2007 ($113.90 in chips) 
Seat 3: iRivuLose ($105.11 in chips) 
Seat 5: korlito69 ($50.13 in chips) 
Seat 6: hurtNCYDE ($105.42 in chips) 
Seat 7: matiko09 ($102 in chips) 
Seat 8: Pacifistas ($110.15 in chips) 
matiko09: posts small blind $0.50
Pacifistas: posts big blind $1
WrongButton: sits out 
HITYESCA: sits out 
*** HOLE CARDS ***
Dealt to matiko09 [9s 8c]
cap. marb: folds 
azzad2007: folds 
iRivuLose: folds 
korlito69: folds 
hurtNCYDE: folds 
matiko09: folds 
Uncalled bet ($0.50) returned to Pacifistas
Pacifistas collected $1 from pot
Pacifistas: doesn't show hand 
*** SUMMARY ***
Total pot $1 | Rake $0 
Seat 1: cap. marb folded before Flop (didn't bet)
Seat 2: azzad2007 folded before Flop (didn't bet)
Seat 3: iRivuLose folded before Flop (didn't bet)
Seat 5: korlito69 folded before Flop (didn't bet)
Seat 6: hurtNCYDE (button) folded before Flop (didn't bet)
Seat 7: matiko09 (small blind) folded before Flop
Seat 8: Pacifistas (big blind) collected ($1)





PokerStars Hand #152662452667:  Hold'em No Limit ($0.50/$1.00 USD) - 2016/04/30 18:37:52 CET [2016/04/30 12:37:52 ET]
Table 'Lova II' 9-max Seat #2 is the button
Seat 1: Pacifistas ($107.08 in chips) 
Seat 2: bilukm ($298.24 in chips) 
Seat 3: matiko09 ($103.87 in chips) 
Seat 4: VanDobeln ($124.95 in chips) 
Seat 5: Ilov3NBA ($162.51 in chips) 
Seat 7: Szevasztopol ($106.82 in chips) 
Seat 8: cap. marb ($57.39 in chips) 
matiko09: posts small blind $0.50
VanDobeln: posts big blind $1
HITYESCA: sits out 
*** HOLE CARDS ***
Dealt to matiko09 [8d Th]
Ilov3NBA: folds 
Szevasztopol: folds 
cap. marb: folds 
Pacifistas: folds 
bilukm: folds 
matiko09: folds 
Uncalled bet ($0.50) returned to VanDobeln
VanDobeln collected $1 from pot
VanDobeln: doesn't show hand 
*** SUMMARY ***
Total pot $1 | Rake $0 
Seat 1: Pacifistas folded before Flop (didn't bet)
Seat 2: bilukm (button) folded before Flop (didn't bet)
Seat 3: matiko09 (small blind) folded before Flop
Seat 4: VanDobeln (big blind) collected ($1)
Seat 5: Ilov3NBA folded before Flop (didn't bet)
Seat 7: Szevasztopol folded before Flop (didn't bet)
Seat 8: cap. marb folded before Flop (didn't bet)





PokerStars Hand #152662454819:  Hold'em No Limit ($0.50/$1.00 USD) - 2016/04/30 18:37:54 CET [2016/04/30 12:37:54 ET]
Table 'Selinur II' 9-max Seat #3 is the button
Seat 1: bigacsiga ($145 in chips) 
Seat 2: matiko09 ($100 in chips) 
Seat 3: HITYESCA ($100 in chips) 
Seat 7: azqanaz ($39 in chips) 
Seat 8: Pacifistas ($100 in chips) 
Seat 9: Spid1 ($101.50 in chips) 
azqanaz: posts small blind $0.50
Pacifistas: posts big blind $1
*** HOLE CARDS ***
Dealt to matiko09 [6d Ks]
Spid1: folds 
bigacsiga: folds 
matiko09: folds 
HITYESCA: folds 
azqanaz: raises $2 to $3
Pacifistas: calls $2
*** FLOP *** [Kh Qd Jh]
azqanaz: bets $2.85
Daniel Daffe joins the table at seat #6 
cap. marb joins the table at seat #4 
Pacifistas: folds 
Uncalled bet ($2.85) returned to azqanaz
azqanaz collected $5.70 from pot
*** SUMMARY ***
Total pot $6 | Rake $0.30 
Board [Kh Qd Jh]
Seat 1: bigacsiga folded before Flop (didn't bet)
Seat 2: matiko09 folded before Flop (didn't bet)
Seat 3: HITYESCA (button) folded before Flop (didn't bet)
Seat 7: azqanaz (small blind) collected ($5.70)
Seat 8: Pacifistas (big blind) folded on the Flop
Seat 9: Spid1 folded before Flop (didn't bet)





PokerStars Hand #152662455347:  Hold'em No Limit (€0.50/€1.00 EUR) - 2016/04/30 18:37:55 CET [2016/04/30 12:37:55 ET]
Table 'Benda' 9-max Seat #3 is the button
Seat 1: WrongButton (€101.50 in chips) 
Seat 2: cap. marb (€73.75 in chips) 
Seat 3: ApkawaDavit (€192.63 in chips) 
Seat 5: hurtNCYDE (€102.97 in chips) 
Seat 6: Nunzio1985ct (€45.59 in chips) 
Seat 7: Ouga Buga (€100 in chips) 
Seat 8: matiko09 (€100 in chips) 
Seat 9: Racushniak (€156.98 in chips) 
hurtNCYDE: posts small blind €0.50
Nunzio1985ct: posts big blind €1
*** HOLE CARDS ***
Dealt to matiko09 [5s Qs]
Ouga Buga: folds 
matiko09: folds 
Racushniak: folds 
WrongButton: folds 
cap. marb: raises €1.12 to €2.12
ApkawaDavit: folds 
hurtNCYDE: folds 
Nunzio1985ct: calls €1.12
*** FLOP *** [Td Qh 6h]
Nunzio1985ct: checks 
cap. marb: bets €2.97
Nunzio1985ct: folds 
Uncalled bet (€2.97) returned to cap. marb
cap. marb collected €4.50 from pot
cap. marb: doesn't show hand 
*** SUMMARY ***
Total pot €4.74 | Rake €0.24 
Board [Td Qh 6h]
Seat 1: WrongButton folded before Flop (didn't bet)
Seat 2: cap. marb collected (€4.50)
Seat 3: ApkawaDavit (button) folded before Flop (didn't bet)
Seat 5: hurtNCYDE (small blind) folded before Flop
Seat 6: Nunzio1985ct (big blind) folded on the Flop
Seat 7: Ouga Buga folded before Flop (didn't bet)
Seat 8: matiko09 folded before Flop (didn't bet)
Seat 9: Racushniak folded before Flop (didn't bet)





PokerStars Hand #152662456125:  Hold'em No Limit ($0.50/$1.00 USD) - 2016/04/30 18:37:56 CET [2016/04/30 12:37:56 ET]
Table 'Raissa II' 9-max Seat #7 is the button
Seat 1: cap. marb ($40.82 in chips) 
Seat 2: azzad2007 ($113.90 in chips) 
Seat 3: iRivuLose ($105.11 in chips) 
Seat 5: korlito69 ($50.13 in chips) 
Seat 6: hurtNCYDE ($105.42 in chips) 
Seat 7: matiko09 ($101.50 in chips) 
Seat 8: Pacifistas ($110.65 in chips) 
Seat 9: WrongButton ($100 in chips) 
Pacifistas: posts small blind $0.50
WrongButton: posts big blind $1
HITYESCA: sits out 
*** HOLE CARDS ***
Dealt to matiko09 [Ad 4s]
cap. marb: raises $1.12 to $2.12
azzad2007: folds 
iRivuLose: calls $2.12
korlito69: folds 
hurtNCYDE: folds 
matiko09: folds 
Pacifistas: folds 
WrongButton: folds 
*** FLOP *** [4h Kd Js]
cap. marb: bets $3.59
iRivuLose: folds 
Uncalled bet ($3.59) returned to cap. marb
cap. marb collected $5.45 from pot
cap. marb: doesn't show hand 
*** SUMMARY ***
Total pot $5.74 | Rake $0.29 
Board [4h Kd Js]
Seat 1: cap. marb collected ($5.45)
Seat 2: azzad2007 folded before Flop (didn't bet)
Seat 3: iRivuLose folded on the Flop
Seat 5: korlito69 folded before Flop (didn't bet)
Seat 6: hurtNCYDE folded before Flop (didn't bet)
Seat 7: matiko09 (button) folded before Flop (didn't bet)
Seat 8: Pacifistas (small blind) folded before Flop
Seat 9: WrongButton (big blind) folded before Flop





PokerStars Hand #152662457014:  Hold'em No Limit ($0.50/$1.00 USD) - 2016/04/30 18:37:57 CET [2016/04/30 12:37:57 ET]
Table 'Kalliope II' 9-max Seat #5 is the button
Seat 1: cap. marb ($37.61 in chips) 
Seat 2: MijasMarco ($59 in chips) 
Seat 3: matiko09 ($100 in chips) 
Seat 4: Ilov3NBA ($123.42 in chips) 
Seat 5: SIMONE280201 ($57.41 in chips) 
Seat 6: hurtNCYDE ($106.96 in chips) 
Seat 7: ApkawaDavit ($161.35 in chips) 
Seat 8: RoadtoNepal ($102.22 in chips) 
Seat 9: scaihaze ($115.14 in chips) 
hurtNCYDE: posts small blind $0.50
ApkawaDavit: posts big blind $1
*** HOLE CARDS ***
Dealt to matiko09 [Jd 4c]
RoadtoNepal: folds 
scaihaze: folds 
cap. marb: folds 
MijasMarco: folds 
matiko09: folds 
Ilov3NBA: folds 
SIMONE280201: raises $1.50 to $2.50
hurtNCYDE: folds 
ApkawaDavit: calls $1.50
*** FLOP *** [Js Ks 8s]
ApkawaDavit: checks 
SIMONE280201: bets $3
ApkawaDavit: folds 
Uncalled bet ($3) returned to SIMONE280201
SIMONE280201 collected $5.22 from pot
*** SUMMARY ***
Total pot $5.50 | Rake $0.28 
Board [Js Ks 8s]
Seat 1: cap. marb folded before Flop (didn't bet)
Seat 2: MijasMarco folded before Flop (didn't bet)
Seat 3: matiko09 folded before Flop (didn't bet)
Seat 4: Ilov3NBA folded before Flop (didn't bet)
Seat 5: SIMONE280201 (button) collected ($5.22)
Seat 6: hurtNCYDE (small blind) folded before Flop
Seat 7: ApkawaDavit (big blind) folded on the Flop
Seat 8: RoadtoNepal folded before Flop (didn't bet)
Seat 9: scaihaze folded before Flop (didn't bet)





PokerStars Hand #152662466717:  Hold'em No Limit ($0.50/$1.00 USD) - 2016/04/30 18:38:10 CET [2016/04/30 12:38:10 ET]
Table 'Dagmar' 9-max Seat #7 is the button
Seat 1: matiko09 ($100 in chips) 
Seat 2: Spid1 ($184.90 in chips) 
Seat 3: ApkawaDavit ($116.20 in chips) 
Seat 5: cap. marb ($47.02 in chips) 
Seat 6: arctur17 ($105.03 in chips) 
Seat 7: kswmh ($76.48 in chips) 
Seat 8: Ilov3NBA ($144.98 in chips) 
Seat 9: okkernoot111 ($145.35 in chips) 
Ilov3NBA: posts small blind $0.50
okkernoot111: posts big blind $1
RoadtoNepal: sits out 
*** HOLE CARDS ***
Dealt to matiko09 [Qc 5d]
matiko09: folds 
Spid1: folds 
ApkawaDavit: folds 
cap. marb: folds 
arctur17: folds 
kswmh: raises $1 to $2
Ilov3NBA: folds 
okkernoot111: folds 
Uncalled bet ($1) returned to kswmh
kswmh collected $2.50 from pot
kswmh: doesn't show hand 
*** SUMMARY ***
Total pot $2.50 | Rake $0 
Seat 1: matiko09 folded before Flop (didn't bet)
Seat 2: Spid1 folded before Flop (didn't bet)
Seat 3: ApkawaDavit folded before Flop (didn't bet)
Seat 5: cap. marb folded before Flop (didn't bet)
Seat 6: arctur17 folded before Flop (didn't bet)
Seat 7: kswmh (button) collected ($2.50)
Seat 8: Ilov3NBA (small blind) folded before Flop
Seat 9: okkernoot111 (big blind) folded before Flop





PokerStars Hand #152662468803:  Hold'em No Limit ($0.50/$1.00 USD) - 2016/04/30 18:38:12 CET [2016/04/30 12:38:12 ET]
Table 'Tamariwa' 9-max Seat #7 is the button
Seat 1: koksskrt ($100 in chips) 
Seat 2: ryanshades ($84.35 in chips) 
Seat 3: matiko09 ($101.50 in chips) 
Seat 4: cap. marb ($125.78 in chips) 
Seat 5: bigacsiga ($100 in chips) 
Seat 7: Pacifistas ($107.87 in chips) 
Seat 8: JWU418 ($71.41 in chips) 
Seat 9: ApkawaDavit ($238.20 in chips) 
JWU418: posts small blind $0.50
ApkawaDavit: posts big blind $1
*** HOLE CARDS ***
Dealt to matiko09 [6s Qh]
koksskrt: folds 
koksskrt leaves the table
El tourist leaves the table
hurtNCYDE joins the table at seat #1 
ryanshades: folds 
hurtNCYDE leaves the table
I The King I joins the table at seat #1 
I The King I leaves the table
matiko09: folds 
HITYESCA joins the table at seat #1 
cap. marb: folds 
bigacsiga: folds 
Pacifistas: folds 
JACQUILF joins the table at seat #6 
JWU418: folds 
Uncalled bet ($0.50) returned to ApkawaDavit
ApkawaDavit collected $1 from pot
ApkawaDavit: doesn't show hand 
*** SUMMARY ***
Total pot $1 | Rake $0 
Seat 1: koksskrt folded before Flop (didn't bet)
Seat 2: ryanshades folded before Flop (didn't bet)
Seat 3: matiko09 folded before Flop (didn't bet)
Seat 4: cap. marb folded before Flop (didn't bet)
Seat 5: bigacsiga folded before Flop (didn't bet)
Seat 7: Pacifistas (button) folded before Flop (didn't bet)
Seat 8: JWU418 (small blind) folded before Flop
Seat 9: ApkawaDavit (big blind) collected ($1)





PokerStars Hand #152662485756:  Hold'em No Limit ($0.50/$1.00 USD) - 2016/04/30 18:38:34 CET [2016/04/30 12:38:34 ET]
Table 'Hippasos' 9-max Seat #1 is the button
Seat 1: MRC63S ($66 in chips) 
Seat 2: matiko09 ($100 in chips) 
Seat 3: WrongButton ($100 in chips) 
Seat 5: boutabi ($108.58 in chips) 
Seat 6: JACQUILF ($100 in chips) 
Seat 7: ilaviiitech ($100 in chips) 
Seat 8: Spid1 ($100 in chips) 
Seat 9: ApkawaDavit ($104.62 in chips) 
matiko09: posts small blind $0.50
WrongButton: posts big blind $1
*** HOLE CARDS ***
Dealt to matiko09 [Ac Kc]
boutabi: raises $5 to $6
JACQUILF: folds 
ilaviiitech: folds 
Spid1: folds 
ApkawaDavit: folds 
MRC63S: folds 
matiko09: calls $5.50
WrongButton: folds 
*** FLOP *** [7h 6c 5d]
matiko09: checks 
boutabi: bets $12
matiko09: folds 
Uncalled bet ($12) returned to boutabi
boutabi collected $12.35 from pot
*** SUMMARY ***
Total pot $13 | Rake $0.65 
Board [7h 6c 5d]
Seat 1: MRC63S (button) folded before Flop (didn't bet)
Seat 2: matiko09 (small blind) folded on the Flop
Seat 3: WrongButton (big blind) folded before Flop
Seat 5: boutabi collected ($12.35)
Seat 6: JACQUILF folded before Flop (didn't bet)
Seat 7: ilaviiitech folded before Flop (didn't bet)
Seat 8: Spid1 folded before Flop (didn't bet)
Seat 9: ApkawaDavit folded before Flop (didn't bet)





PokerStars Hand #152662487760:  Hold'em No Limit ($0.50/$1.00 USD) - 2016/04/30 18:38:37 CET [2016/04/30 12:38:37 ET]
Table 'Kalliope II' 9-max Seat #6 is the button
Seat 1: cap. marb ($37.61 in chips) 
Seat 2: MijasMarco ($59 in chips) 
Seat 3: matiko09 ($100 in chips) 
Seat 4: Ilov3NBA ($123.42 in chips) 
Seat 5: SIMONE280201 ($60.13 in chips) 
Seat 6: hurtNCYDE ($106.46 in chips) 
Seat 7: ApkawaDavit ($158.85 in chips) 
Seat 8: RoadtoNepal ($102.22 in chips) 
Seat 9: scaihaze ($115.14 in chips) 
ApkawaDavit: posts small blind $0.50
RoadtoNepal: posts big blind $1
*** HOLE CARDS ***
Dealt to matiko09 [6s 2c]
scaihaze: raises $2 to $3
cap. marb: folds 
MijasMarco: folds 
MijasMarco leaves the table
matiko09: folds 
Ilov3NBA: folds 
SIMONE280201: folds 
bigacsiga joins the table at seat #2 
hurtNCYDE: folds 
ApkawaDavit: folds 
RoadtoNepal: folds 
Uncalled bet ($2) returned to scaihaze
scaihaze collected $2.50 from pot
scaihaze: doesn't show hand 
*** SUMMARY ***
Total pot $2.50 | Rake $0 
Seat 1: cap. marb folded before Flop (didn't bet)
Seat 2: MijasMarco folded before Flop (didn't bet)
Seat 3: matiko09 folded before Flop (didn't bet)
Seat 4: Ilov3NBA folded before Flop (didn't bet)
Seat 5: SIMONE280201 folded before Flop (didn't bet)
Seat 6: hurtNCYDE (button) folded before Flop (didn't bet)
Seat 7: ApkawaDavit (small blind) folded before Flop
Seat 8: RoadtoNepal (big blind) folded before Flop
Seat 9: scaihaze collected ($2.50)





PokerStars Hand #152662490832:  Hold'em No Limit ($0.50/$1.00 USD) - 2016/04/30 18:38:41 CET [2016/04/30 12:38:41 ET]
Table 'Tamariwa' 9-max Seat #8 is the button
Seat 1: HITYESCA ($100 in chips) 
Seat 2: ryanshades ($84.35 in chips) 
Seat 3: matiko09 ($101.50 in chips) 
Seat 4: cap. marb ($125.78 in chips) 
Seat 5: bigacsiga ($100 in chips) 
Seat 7: Pacifistas ($107.87 in chips) 
Seat 8: JWU418 ($70.91 in chips) 
Seat 9: ApkawaDavit ($238.70 in chips) 
ApkawaDavit: posts small blind $0.50
HITYESCA: posts big blind $1
JACQUILF: sits out 
*** HOLE CARDS ***
Dealt to matiko09 [Td Qc]
ryanshades: folds 
matiko09: folds 
cap. marb: folds 
bigacsiga: folds 
JACQUILF leaves the table
Pacifistas: folds 
JWU418: folds 
ApkawaDavit: folds 
Uncalled bet ($0.50) returned to HITYESCA
HITYESCA collected $1 from pot
HITYESCA: doesn't show hand 
*** SUMMARY ***
Total pot $1 | Rake $0 
Seat 1: HITYESCA (big blind) collected ($1)
Seat 2: ryanshades folded before Flop (didn't bet)
Seat 3: matiko09 folded before Flop (didn't bet)
Seat 4: cap. marb folded before Flop (didn't bet)
Seat 5: bigacsiga folded before Flop (didn't bet)
Seat 7: Pacifistas folded before Flop (didn't bet)
Seat 8: JWU418 (button) folded before Flop (didn't bet)
Seat 9: ApkawaDavit (small blind) folded before Flop





PokerStars Hand #152662496891:  Hold'em No Limit ($0.50/$1.00 USD) - 2016/04/30 18:38:48 CET [2016/04/30 12:38:48 ET]
Table 'Dagmar' 9-max Seat #8 is the button
Seat 1: matiko09 ($100 in chips) 
Seat 2: Spid1 ($184.90 in chips) 
Seat 3: ApkawaDavit ($116.20 in chips) 
Seat 5: cap. marb ($47.02 in chips) 
Seat 6: arctur17 ($105.03 in chips) 
Seat 7: kswmh ($77.98 in chips) 
Seat 8: Ilov3NBA ($144.48 in chips) 
Seat 9: okkernoot111 ($144.35 in chips) 
okkernoot111: posts small blind $0.50
matiko09: posts big blind $1
RoadtoNepal: sits out 
*** HOLE CARDS ***
Dealt to matiko09 [Jh Jc]
Spid1: folds 
ApkawaDavit: folds 
cap. marb: folds 
arctur17: folds 
kswmh: folds 
Ilov3NBA: folds 
okkernoot111: raises $2 to $3
matiko09: raises $6 to $9
okkernoot111: raises $135.35 to $144.35 and is all-in
matiko09: calls $91 and is all-in
Uncalled bet ($44.35) returned to okkernoot111
*** FLOP *** [2h Js Qh]
*** TURN *** [2h Js Qh] [6s]
*** RIVER *** [2h Js Qh 6s] [Jd]
*** SHOW DOWN ***
okkernoot111: shows [Kd Ad] (a pair of Jacks)
matiko09: shows [Jh Jc] (four of a kind, Jacks)
matiko09 collected $197.50 from pot
*** SUMMARY ***
Total pot $200 | Rake $2.50 
Board [2h Js Qh 6s Jd]
Seat 1: matiko09 (big blind) showed [Jh Jc] and won ($197.50) with four of a kind, Jacks
Seat 2: Spid1 folded before Flop (didn't bet)
Seat 3: ApkawaDavit folded before Flop (didn't bet)
Seat 5: cap. marb folded before Flop (didn't bet)
Seat 6: arctur17 folded before Flop (didn't bet)
Seat 7: kswmh folded before Flop (didn't bet)
Seat 8: Ilov3NBA (button) folded before Flop (didn't bet)
Seat 9: okkernoot111 (small blind) showed [Kd Ad] and lost with a pair of Jacks





PokerStars Hand #152662508699:  Hold'em No Limit ($0.50/$1.00 USD) - 2016/04/30 18:39:03 CET [2016/04/30 12:39:03 ET]
Table 'Ruvuma' 9-max Seat #7 is the button
Seat 1: Ilov3NBA ($106.38 in chips) 
Seat 2: Spid1 ($100.25 in chips) 
Seat 3: OneTwo81 ($98.22 in chips) 
Seat 4: splicanin1 ($102.43 in chips) 
Seat 5: 1CANSEEY0U ($41.23 in chips) 
Seat 6: Pacifistas ($111.20 in chips) 
Seat 7: matiko09 ($100 in chips) 
Seat 8: Bailey Dew ($122.98 in chips) 
Seat 9: ApkawaDavit ($131.28 in chips) 
Bailey Dew: posts small blind $0.50
ApkawaDavit: posts big blind $1
*** HOLE CARDS ***
Dealt to matiko09 [7s 4c]
Ilov3NBA: folds 
Spid1: folds 
OneTwo81: folds 
splicanin1: folds 
1CANSEEY0U: folds 
Pacifistas: folds 
matiko09: folds 
Bailey Dew: calls $0.50
ApkawaDavit: checks 
*** FLOP *** [Js Jc Kd]
Bailey Dew: checks 
ApkawaDavit: checks 
*** TURN *** [Js Jc Kd] [7c]
Bailey Dew: checks 
ApkawaDavit: bets $1
Bailey Dew: calls $1
*** RIVER *** [Js Jc Kd 7c] [5c]
Bailey Dew: checks 
ApkawaDavit: checks 
*** SHOW DOWN ***
Bailey Dew: shows [Ah 3d] (a pair of Jacks)
ApkawaDavit: shows [6c 7h] (two pair, Jacks and Sevens)
ApkawaDavit collected $3.80 from pot
*** SUMMARY ***
Total pot $4 | Rake $0.20 
Board [Js Jc Kd 7c 5c]
Seat 1: Ilov3NBA folded before Flop (didn't bet)
Seat 2: Spid1 folded before Flop (didn't bet)
Seat 3: OneTwo81 folded before Flop (didn't bet)
Seat 4: splicanin1 folded before Flop (didn't bet)
Seat 5: 1CANSEEY0U folded before Flop (didn't bet)
Seat 6: Pacifistas folded before Flop (didn't bet)
Seat 7: matiko09 (button) folded before Flop (didn't bet)
Seat 8: Bailey Dew (small blind) showed [Ah 3d] and lost with a pair of Jacks
Seat 9: ApkawaDavit (big blind) showed [6c 7h] and won ($3.80) with two pair, Jacks and Sevens





PokerStars Hand #152662512477:  Hold'em No Limit ($0.50/$1.00 USD) - 2016/04/30 18:39:08 CET [2016/04/30 12:39:08 ET]
Table 'Raissa II' 9-max Seat #8 is the button
Seat 1: cap. marb ($44.15 in chips) 
Seat 2: azzad2007 ($113.90 in chips) 
Seat 3: iRivuLose ($102.99 in chips) 
Seat 5: korlito69 ($50.13 in chips) 
Seat 6: hurtNCYDE ($105.42 in chips) 
Seat 7: matiko09 ($101.50 in chips) 
Seat 8: Pacifistas ($110.15 in chips) 
Seat 9: WrongButton ($100 in chips) 
WrongButton: posts small blind $0.50
cap. marb: posts big blind $1
HITYESCA: sits out 
*** HOLE CARDS ***
Dealt to matiko09 [2c 7h]
azzad2007: folds 
iRivuLose: folds 
korlito69: folds 
hurtNCYDE: folds 
matiko09: folds 
Pacifistas: raises $1.50 to $2.50
WrongButton: folds 
cap. marb: raises $3.50 to $6
Pacifistas: folds 
Uncalled bet ($3.50) returned to cap. marb
cap. marb collected $5.50 from pot
cap. marb: doesn't show hand 
*** SUMMARY ***
Total pot $5.50 | Rake $0 
Seat 1: cap. marb (big blind) collected ($5.50)
Seat 2: azzad2007 folded before Flop (didn't bet)
Seat 3: iRivuLose folded before Flop (didn't bet)
Seat 5: korlito69 folded before Flop (didn't bet)
Seat 6: hurtNCYDE folded before Flop (didn't bet)
Seat 7: matiko09 folded before Flop (didn't bet)
Seat 8: Pacifistas (button) folded before Flop
Seat 9: WrongButton (small blind) folded before Flop





PokerStars Hand #152662516388:  Hold'em No Limit ($0.50/$1.00 USD) - 2016/04/30 18:39:13 CET [2016/04/30 12:39:13 ET]
Table 'Lova II' 9-max Seat #3 is the button
Seat 1: Pacifistas ($107.08 in chips) 
Seat 2: bilukm ($298.24 in chips) 
Seat 3: matiko09 ($103.37 in chips) 
Seat 4: VanDobeln ($125.45 in chips) 
Seat 5: Ilov3NBA ($162.51 in chips) 
Seat 7: Szevasztopol ($106.82 in chips) 
Seat 8: cap. marb ($57.39 in chips) 
VanDobeln: posts small blind $0.50
Ilov3NBA: posts big blind $1
HITYESCA: sits out 
*** HOLE CARDS ***
Dealt to matiko09 [8h 3c]
Szevasztopol: folds 
cap. marb: folds 
Pacifistas: folds 
bilukm: folds 
matiko09: folds 
VanDobeln: calls $0.50
Ilov3NBA: checks 
*** FLOP *** [Ks 6h Th]
VanDobeln: checks 
Ilov3NBA: checks 
*** TURN *** [Ks 6h Th] [7c]
VanDobeln: bets $1.42
IseeUcards joins the table at seat #9 
Ilov3NBA: folds 
Uncalled bet ($1.42) returned to VanDobeln
VanDobeln collected $1.90 from pot
VanDobeln: doesn't show hand 
*** SUMMARY ***
Total pot $2 | Rake $0.10 
Board [Ks 6h Th 7c]
Seat 1: Pacifistas folded before Flop (didn't bet)
Seat 2: bilukm folded before Flop (didn't bet)
Seat 3: matiko09 (button) folded before Flop (didn't bet)
Seat 4: VanDobeln (small blind) collected ($1.90)
Seat 5: Ilov3NBA (big blind) folded on the Turn
Seat 7: Szevasztopol folded before Flop (didn't bet)
Seat 8: cap. marb folded before Flop (didn't bet)





PokerStars Hand #152662516133:  Hold'em No Limit ($0.50/$1.00 USD) - 2016/04/30 18:39:13 CET [2016/04/30 12:39:13 ET]
Table 'Selinur II' 9-max Seat #7 is the button
Seat 1: bigacsiga ($145 in chips) 
Seat 2: matiko09 ($100 in chips) 
Seat 3: HITYESCA ($100 in chips) 
Seat 7: azqanaz ($41.70 in chips) 
Seat 8: Pacifistas ($100 in chips) 
Seat 9: Spid1 ($101.50 in chips) 
Pacifistas: posts small blind $0.50
Spid1: posts big blind $1
cap. marb: sits out 
Daniel Daffe: sits out 
*** HOLE CARDS ***
Dealt to matiko09 [Tc Ts]
bigacsiga: folds 
matiko09: raises $2 to $3
HITYESCA: folds 
azqanaz: folds 
Pacifistas: calls $2.50
Spid1: folds 
*** FLOP *** [Jh 2h 5d]
Pacifistas: checks 
matiko09: checks 
*** TURN *** [Jh 2h 5d] [Qh]
Pacifistas: bets $4.52
matiko09: folds 
Uncalled bet ($4.52) returned to Pacifistas
Pacifistas collected $6.65 from pot
Pacifistas: doesn't show hand 
*** SUMMARY ***
Total pot $7 | Rake $0.35 
Board [Jh 2h 5d Qh]
Seat 1: bigacsiga folded before Flop (didn't bet)
Seat 2: matiko09 folded on the Turn
Seat 3: HITYESCA folded before Flop (didn't bet)
Seat 7: azqanaz (button) folded before Flop (didn't bet)
Seat 8: Pacifistas (small blind) collected ($6.65)
Seat 9: Spid1 (big blind) folded before Flop





PokerStars Hand #152662517803:  Hold'em No Limit ($0.50/$1.00 USD) - 2016/04/30 18:39:15 CET [2016/04/30 12:39:15 ET]
Table 'Tamariwa' 9-max Seat #9 is the button
Seat 1: HITYESCA ($100.50 in chips) 
Seat 2: ryanshades ($84.35 in chips) 
Seat 3: matiko09 ($101.50 in chips) 
Seat 4: cap. marb ($125.78 in chips) 
Seat 5: bigacsiga ($100 in chips) 
Seat 7: Pacifistas ($107.87 in chips) 
Seat 8: JWU418 ($70.91 in chips) 
Seat 9: ApkawaDavit ($238.20 in chips) 
HITYESCA: posts small blind $0.50
ryanshades: posts big blind $1
*** HOLE CARDS ***
Dealt to matiko09 [4h 7s]
Fivez joins the table at seat #6 
matiko09: folds 
cap. marb: folds 
bigacsiga: folds 
Pacifistas: raises $2 to $3
JWU418: folds 
ApkawaDavit: folds 
HITYESCA: folds 
ryanshades: folds 
Uncalled bet ($2) returned to Pacifistas
Pacifistas collected $2.50 from pot
Pacifistas: doesn't show hand 
*** SUMMARY ***
Total pot $2.50 | Rake $0 
Seat 1: HITYESCA (small blind) folded before Flop
Seat 2: ryanshades (big blind) folded before Flop
Seat 3: matiko09 folded before Flop (didn't bet)
Seat 4: cap. marb folded before Flop (didn't bet)
Seat 5: bigacsiga folded before Flop (didn't bet)
Seat 7: Pacifistas collected ($2.50)
Seat 8: JWU418 folded before Flop (didn't bet)
Seat 9: ApkawaDavit (button) folded before Flop (didn't bet)





PokerStars Hand #152662534444:  Hold'em No Limit ($0.50/$1.00 USD) - 2016/04/30 18:39:37 CET [2016/04/30 12:39:37 ET]
Table 'Hippasos' 9-max Seat #2 is the button
Seat 1: MRC63S ($66 in chips) 
Seat 2: matiko09 ($100 in chips) 
Seat 3: WrongButton ($100 in chips) 
Seat 5: boutabi ($114.93 in chips) 
Seat 6: JACQUILF ($100 in chips) 
Seat 7: ilaviiitech ($100 in chips) 
Seat 8: Spid1 ($100 in chips) 
Seat 9: ApkawaDavit ($104.62 in chips) 
WrongButton: posts small blind $0.50
boutabi: posts big blind $1
*** HOLE CARDS ***
Dealt to matiko09 [4h 8c]
JACQUILF: folds 
ilaviiitech: folds 
Spid1: folds 
ApkawaDavit: folds 
MRC63S: folds 
matiko09: folds 
WrongButton: calls $0.50
boutabi: checks 
*** FLOP *** [Js 2d 6d]
WrongButton: bets $1.02
boutabi: calls $1.02
*** TURN *** [Js 2d 6d] [Qd]
WrongButton: checks 
boutabi: checks 
*** RIVER *** [Js 2d 6d Qd] [Tc]
WrongButton: bets $1.30
boutabi: calls $1.30
*** SHOW DOWN ***
WrongButton: shows [Jd 7s] (a pair of Jacks)
boutabi: mucks hand 
WrongButton collected $6.31 from pot
*** SUMMARY ***
Total pot $6.64 | Rake $0.33 
Board [Js 2d 6d Qd Tc]
Seat 1: MRC63S folded before Flop (didn't bet)
Seat 2: matiko09 (button) folded before Flop (didn't bet)
Seat 3: WrongButton (small blind) showed [Jd 7s] and won ($6.31) with a pair of Jacks
Seat 5: boutabi (big blind) mucked [6s 9c]
Seat 6: JACQUILF folded before Flop (didn't bet)
Seat 7: ilaviiitech folded before Flop (didn't bet)
Seat 8: Spid1 folded before Flop (didn't bet)
Seat 9: ApkawaDavit folded before Flop (didn't bet)





PokerStars Hand #152662537155:  Hold'em No Limit ($0.50/$1.00 USD) - 2016/04/30 18:39:40 CET [2016/04/30 12:39:40 ET]
Table 'Kalliope II' 9-max Seat #7 is the button
Seat 1: cap. marb ($37.61 in chips) 
Seat 3: matiko09 ($100 in chips) 
Seat 4: Ilov3NBA ($123.42 in chips) 
Seat 5: SIMONE280201 ($60.13 in chips) 
Seat 6: hurtNCYDE ($106.46 in chips) 
Seat 7: ApkawaDavit ($158.35 in chips) 
Seat 8: RoadtoNepal ($101.22 in chips) 
Seat 9: scaihaze ($116.64 in chips) 
RoadtoNepal: posts small blind $0.50
scaihaze: posts big blind $1
bigacsiga: sits out 
*** HOLE CARDS ***
Dealt to matiko09 [6c Th]
cap. marb: folds 
matiko09: folds 
Ilov3NBA: folds 
SIMONE280201 has timed out
SIMONE280201: folds 
hurtNCYDE: folds 
ApkawaDavit: raises $1 to $2
RoadtoNepal: folds 
scaihaze: calls $1
*** FLOP *** [Ah 3h 6h]
scaihaze: bets $2
ApkawaDavit: raises $5 to $7
scaihaze: folds 
Uncalled bet ($5) returned to ApkawaDavit
ApkawaDavit collected $8.08 from pot
ApkawaDavit: doesn't show hand 
*** SUMMARY ***
Total pot $8.50 | Rake $0.42 
Board [Ah 3h 6h]
Seat 1: cap. marb folded before Flop (didn't bet)
Seat 3: matiko09 folded before Flop (didn't bet)
Seat 4: Ilov3NBA folded before Flop (didn't bet)
Seat 5: SIMONE280201 folded before Flop (didn't bet)
Seat 6: hurtNCYDE folded before Flop (didn't bet)
Seat 7: ApkawaDavit (button) collected ($8.08)
Seat 8: RoadtoNepal (small blind) folded before Flop
Seat 9: scaihaze (big blind) folded on the Flop





PokerStars Hand #152662537217:  Hold'em No Limit ($0.50/$1.00 USD) - 2016/04/30 18:39:40 CET [2016/04/30 12:39:40 ET]
Table 'Dagmar' 9-max Seat #9 is the button
Seat 1: matiko09 ($197.50 in chips) 
Seat 2: Spid1 ($184.90 in chips) 
Seat 3: ApkawaDavit ($116.20 in chips) 
Seat 5: cap. marb ($47.02 in chips) 
Seat 6: arctur17 ($105.03 in chips) 
Seat 7: kswmh ($77.98 in chips) 
Seat 8: Ilov3NBA ($144.48 in chips) 
Seat 9: okkernoot111 ($44.35 in chips) 
matiko09: posts small blind $0.50
Spid1: posts big blind $1
RoadtoNepal: sits out 
*** HOLE CARDS ***
Dealt to matiko09 [8h 4h]
ApkawaDavit: folds 
cap. marb: folds 
arctur17: folds 
kswmh: folds 
Ilov3NBA: folds 
okkernoot111: folds 
matiko09: folds 
Uncalled bet ($0.50) returned to Spid1
Spid1 collected $1 from pot
Spid1: doesn't show hand 
*** SUMMARY ***
Total pot $1 | Rake $0 
Seat 1: matiko09 (small blind) folded before Flop
Seat 2: Spid1 (big blind) collected ($1)
Seat 3: ApkawaDavit folded before Flop (didn't bet)
Seat 5: cap. marb folded before Flop (didn't bet)
Seat 6: arctur17 folded before Flop (didn't bet)
Seat 7: kswmh folded before Flop (didn't bet)
Seat 8: Ilov3NBA folded before Flop (didn't bet)
Seat 9: okkernoot111 (button) folded before Flop (didn't bet)





PokerStars Hand #152662539831:  Hold'em No Limit ($0.50/$1.00 USD) - 2016/04/30 18:39:44 CET [2016/04/30 12:39:44 ET]
Table 'Raissa II' 9-max Seat #9 is the button
Seat 1: cap. marb ($47.15 in chips) 
Seat 2: azzad2007 ($113.90 in chips) 
Seat 3: iRivuLose ($102.99 in chips) 
Seat 5: korlito69 ($50.13 in chips) 
Seat 6: hurtNCYDE ($105.42 in chips) 
Seat 7: matiko09 ($101.50 in chips) 
Seat 8: Pacifistas ($107.65 in chips) 
Seat 9: WrongButton ($100 in chips) 
cap. marb: posts small blind $0.50
azzad2007: posts big blind $1
HITYESCA: sits out 
*** HOLE CARDS ***
Dealt to matiko09 [Th Ts]
iRivuLose: folds 
korlito69: folds 
hurtNCYDE: raises $1.50 to $2.50
matiko09: calls $2.50
Pacifistas: folds 
WrongButton: folds 
cap. marb: folds 
azzad2007: folds 
*** FLOP *** [Ks 2s 4h]
hurtNCYDE: checks 
matiko09: checks 
*** TURN *** [Ks 2s 4h] [6h]
hurtNCYDE: checks 
matiko09: bets $3.21
hurtNCYDE: calls $3.21
*** RIVER *** [Ks 2s 4h 6h] [As]
hurtNCYDE: checks 
matiko09: checks 
*** SHOW DOWN ***
hurtNCYDE: shows [Js Jc] (a pair of Jacks)
matiko09: mucks hand 
hurtNCYDE collected $12.27 from pot
*** SUMMARY ***
Total pot $12.92 | Rake $0.65 
Board [Ks 2s 4h 6h As]
Seat 1: cap. marb (small blind) folded before Flop
Seat 2: azzad2007 (big blind) folded before Flop
Seat 3: iRivuLose folded before Flop (didn't bet)
Seat 5: korlito69 folded before Flop (didn't bet)
Seat 6: hurtNCYDE showed [Js Jc] and won ($12.27) with a pair of Jacks
Seat 7: matiko09 mucked [Th Ts]
Seat 8: Pacifistas folded before Flop (didn't bet)
Seat 9: WrongButton (button) folded before Flop (didn't bet)





PokerStars Hand #152662547739:  Hold'em No Limit ($0.50/$1.00 USD) - 2016/04/30 18:39:54 CET [2016/04/30 12:39:54 ET]
Table 'Selinur II' 9-max Seat #8 is the button
Seat 1: bigacsiga ($145 in chips) 
Seat 2: matiko09 ($100 in chips) 
Seat 3: HITYESCA ($100 in chips) 
Seat 6: Daniel Daffe ($60 in chips) 
Seat 7: azqanaz ($41.70 in chips) 
Seat 8: Pacifistas ($103.65 in chips) 
Seat 9: Spid1 ($100.50 in chips) 
Spid1: posts small blind $0.50
bigacsiga: posts big blind $1
cap. marb: sits out 
Daniel Daffe: posts big blind $1
*** HOLE CARDS ***
Dealt to matiko09 [9h 6s]
matiko09: folds 
HITYESCA: folds 
Daniel Daffe: checks 
azqanaz: raises $3.50 to $4.50
Pacifistas: folds 
Spid1: folds 
bigacsiga: folds 
Daniel Daffe: folds 
Uncalled bet ($3.50) returned to azqanaz
azqanaz collected $3.50 from pot
*** SUMMARY ***
Total pot $3.50 | Rake $0 
Seat 1: bigacsiga (big blind) folded before Flop
Seat 2: matiko09 folded before Flop (didn't bet)
Seat 3: HITYESCA folded before Flop (didn't bet)
Seat 6: Daniel Daffe folded before Flop
Seat 7: azqanaz collected ($3.50)
Seat 8: Pacifistas (button) folded before Flop (didn't bet)
Seat 9: Spid1 (small blind) folded before Flop





PokerStars Hand #152662553360:  Hold'em No Limit ($0.50/$1.00 USD) - 2016/04/30 18:40:01 CET [2016/04/30 12:40:01 ET]
Table 'Ruvuma' 9-max Seat #8 is the button
Seat 1: Ilov3NBA ($106.38 in chips) 
Seat 2: Spid1 ($100.25 in chips) 
Seat 3: OneTwo81 ($98.22 in chips) 
Seat 4: splicanin1 ($102.43 in chips) 
Seat 5: 1CANSEEY0U ($41.23 in chips) 
Seat 6: Pacifistas ($111.20 in chips) 
Seat 7: matiko09 ($100 in chips) 
Seat 8: Bailey Dew ($120.98 in chips) 
Seat 9: ApkawaDavit ($133.08 in chips) 
ApkawaDavit: posts small blind $0.50
Ilov3NBA: posts big blind $1
*** HOLE CARDS ***
Dealt to matiko09 [Td Tc]
Spid1: folds 
OneTwo81: calls $1
splicanin1: folds 
1CANSEEY0U: folds 
Pacifistas: folds 
matiko09: raises $3 to $4
Bailey Dew: raises $8.50 to $12.50
ApkawaDavit: folds 
Ilov3NBA: folds 
OneTwo81: folds 
matiko09: calls $8.50
*** FLOP *** [Qd Jh 4c]
matiko09: checks 
Bailey Dew: checks 
*** TURN *** [Qd Jh 4c] [3h]
matiko09: checks 
Bailey Dew: checks 
*** RIVER *** [Qd Jh 4c 3h] [7s]
matiko09: checks 
Bailey Dew: bets $13.58
matiko09: folds 
Uncalled bet ($13.58) returned to Bailey Dew
Bailey Dew collected $26.12 from pot
Bailey Dew: doesn't show hand 
*** SUMMARY ***
Total pot $27.50 | Rake $1.38 
Board [Qd Jh 4c 3h 7s]
Seat 1: Ilov3NBA (big blind) folded before Flop
Seat 2: Spid1 folded before Flop (didn't bet)
Seat 3: OneTwo81 folded before Flop
Seat 4: splicanin1 folded before Flop (didn't bet)
Seat 5: 1CANSEEY0U folded before Flop (didn't bet)
Seat 6: Pacifistas folded before Flop (didn't bet)
Seat 7: matiko09 folded on the River
Seat 8: Bailey Dew (button) collected ($26.12)
Seat 9: ApkawaDavit (small blind) folded before Flop





PokerStars Hand #152662559169:  Hold'em No Limit ($0.50/$1.00 USD) - 2016/04/30 18:40:09 CET [2016/04/30 12:40:09 ET]
Table 'Dagmar' 9-max Seat #1 is the button
Seat 1: matiko09 ($197 in chips) 
Seat 2: Spid1 ($185.40 in chips) 
Seat 3: ApkawaDavit ($116.20 in chips) 
Seat 5: cap. marb ($47.02 in chips) 
Seat 6: arctur17 ($105.03 in chips) 
Seat 7: kswmh ($77.98 in chips) 
Seat 8: Ilov3NBA ($144.48 in chips) 
Seat 9: okkernoot111 ($44.35 in chips) 
Spid1: posts small blind $0.50
ApkawaDavit: posts big blind $1
RoadtoNepal: sits out 
*** HOLE CARDS ***
Dealt to matiko09 [4s Kc]
cap. marb: folds 
arctur17: folds 
kswmh: folds 
Ilov3NBA: folds 
okkernoot111: raises $2 to $3
matiko09: folds 
Spid1: folds 
ApkawaDavit: folds 
Uncalled bet ($2) returned to okkernoot111
okkernoot111 collected $2.50 from pot
*** SUMMARY ***
Total pot $2.50 | Rake $0 
Seat 1: matiko09 (button) folded before Flop (didn't bet)
Seat 2: Spid1 (small blind) folded before Flop
Seat 3: ApkawaDavit (big blind) folded before Flop
Seat 5: cap. marb folded before Flop (didn't bet)
Seat 6: arctur17 folded before Flop (didn't bet)
Seat 7: kswmh folded before Flop (didn't bet)
Seat 8: Ilov3NBA folded before Flop (didn't bet)
Seat 9: okkernoot111 collected ($2.50)





PokerStars Hand #152662561763:  Hold'em No Limit ($0.50/$1.00 USD) - 2016/04/30 18:40:12 CET [2016/04/30 12:40:12 ET]
Table 'Lova II' 9-max Seat #4 is the button
Seat 1: Pacifistas ($107.08 in chips) 
Seat 2: bilukm ($298.24 in chips) 
Seat 3: matiko09 ($103.37 in chips) 
Seat 4: VanDobeln ($126.35 in chips) 
Seat 5: Ilov3NBA ($161.51 in chips) 
Seat 6: HITYESCA ($100 in chips) 
Seat 7: Szevasztopol ($106.82 in chips) 
Seat 8: cap. marb ($57.39 in chips) 
Ilov3NBA: posts small blind $0.50
HITYESCA: posts big blind $1
IseeUcards: sits out 
*** HOLE CARDS ***
Dealt to matiko09 [Ks 7s]
Szevasztopol: folds 
cap. marb: folds 
Pacifistas: raises $2 to $3
bilukm: folds 
matiko09: folds 
VanDobeln: folds 
Ilov3NBA: folds 
HITYESCA: raises $7 to $10
Pacifistas: folds 
Uncalled bet ($7) returned to HITYESCA
HITYESCA collected $6.50 from pot
HITYESCA: doesn't show hand 
*** SUMMARY ***
Total pot $6.50 | Rake $0 
Seat 1: Pacifistas folded before Flop
Seat 2: bilukm folded before Flop (didn't bet)
Seat 3: matiko09 folded before Flop (didn't bet)
Seat 4: VanDobeln (button) folded before Flop (didn't bet)
Seat 5: Ilov3NBA (small blind) folded before Flop
Seat 6: HITYESCA (big blind) collected ($6.50)
Seat 7: Szevasztopol folded before Flop (didn't bet)
Seat 8: cap. marb folded before Flop (didn't bet)





PokerStars Hand #152662566938:  Hold'em No Limit ($0.50/$1.00 USD) - 2016/04/30 18:40:19 CET [2016/04/30 12:40:19 ET]
Table 'Hippasos' 9-max Seat #3 is the button
Seat 1: MRC63S ($66 in chips) 
Seat 2: matiko09 ($100 in chips) 
Seat 3: WrongButton ($102.99 in chips) 
Seat 5: boutabi ($111.61 in chips) 
Seat 6: JACQUILF ($100 in chips) 
Seat 7: ilaviiitech ($100 in chips) 
Seat 8: Spid1 ($100 in chips) 
Seat 9: ApkawaDavit ($104.62 in chips) 
boutabi: posts small blind $0.50
JACQUILF: posts big blind $1
*** HOLE CARDS ***
Dealt to matiko09 [Th 3s]
ilaviiitech: folds 
Spid1: folds 
ApkawaDavit: raises $2 to $3
MRC63S: calls $3
matiko09: folds 
WrongButton: folds 
boutabi: calls $2.50
JACQUILF: folds 
*** FLOP *** [8c 5h 9h]
boutabi: bets $7
ApkawaDavit: folds 
MRC63S: folds 
Uncalled bet ($7) returned to boutabi
boutabi collected $9.50 from pot
boutabi: doesn't show hand 
*** SUMMARY ***
Total pot $10 | Rake $0.50 
Board [8c 5h 9h]
Seat 1: MRC63S folded on the Flop
Seat 2: matiko09 folded before Flop (didn't bet)
Seat 3: WrongButton (button) folded before Flop (didn't bet)
Seat 5: boutabi (small blind) collected ($9.50)
Seat 6: JACQUILF (big blind) folded before Flop
Seat 7: ilaviiitech folded before Flop (didn't bet)
Seat 8: Spid1 folded before Flop (didn't bet)
Seat 9: ApkawaDavit folded on the Flop





PokerStars Hand #152662572334:  Hold'em No Limit ($0.50/$1.00 USD) - 2016/04/30 18:40:25 CET [2016/04/30 12:40:25 ET]
Table 'Selinur II' 9-max Seat #9 is the button
Seat 1: bigacsiga ($144 in chips) 
Seat 2: matiko09 ($100 in chips) 
Seat 3: HITYESCA ($100 in chips) 
Seat 6: Daniel Daffe ($59 in chips) 
Seat 7: azqanaz ($44.20 in chips) 
Seat 8: Pacifistas ($103.65 in chips) 
Seat 9: Spid1 ($100 in chips) 
bigacsiga: posts small blind $0.50
matiko09: posts big blind $1
cap. marb: sits out 
*** HOLE CARDS ***
Dealt to matiko09 [Qs 8d]
HITYESCA: folds 
qwertzuiopüß joins the table at seat #5 
Daniel Daffe: folds 
azqanaz: raises $2 to $3
Pacifistas: folds 
Spid1: folds 
bigacsiga: folds 
matiko09: folds 
Uncalled bet ($2) returned to azqanaz
azqanaz collected $2.50 from pot
*** SUMMARY ***
Total pot $2.50 | Rake $0 
Seat 1: bigacsiga (small blind) folded before Flop
Seat 2: matiko09 (big blind) folded before Flop
Seat 3: HITYESCA folded before Flop (didn't bet)
Seat 6: Daniel Daffe folded before Flop (didn't bet)
Seat 7: azqanaz collected ($2.50)
Seat 8: Pacifistas folded before Flop (didn't bet)
Seat 9: Spid1 (button) folded before Flop (didn't bet)





PokerStars Hand #152662575357:  Hold'em No Limit ($0.50/$1.00 USD) - 2016/04/30 18:40:29 CET [2016/04/30 12:40:29 ET]
Table 'Raissa II' 9-max Seat #1 is the button
Seat 1: cap. marb ($46.65 in chips) 
Seat 2: azzad2007 ($112.90 in chips) 
Seat 3: iRivuLose ($102.99 in chips) 
Seat 5: korlito69 ($50.13 in chips) 
Seat 6: hurtNCYDE ($111.98 in chips) 
Seat 7: matiko09 ($100 in chips) 
Seat 8: Pacifistas ($107.65 in chips) 
Seat 9: WrongButton ($100 in chips) 
azzad2007: posts small blind $0.50
iRivuLose: posts big blind $1
HITYESCA: sits out 
*** HOLE CARDS ***
Dealt to matiko09 [Qh Tc]
korlito69: folds 
hurtNCYDE: folds 
matiko09: folds 
Pacifistas: folds 
WrongButton: folds 
cap. marb: raises $1.12 to $2.12
azzad2007: calls $1.62
iRivuLose: calls $1.12
*** FLOP *** [5h 2d 5d]
azzad2007: checks 
iRivuLose: checks 
cap. marb: bets $3.98
azzad2007: folds 
iRivuLose: folds 
Uncalled bet ($3.98) returned to cap. marb
cap. marb collected $6.04 from pot
cap. marb: doesn't show hand 
*** SUMMARY ***
Total pot $6.36 | Rake $0.32 
Board [5h 2d 5d]
Seat 1: cap. marb (button) collected ($6.04)
Seat 2: azzad2007 (small blind) folded on the Flop
Seat 3: iRivuLose (big blind) folded on the Flop
Seat 5: korlito69 folded before Flop (didn't bet)
Seat 6: hurtNCYDE folded before Flop (didn't bet)
Seat 7: matiko09 folded before Flop (didn't bet)
Seat 8: Pacifistas folded before Flop (didn't bet)
Seat 9: WrongButton folded before Flop (didn't bet)





PokerStars Hand #152662579607:  Hold'em No Limit ($0.50/$1.00 USD) - 2016/04/30 18:40:35 CET [2016/04/30 12:40:35 ET]
Table 'Dagmar' 9-max Seat #2 is the button
Seat 1: matiko09 ($197 in chips) 
Seat 2: Spid1 ($184.90 in chips) 
Seat 3: ApkawaDavit ($115.20 in chips) 
Seat 4: RoadtoNepal ($100 in chips) 
Seat 5: cap. marb ($47.02 in chips) 
Seat 6: arctur17 ($105.03 in chips) 
Seat 7: kswmh ($77.98 in chips) 
Seat 8: Ilov3NBA ($144.48 in chips) 
Seat 9: okkernoot111 ($85.85 in chips) 
ApkawaDavit: posts small blind $0.50
RoadtoNepal: posts big blind $1
*** HOLE CARDS ***
Dealt to matiko09 [7h Jd]
cap. marb: folds 
arctur17: folds 
kswmh: folds 
Ilov3NBA: folds 
okkernoot111: folds 
matiko09: folds 
Spid1: raises $1.50 to $2.50
ApkawaDavit: folds 
RoadtoNepal: calls $1.50
*** FLOP *** [3c Kc Js]
RoadtoNepal: checks 
Spid1: checks 
*** TURN *** [3c Kc Js] [Kh]
RoadtoNepal: checks 
Spid1: bets $3.50
RoadtoNepal: calls $3.50
*** RIVER *** [3c Kc Js Kh] [5h]
RoadtoNepal: checks 
Spid1: bets $9
RoadtoNepal: folds 
Uncalled bet ($9) returned to Spid1
Spid1 collected $11.88 from pot
Spid1: doesn't show hand 
*** SUMMARY ***
Total pot $12.50 | Rake $0.62 
Board [3c Kc Js Kh 5h]
Seat 1: matiko09 folded before Flop (didn't bet)
Seat 2: Spid1 (button) collected ($11.88)
Seat 3: ApkawaDavit (small blind) folded before Flop
Seat 4: RoadtoNepal (big blind) folded on the River
Seat 5: cap. marb folded before Flop (didn't bet)
Seat 6: arctur17 folded before Flop (didn't bet)
Seat 7: kswmh folded before Flop (didn't bet)
Seat 8: Ilov3NBA folded before Flop (didn't bet)
Seat 9: okkernoot111 folded before Flop (didn't bet)





PokerStars Hand #152662596560:  Hold'em No Limit ($0.50/$1.00 USD) - 2016/04/30 18:40:57 CET [2016/04/30 12:40:57 ET]
Table 'Selinur II' 9-max Seat #1 is the button
Seat 1: bigacsiga ($143.50 in chips) 
Seat 2: matiko09 ($100 in chips) 
Seat 3: HITYESCA ($100 in chips) 
Seat 6: Daniel Daffe ($59 in chips) 
Seat 7: azqanaz ($45.70 in chips) 
Seat 8: Pacifistas ($103.65 in chips) 
Seat 9: Spid1 ($100 in chips) 
matiko09: posts small blind $0.50
HITYESCA: posts big blind $1
cap. marb: sits out 
qwertzuiopüß: sits out 
*** HOLE CARDS ***
Dealt to matiko09 [6c 3h]
Daniel Daffe: calls $1
azqanaz: calls $1
Pacifistas: folds 
Spid1: folds 
bigacsiga: folds 
matiko09: folds 
HITYESCA: checks 
*** FLOP *** [5c Qs Js]
HITYESCA: checks 
Daniel Daffe: bets $3.32
azqanaz: folds 
HITYESCA: folds 
Uncalled bet ($3.32) returned to Daniel Daffe
Daniel Daffe collected $3.32 from pot
Daniel Daffe: doesn't show hand 
*** SUMMARY ***
Total pot $3.50 | Rake $0.18 
Board [5c Qs Js]
Seat 1: bigacsiga (button) folded before Flop (didn't bet)
Seat 2: matiko09 (small blind) folded before Flop
Seat 3: HITYESCA (big blind) folded on the Flop
Seat 6: Daniel Daffe collected ($3.32)
Seat 7: azqanaz folded on the Flop
Seat 8: Pacifistas folded before Flop (didn't bet)
Seat 9: Spid1 folded before Flop (didn't bet)





PokerStars Hand #152662597000:  Hold'em No Limit ($0.50/$1.00 USD) - 2016/04/30 18:40:57 CET [2016/04/30 12:40:57 ET]
Table 'Hippasos' 9-max Seat #5 is the button
Seat 1: MRC63S ($63 in chips) 
Seat 2: matiko09 ($100 in chips) 
Seat 3: WrongButton ($102.99 in chips) 
Seat 5: boutabi ($118.11 in chips) 
Seat 6: JACQUILF ($100 in chips) 
Seat 7: ilaviiitech ($100 in chips) 
Seat 8: Spid1 ($100 in chips) 
Seat 9: ApkawaDavit ($101.62 in chips) 
JACQUILF: posts small blind $0.50
ilaviiitech: posts big blind $1
*** HOLE CARDS ***
Dealt to matiko09 [Jh 4h]
Spid1: raises $2 to $3
ApkawaDavit: folds 
MRC63S: calls $3
matiko09: folds 
WrongButton: folds 
boutabi: calls $3
JACQUILF: calls $2.50
ilaviiitech: folds 
*** FLOP *** [9s 9h Qc]
JACQUILF: checks 
Spid1: checks 
MRC63S: checks 
boutabi: checks 
*** TURN *** [9s 9h Qc] [5c]
JACQUILF: bets $6.99
Spid1: folds 
MRC63S: folds 
boutabi: calls $6.99
*** RIVER *** [9s 9h Qc 5c] [Qd]
JACQUILF: checks 
boutabi: bets $26
JACQUILF: folds 
Uncalled bet ($26) returned to boutabi
boutabi collected $25.63 from pot
boutabi: doesn't show hand 
*** SUMMARY ***
Total pot $26.98 | Rake $1.35 
Board [9s 9h Qc 5c Qd]
Seat 1: MRC63S folded on the Turn
Seat 2: matiko09 folded before Flop (didn't bet)
Seat 3: WrongButton folded before Flop (didn't bet)
Seat 5: boutabi (button) collected ($25.63)
Seat 6: JACQUILF (small blind) folded on the River
Seat 7: ilaviiitech (big blind) folded before Flop
Seat 8: Spid1 folded on the Turn
Seat 9: ApkawaDavit folded before Flop (didn't bet)





PokerStars Hand #152662613303:  Hold'em No Limit ($0.50/$1.00 USD) - 2016/04/30 18:41:18 CET [2016/04/30 12:41:18 ET]
Table 'Ruvuma' 9-max Seat #9 is the button
Seat 1: Ilov3NBA ($105.38 in chips) 
Seat 2: Spid1 ($100.25 in chips) 
Seat 3: OneTwo81 ($97.22 in chips) 
Seat 4: splicanin1 ($102.43 in chips) 
Seat 5: 1CANSEEY0U ($41.23 in chips) 
Seat 6: Pacifistas ($111.20 in chips) 
Seat 7: matiko09 ($100 in chips) 
Seat 8: Bailey Dew ($134.60 in chips) 
Seat 9: ApkawaDavit ($132.58 in chips) 
Ilov3NBA: posts small blind $0.50
Spid1: posts big blind $1
*** HOLE CARDS ***
Dealt to matiko09 [7d 4c]
OneTwo81: folds 
splicanin1: calls $1
1CANSEEY0U: folds 
Pacifistas: raises $3 to $4
matiko09: folds 
Bailey Dew: raises $8.50 to $12.50
ApkawaDavit: folds 
Ilov3NBA: folds 
Spid1: folds 
splicanin1: folds 
Pacifistas: folds 
Uncalled bet ($8.50) returned to Bailey Dew
Bailey Dew collected $10.50 from pot
Bailey Dew: doesn't show hand 
*** SUMMARY ***
Total pot $10.50 | Rake $0 
Seat 1: Ilov3NBA (small blind) folded before Flop
Seat 2: Spid1 (big blind) folded before Flop
Seat 3: OneTwo81 folded before Flop (didn't bet)
Seat 4: splicanin1 folded before Flop
Seat 5: 1CANSEEY0U folded before Flop (didn't bet)
Seat 6: Pacifistas folded before Flop
Seat 7: matiko09 folded before Flop (didn't bet)
Seat 8: Bailey Dew collected ($10.50)
Seat 9: ApkawaDavit (button) folded before Flop (didn't bet)





PokerStars Hand #152662616140:  Hold'em No Limit ($0.50/$1.00 USD) - 2016/04/30 18:41:22 CET [2016/04/30 12:41:22 ET]
Table 'Kalliope II' 9-max Seat #8 is the button
Seat 1: cap. marb ($37.61 in chips) 
Seat 3: matiko09 ($100 in chips) 
Seat 4: Ilov3NBA ($123.42 in chips) 
Seat 5: SIMONE280201 ($60.13 in chips) 
Seat 6: hurtNCYDE ($106.46 in chips) 
Seat 7: ApkawaDavit ($162.43 in chips) 
Seat 8: RoadtoNepal ($100.72 in chips) 
Seat 9: scaihaze ($112.64 in chips) 
scaihaze: posts small blind $0.50
cap. marb: posts big blind $1
bigacsiga: sits out 
*** HOLE CARDS ***
Dealt to matiko09 [3d Ts]
matiko09: folds 
Ilov3NBA: raises $2 to $3
SIMONE280201: calls $3
hurtNCYDE: folds 
ApkawaDavit: calls $3
RoadtoNepal: calls $3
scaihaze: folds 
cap. marb: folds 
*** FLOP *** [Ks Js 2d]
Ilov3NBA: checks 
SIMONE280201: checks 
ApkawaDavit: checks 
RoadtoNepal: bets $8.54
Ilov3NBA: folds 
SIMONE280201: calls $8.54
ApkawaDavit: folds 
*** TURN *** [Ks Js 2d] [4d]
SIMONE280201: checks 
RoadtoNepal: checks 
*** RIVER *** [Ks Js 2d 4d] [Ah]
SIMONE280201: checks 
RoadtoNepal: bets $19.50
SIMONE280201: folds 
Uncalled bet ($19.50) returned to RoadtoNepal
RoadtoNepal collected $29.05 from pot
RoadtoNepal: doesn't show hand 
*** SUMMARY ***
Total pot $30.58 | Rake $1.53 
Board [Ks Js 2d 4d Ah]
Seat 1: cap. marb (big blind) folded before Flop
Seat 3: matiko09 folded before Flop (didn't bet)
Seat 4: Ilov3NBA folded on the Flop
Seat 5: SIMONE280201 folded on the River
Seat 6: hurtNCYDE folded before Flop (didn't bet)
Seat 7: ApkawaDavit folded on the Flop
Seat 8: RoadtoNepal (button) collected ($29.05)
Seat 9: scaihaze (small blind) folded before Flop





PokerStars Hand #152662622302:  Hold'em No Limit ($0.50/$1.00 USD) - 2016/04/30 18:41:29 CET [2016/04/30 12:41:29 ET]
Table 'Lova II' 9-max Seat #5 is the button
Seat 1: Pacifistas ($104.08 in chips) 
Seat 2: bilukm ($298.24 in chips) 
Seat 3: matiko09 ($103.37 in chips) 
Seat 4: VanDobeln ($126.35 in chips) 
Seat 5: Ilov3NBA ($161.01 in chips) 
Seat 6: HITYESCA ($103.50 in chips) 
Seat 7: Szevasztopol ($106.82 in chips) 
Seat 8: cap. marb ($57.39 in chips) 
HITYESCA: posts small blind $0.50
Szevasztopol: posts big blind $1
*** HOLE CARDS ***
Dealt to matiko09 [Ah 4s]
cap. marb: folds 
Pacifistas: folds 
bilukm: calls $1
matiko09: folds 
VanDobeln: folds 
Ilov3NBA: folds 
HITYESCA: folds 
Szevasztopol: checks 
*** FLOP *** [5c Kc 3c]
Szevasztopol: checks 
bilukm: bets $2.38
Szevasztopol: folds 
Uncalled bet ($2.38) returned to bilukm
bilukm collected $2.38 from pot
bilukm: doesn't show hand 
*** SUMMARY ***
Total pot $2.50 | Rake $0.12 
Board [5c Kc 3c]
Seat 1: Pacifistas folded before Flop (didn't bet)
Seat 2: bilukm collected ($2.38)
Seat 3: matiko09 folded before Flop (didn't bet)
Seat 4: VanDobeln folded before Flop (didn't bet)
Seat 5: Ilov3NBA (button) folded before Flop (didn't bet)
Seat 6: HITYESCA (small blind) folded before Flop
Seat 7: Szevasztopol (big blind) folded on the Flop
Seat 8: cap. marb folded before Flop (didn't bet)





PokerStars Hand #152662630529:  Hold'em No Limit ($0.50/$1.00 USD) - 2016/04/30 18:41:40 CET [2016/04/30 12:41:40 ET]
Table 'Selinur II' 9-max Seat #2 is the button
Seat 1: bigacsiga ($143.50 in chips) 
Seat 2: matiko09 ($100 in chips) 
Seat 3: HITYESCA ($100 in chips) 
Seat 4: cap. marb ($40 in chips) 
Seat 6: Daniel Daffe ($61.32 in chips) 
Seat 7: azqanaz ($44.70 in chips) 
Seat 8: Pacifistas ($103.65 in chips) 
Seat 9: Spid1 ($100 in chips) 
HITYESCA: posts small blind $0.50
cap. marb: posts big blind $1
qwertzuiopüß: sits out 
*** HOLE CARDS ***
Dealt to matiko09 [7s As]
Daniel Daffe: folds 
azqanaz: raises $2 to $3
Pacifistas: folds 
Spid1: folds 
bigacsiga: calls $3
matiko09: folds 
HITYESCA: folds 
cap. marb: folds 
*** FLOP *** [5c 3d Jc]
azqanaz: bets $4.41
bigacsiga: calls $4.41
*** TURN *** [5c 3d Jc] [Qh]
azqanaz: checks 
bigacsiga: bets $9
azqanaz: calls $9
*** RIVER *** [5c 3d Jc Qh] [4d]
azqanaz: bets $28.29 and is all-in
bigacsiga: calls $28.29
*** SHOW DOWN ***
azqanaz: shows [Qd Jd] (two pair, Queens and Jacks)
bigacsiga: shows [3s 3c] (three of a kind, Threes)
bigacsiga collected $88.40 from pot
*** SUMMARY ***
Total pot $90.90 | Rake $2.50 
Board [5c 3d Jc Qh 4d]
Seat 1: bigacsiga showed [3s 3c] and won ($88.40) with three of a kind, Threes
Seat 2: matiko09 (button) folded before Flop (didn't bet)
Seat 3: HITYESCA (small blind) folded before Flop
Seat 4: cap. marb (big blind) folded before Flop
Seat 6: Daniel Daffe folded before Flop (didn't bet)
Seat 7: azqanaz showed [Qd Jd] and lost with two pair, Queens and Jacks
Seat 8: Pacifistas folded before Flop (didn't bet)
Seat 9: Spid1 folded before Flop (didn't bet)





PokerStars Hand #152662634159:  Hold'em No Limit ($0.50/$1.00 USD) - 2016/04/30 18:41:45 CET [2016/04/30 12:41:45 ET]
Table 'Raissa II' 9-max Seat #2 is the button
Seat 1: cap. marb ($50.57 in chips) 
Seat 2: azzad2007 ($110.78 in chips) 
Seat 3: iRivuLose ($100.87 in chips) 
Seat 4: HITYESCA ($100 in chips) 
Seat 5: korlito69 ($50.13 in chips) 
Seat 6: hurtNCYDE ($111.98 in chips) 
Seat 7: matiko09 ($100 in chips) 
Seat 8: Pacifistas ($107.65 in chips) 
Seat 9: WrongButton ($100 in chips) 
iRivuLose: posts small blind $0.50
HITYESCA: posts big blind $1
*** HOLE CARDS ***
Dealt to matiko09 [8h Kc]
korlito69: folds 
hurtNCYDE: folds 
matiko09: folds 
Pacifistas: folds 
WrongButton: folds 
cap. marb: raises $1.12 to $2.12
azzad2007: folds 
iRivuLose: folds 
HITYESCA: raises $4.38 to $6.50
cap. marb: folds 
Uncalled bet ($4.38) returned to HITYESCA
HITYESCA collected $4.74 from pot
HITYESCA: doesn't show hand 
*** SUMMARY ***
Total pot $4.74 | Rake $0 
Seat 1: cap. marb folded before Flop
Seat 2: azzad2007 (button) folded before Flop (didn't bet)
Seat 3: iRivuLose (small blind) folded before Flop
Seat 4: HITYESCA (big blind) collected ($4.74)
Seat 5: korlito69 folded before Flop (didn't bet)
Seat 6: hurtNCYDE folded before Flop (didn't bet)
Seat 7: matiko09 folded before Flop (didn't bet)
Seat 8: Pacifistas folded before Flop (didn't bet)
Seat 9: WrongButton folded before Flop (didn't bet)





PokerStars Hand #152662646560:  Hold'em No Limit ($0.50/$1.00 USD) - 2016/04/30 18:42:01 CET [2016/04/30 12:42:01 ET]
Table 'Ruvuma' 9-max Seat #1 is the button
Seat 1: Ilov3NBA ($104.88 in chips) 
Seat 2: Spid1 ($100 in chips) 
Seat 3: OneTwo81 ($97.22 in chips) 
Seat 4: splicanin1 ($101.43 in chips) 
Seat 5: 1CANSEEY0U ($41.23 in chips) 
Seat 6: Pacifistas ($107.20 in chips) 
Seat 7: matiko09 ($100 in chips) 
Seat 8: Bailey Dew ($141.10 in chips) 
Seat 9: ApkawaDavit ($132.58 in chips) 
Spid1: posts small blind $0.50
OneTwo81: posts big blind $1
*** HOLE CARDS ***
Dealt to matiko09 [Qc 6c]
splicanin1: folds 
1CANSEEY0U: raises $1 to $2
Pacifistas: calls $2
matiko09: folds 
Bailey Dew: folds 
ApkawaDavit: folds 
Ilov3NBA: folds 
Spid1: folds 
OneTwo81: calls $1
*** FLOP *** [2h 5s 7h]
OneTwo81: checks 
1CANSEEY0U: checks 
Pacifistas: bets $4.40
OneTwo81: folds 
1CANSEEY0U: calls $4.40
*** TURN *** [2h 5s 7h] [Kh]
1CANSEEY0U: checks 
Pacifistas: bets $8
1CANSEEY0U: calls $8
*** RIVER *** [2h 5s 7h Kh] [6h]
1CANSEEY0U: checks 
Pacifistas: checks 
*** SHOW DOWN ***
1CANSEEY0U: shows [Kc Qh] (a flush, King high)
Pacifistas: mucks hand 
1CANSEEY0U collected $29.74 from pot
*** SUMMARY ***
Total pot $31.30 | Rake $1.56 
Board [2h 5s 7h Kh 6h]
Seat 1: Ilov3NBA (button) folded before Flop (didn't bet)
Seat 2: Spid1 (small blind) folded before Flop
Seat 3: OneTwo81 (big blind) folded on the Flop
Seat 4: splicanin1 folded before Flop (didn't bet)
Seat 5: 1CANSEEY0U showed [Kc Qh] and won ($29.74) with a flush, King high
Seat 6: Pacifistas mucked [7d 7c]
Seat 7: matiko09 folded before Flop (didn't bet)
Seat 8: Bailey Dew folded before Flop (didn't bet)
Seat 9: ApkawaDavit folded before Flop (didn't bet)





PokerStars Hand #152662657053:  Hold'em No Limit ($0.50/$1.00 USD) - 2016/04/30 18:42:14 CET [2016/04/30 12:42:14 ET]
Table 'Hippasos' 9-max Seat #6 is the button
Seat 1: MRC63S ($60 in chips) 
Seat 2: matiko09 ($100 in chips) 
Seat 3: WrongButton ($102.99 in chips) 
Seat 5: boutabi ($133.75 in chips) 
Seat 6: JACQUILF ($100 in chips) 
Seat 7: ilaviiitech ($100 in chips) 
Seat 8: Spid1 ($100 in chips) 
Seat 9: ApkawaDavit ($101.62 in chips) 
ilaviiitech: posts small blind $0.50
Spid1: posts big blind $1
*** HOLE CARDS ***
Dealt to matiko09 [Ad 8c]
ApkawaDavit: folds 
MRC63S: calls $1
matiko09: folds 
WrongButton: folds 
boutabi: calls $1
JACQUILF: folds 
ilaviiitech: folds 
Spid1: checks 
*** FLOP *** [6c Qh 3c]
Spid1: checks 
MRC63S: checks 
boutabi: checks 
*** TURN *** [6c Qh 3c] [7s]
Spid1: checks 
MRC63S: bets $1
boutabi: calls $1
Spid1: folds 
*** RIVER *** [6c Qh 3c 7s] [Qd]
MRC63S: bets $4
boutabi: raises $13 to $17
MRC63S: calls $13
*** SHOW DOWN ***
boutabi: shows [5h Kh] (a pair of Queens)
MRC63S: shows [Ah 7d] (two pair, Queens and Sevens)
MRC63S collected $37.52 from pot
*** SUMMARY ***
Total pot $39.50 | Rake $1.98 
Board [6c Qh 3c 7s Qd]
Seat 1: MRC63S showed [Ah 7d] and won ($37.52) with two pair, Queens and Sevens
Seat 2: matiko09 folded before Flop (didn't bet)
Seat 3: WrongButton folded before Flop (didn't bet)
Seat 5: boutabi showed [5h Kh] and lost with a pair of Queens
Seat 6: JACQUILF (button) folded before Flop (didn't bet)
Seat 7: ilaviiitech (small blind) folded before Flop
Seat 8: Spid1 (big blind) folded on the Turn
Seat 9: ApkawaDavit folded before Flop (didn't bet)





PokerStars Hand #152662662529:  Hold'em No Limit ($0.50/$1.00 USD) - 2016/04/30 18:42:21 CET [2016/04/30 12:42:21 ET]
Table 'Dagmar' 9-max Seat #3 is the button
Seat 1: matiko09 ($197 in chips) 
Seat 2: Spid1 ($190.78 in chips) 
Seat 3: ApkawaDavit ($114.70 in chips) 
Seat 4: RoadtoNepal ($100 in chips) 
Seat 5: cap. marb ($47.02 in chips) 
Seat 6: arctur17 ($105.03 in chips) 
Seat 7: kswmh ($77.98 in chips) 
Seat 8: Ilov3NBA ($144.48 in chips) 
Seat 9: okkernoot111 ($85.85 in chips) 
RoadtoNepal: posts small blind $0.50
cap. marb: posts big blind $1
*** HOLE CARDS ***
Dealt to matiko09 [4s 4h]
arctur17: folds 
kswmh: raises $1 to $2
Ilov3NBA: folds 
okkernoot111: folds 
matiko09: calls $2
Spid1: folds 
ApkawaDavit: folds 
RoadtoNepal: raises $10 to $12
cap. marb: folds 
kswmh: folds 
matiko09: folds 
Uncalled bet ($10) returned to RoadtoNepal
RoadtoNepal collected $7 from pot
RoadtoNepal: doesn't show hand 
*** SUMMARY ***
Total pot $7 | Rake $0 
Seat 1: matiko09 folded before Flop
Seat 2: Spid1 folded before Flop (didn't bet)
Seat 3: ApkawaDavit (button) folded before Flop (didn't bet)
Seat 4: RoadtoNepal (small blind) collected ($7)
Seat 5: cap. marb (big blind) folded before Flop
Seat 6: arctur17 folded before Flop (didn't bet)
Seat 7: kswmh folded before Flop
Seat 8: Ilov3NBA folded before Flop (didn't bet)
Seat 9: okkernoot111 folded before Flop (didn't bet)





PokerStars Hand #152662672006:  Hold'em No Limit ($0.50/$1.00 USD) - 2016/04/30 18:42:33 CET [2016/04/30 12:42:33 ET]
Table 'Raissa II' 9-max Seat #3 is the button
Seat 1: cap. marb ($48.45 in chips) 
Seat 2: azzad2007 ($110.78 in chips) 
Seat 3: iRivuLose ($100.37 in chips) 
Seat 4: HITYESCA ($102.62 in chips) 
Seat 5: korlito69 ($50.13 in chips) 
Seat 6: hurtNCYDE ($111.98 in chips) 
Seat 7: matiko09 ($100 in chips) 
Seat 8: Pacifistas ($107.65 in chips) 
Seat 9: WrongButton ($100 in chips) 
HITYESCA: posts small blind $0.50
korlito69: posts big blind $1
*** HOLE CARDS ***
Dealt to matiko09 [9s 3c]
hurtNCYDE: folds 
matiko09: folds 
Pacifistas: folds 
WrongButton: folds 
cap. marb: folds 
azzad2007: folds 
iRivuLose: folds 
HITYESCA: folds 
Uncalled bet ($0.50) returned to korlito69
korlito69 collected $1 from pot
korlito69: doesn't show hand 
*** SUMMARY ***
Total pot $1 | Rake $0 
Seat 1: cap. marb folded before Flop (didn't bet)
Seat 2: azzad2007 folded before Flop (didn't bet)
Seat 3: iRivuLose (button) folded before Flop (didn't bet)
Seat 4: HITYESCA (small blind) folded before Flop
Seat 5: korlito69 (big blind) collected ($1)
Seat 6: hurtNCYDE folded before Flop (didn't bet)
Seat 7: matiko09 folded before Flop (didn't bet)
Seat 8: Pacifistas folded before Flop (didn't bet)
Seat 9: WrongButton folded before Flop (didn't bet)





PokerStars Hand #152662678193:  Hold'em No Limit ($0.50/$1.00 USD) - 2016/04/30 18:42:41 CET [2016/04/30 12:42:41 ET]
Table 'Selinur II' 9-max Seat #3 is the button
Seat 1: bigacsiga ($187.20 in chips) 
Seat 2: matiko09 ($100 in chips) 
Seat 3: HITYESCA ($100 in chips) 
Seat 4: cap. marb ($39 in chips) 
Seat 5: qwertzuiopüß ($55.82 in chips) 
Seat 6: Daniel Daffe ($61.32 in chips) 
Seat 8: Pacifistas ($103.65 in chips) 
Seat 9: Spid1 ($100 in chips) 
cap. marb: posts small blind $0.50
qwertzuiopüß: posts big blind $1
*** HOLE CARDS ***
Dealt to matiko09 [As 8h]
Daniel Daffe: folds 
Pacifistas: folds 
Spid1: folds 
bigacsiga: folds 
matiko09: raises $1.50 to $2.50
HITYESCA: folds 
cap. marb: folds 
qwertzuiopüß: calls $1.50
*** FLOP *** [9s 3s Tc]
qwertzuiopüß: checks 
matiko09: checks 
*** TURN *** [9s 3s Tc] [7h]
qwertzuiopüß: bets $2
matiko09: calls $2
*** RIVER *** [9s 3s Tc 7h] [2c]
qwertzuiopüß: checks 
matiko09: checks 
*** SHOW DOWN ***
qwertzuiopüß: shows [Qh 9h] (a pair of Nines)
matiko09: mucks hand 
qwertzuiopüß collected $9.02 from pot
*** SUMMARY ***
Total pot $9.50 | Rake $0.48 
Board [9s 3s Tc 7h 2c]
Seat 1: bigacsiga folded before Flop (didn't bet)
Seat 2: matiko09 mucked [As 8h]
Seat 3: HITYESCA (button) folded before Flop (didn't bet)
Seat 4: cap. marb (small blind) folded before Flop
Seat 5: qwertzuiopüß (big blind) showed [Qh 9h] and won ($9.02) with a pair of Nines
Seat 6: Daniel Daffe folded before Flop (didn't bet)
Seat 8: Pacifistas folded before Flop (didn't bet)
Seat 9: Spid1 folded before Flop (didn't bet)





PokerStars Hand #152662686838:  Hold'em No Limit ($0.50/$1.00 USD) - 2016/04/30 18:42:52 CET [2016/04/30 12:42:52 ET]
Table 'Ruvuma' 9-max Seat #2 is the button
Seat 1: Ilov3NBA ($104.88 in chips) 
Seat 2: Spid1 ($100 in chips) 
Seat 3: OneTwo81 ($95.22 in chips) 
Seat 4: splicanin1 ($101.43 in chips) 
Seat 5: 1CANSEEY0U ($56.57 in chips) 
Seat 6: Pacifistas ($100 in chips) 
Seat 7: matiko09 ($100 in chips) 
Seat 8: Bailey Dew ($141.10 in chips) 
Seat 9: ApkawaDavit ($132.58 in chips) 
OneTwo81: posts small blind $0.50
splicanin1: posts big blind $1
*** HOLE CARDS ***
Dealt to matiko09 [Ts Qh]
1CANSEEY0U: raises $2 to $3
Pacifistas: folds 
matiko09: folds 
Bailey Dew: folds 
ApkawaDavit: calls $3
Ilov3NBA: folds 
Spid1: folds 
OneTwo81: folds 
splicanin1: calls $2
*** FLOP *** [7c 9s 7s]
splicanin1: checks 
1CANSEEY0U: checks 
ApkawaDavit: bets $3
splicanin1: folds 
1CANSEEY0U: calls $3
*** TURN *** [7c 9s 7s] [2d]
1CANSEEY0U: checks 
ApkawaDavit: bets $6.50
1CANSEEY0U: raises $8.50 to $15
ApkawaDavit: calls $8.50
*** RIVER *** [7c 9s 7s 2d] [3d]
1CANSEEY0U: bets $13
ApkawaDavit: raises $36.50 to $49.50
1CANSEEY0U: folds 
Uncalled bet ($36.50) returned to ApkawaDavit
ApkawaDavit collected $69 from pot
ApkawaDavit: doesn't show hand 
*** SUMMARY ***
Total pot $71.50 | Rake $2.50 
Board [7c 9s 7s 2d 3d]
Seat 1: Ilov3NBA folded before Flop (didn't bet)
Seat 2: Spid1 (button) folded before Flop (didn't bet)
Seat 3: OneTwo81 (small blind) folded before Flop
Seat 4: splicanin1 (big blind) folded on the Flop
Seat 5: 1CANSEEY0U folded on the River
Seat 6: Pacifistas folded before Flop (didn't bet)
Seat 7: matiko09 folded before Flop (didn't bet)
Seat 8: Bailey Dew folded before Flop (didn't bet)
Seat 9: ApkawaDavit collected ($69)





PokerStars Hand #152662690135:  Hold'em No Limit ($0.50/$1.00 USD) - 2016/04/30 18:42:57 CET [2016/04/30 12:42:57 ET]
Table 'Lova II' 9-max Seat #6 is the button
Seat 1: Pacifistas ($104.08 in chips) 
Seat 2: bilukm ($299.62 in chips) 
Seat 3: matiko09 ($103.37 in chips) 
Seat 4: VanDobeln ($126.35 in chips) 
Seat 5: Ilov3NBA ($161.01 in chips) 
Seat 6: HITYESCA ($103 in chips) 
Seat 7: Szevasztopol ($105.82 in chips) 
Seat 8: cap. marb ($57.39 in chips) 
Szevasztopol: posts small blind $0.50
cap. marb: posts big blind $1
IseeUcards: sits out 
*** HOLE CARDS ***
Dealt to matiko09 [4c 6h]
Pacifistas: folds 
bilukm: folds 
matiko09: folds 
VanDobeln: folds 
Ilov3NBA: folds 
HITYESCA: raises $1.50 to $2.50
Szevasztopol: folds 
cap. marb: raises $4.50 to $7
HITYESCA: folds 
Uncalled bet ($4.50) returned to cap. marb
cap. marb collected $5.50 from pot
cap. marb: doesn't show hand 
*** SUMMARY ***
Total pot $5.50 | Rake $0 
Seat 1: Pacifistas folded before Flop (didn't bet)
Seat 2: bilukm folded before Flop (didn't bet)
Seat 3: matiko09 folded before Flop (didn't bet)
Seat 4: VanDobeln folded before Flop (didn't bet)
Seat 5: Ilov3NBA folded before Flop (didn't bet)
Seat 6: HITYESCA (button) folded before Flop
Seat 7: Szevasztopol (small blind) folded before Flop
Seat 8: cap. marb (big blind) collected ($5.50)





PokerStars Hand #152662694261:  Hold'em No Limit ($0.50/$1.00 USD) - 2016/04/30 18:43:02 CET [2016/04/30 12:43:02 ET]
Table 'Kalliope II' 9-max Seat #9 is the button
Seat 1: cap. marb ($36.61 in chips) 
Seat 2: bigacsiga ($157.78 in chips) 
Seat 3: matiko09 ($100 in chips) 
Seat 4: Ilov3NBA ($120.42 in chips) 
Seat 5: SIMONE280201 ($48.59 in chips) 
Seat 6: hurtNCYDE ($106.46 in chips) 
Seat 7: ApkawaDavit ($159.43 in chips) 
Seat 8: RoadtoNepal ($118.23 in chips) 
Seat 9: scaihaze ($112.14 in chips) 
cap. marb: posts small blind $0.50
bigacsiga: posts big blind $1
*** HOLE CARDS ***
Dealt to matiko09 [Jc 3s]
matiko09: folds 
Ilov3NBA: folds 
SIMONE280201 has timed out
SIMONE280201: folds 
hurtNCYDE: folds 
ApkawaDavit: folds 
RoadtoNepal: folds 
scaihaze: raises $2 to $3
cap. marb: folds 
bigacsiga: calls $2
*** FLOP *** [Tc 7s 8c]
bigacsiga: checks 
scaihaze: bets $4
bigacsiga: calls $4
*** TURN *** [Tc 7s 8c] [Ah]
bigacsiga: checks 
SIMONE280201 is disconnected 
scaihaze: bets $8
bigacsiga: folds 
Uncalled bet ($8) returned to scaihaze
scaihaze collected $13.78 from pot
scaihaze: doesn't show hand 
*** SUMMARY ***
Total pot $14.50 | Rake $0.72 
Board [Tc 7s 8c Ah]
Seat 1: cap. marb (small blind) folded before Flop
Seat 2: bigacsiga (big blind) folded on the Turn
Seat 3: matiko09 folded before Flop (didn't bet)
Seat 4: Ilov3NBA folded before Flop (didn't bet)
Seat 5: SIMONE280201 folded before Flop (didn't bet)
Seat 6: hurtNCYDE folded before Flop (didn't bet)
Seat 7: ApkawaDavit folded before Flop (didn't bet)
Seat 8: RoadtoNepal folded before Flop (didn't bet)
Seat 9: scaihaze (button) collected ($13.78)





PokerStars Hand #152662696278:  Hold'em No Limit ($0.50/$1.00 USD) - 2016/04/30 18:43:04 CET [2016/04/30 12:43:04 ET]
Table 'Raissa II' 9-max Seat #4 is the button
Seat 1: cap. marb ($48.45 in chips) 
Seat 2: azzad2007 ($110.78 in chips) 
Seat 3: iRivuLose ($100.37 in chips) 
Seat 4: HITYESCA ($102.12 in chips) 
Seat 5: korlito69 ($50.63 in chips) 
Seat 6: hurtNCYDE ($111.98 in chips) 
Seat 7: matiko09 ($100 in chips) 
Seat 8: Pacifistas ($107.65 in chips) 
Seat 9: WrongButton ($100 in chips) 
korlito69: posts small blind $0.50
hurtNCYDE: posts big blind $1
*** HOLE CARDS ***
Dealt to matiko09 [Qd Tc]
matiko09: folds 
Pacifistas: folds 
WrongButton: folds 
cap. marb: folds 
azzad2007: folds 
iRivuLose: folds 
HITYESCA: folds 
korlito69: raises $2 to $3
hurtNCYDE: folds 
Uncalled bet ($2) returned to korlito69
korlito69 collected $2 from pot
korlito69: doesn't show hand 
*** SUMMARY ***
Total pot $2 | Rake $0 
Seat 1: cap. marb folded before Flop (didn't bet)
Seat 2: azzad2007 folded before Flop (didn't bet)
Seat 3: iRivuLose folded before Flop (didn't bet)
Seat 4: HITYESCA (button) folded before Flop (didn't bet)
Seat 5: korlito69 (small blind) collected ($2)
Seat 6: hurtNCYDE (big blind) folded before Flop
Seat 7: matiko09 folded before Flop (didn't bet)
Seat 8: Pacifistas folded before Flop (didn't bet)
Seat 9: WrongButton folded before Flop (didn't bet)





PokerStars Hand #152662709193:  Hold'em No Limit ($0.50/$1.00 USD) - 2016/04/30 18:43:21 CET [2016/04/30 12:43:21 ET]
Table 'Dagmar' 9-max Seat #4 is the button
Seat 1: matiko09 ($195 in chips) 
Seat 2: Spid1 ($190.78 in chips) 
Seat 3: ApkawaDavit ($114.70 in chips) 
Seat 4: RoadtoNepal ($105 in chips) 
Seat 5: cap. marb ($46.02 in chips) 
Seat 6: arctur17 ($105.03 in chips) 
Seat 7: kswmh ($75.98 in chips) 
Seat 8: Ilov3NBA ($144.48 in chips) 
Seat 9: okkernoot111 ($85.85 in chips) 
cap. marb: posts small blind $0.50
arctur17: posts big blind $1
*** HOLE CARDS ***
Dealt to matiko09 [Kh 2d]
kswmh: folds 
Ilov3NBA: folds 
okkernoot111: folds 
matiko09: folds 
Spid1: folds 
ApkawaDavit: raises $1.50 to $2.50
RoadtoNepal: calls $2.50
cap. marb: folds 
arctur17: folds 
*** FLOP *** [As 5c Qc]
ApkawaDavit: checks 
RoadtoNepal: bets $4.63
ApkawaDavit: folds 
Uncalled bet ($4.63) returned to RoadtoNepal
RoadtoNepal collected $6.18 from pot
RoadtoNepal: doesn't show hand 
*** SUMMARY ***
Total pot $6.50 | Rake $0.32 
Board [As 5c Qc]
Seat 1: matiko09 folded before Flop (didn't bet)
Seat 2: Spid1 folded before Flop (didn't bet)
Seat 3: ApkawaDavit folded on the Flop
Seat 4: RoadtoNepal (button) collected ($6.18)
Seat 5: cap. marb (small blind) folded before Flop
Seat 6: arctur17 (big blind) folded before Flop
Seat 7: kswmh folded before Flop (didn't bet)
Seat 8: Ilov3NBA folded before Flop (didn't bet)
Seat 9: okkernoot111 folded before Flop (didn't bet)





PokerStars Hand #152662710537:  Hold'em No Limit ($0.50/$1.00 USD) - 2016/04/30 18:43:23 CET [2016/04/30 12:43:23 ET]
Table 'Hippasos' 9-max Seat #7 is the button
Seat 1: MRC63S ($78.52 in chips) 
Seat 2: matiko09 ($100 in chips) 
Seat 3: WrongButton ($102.99 in chips) 
Seat 5: boutabi ($114.75 in chips) 
Seat 6: JACQUILF ($100 in chips) 
Seat 7: ilaviiitech ($100 in chips) 
Seat 8: Spid1 ($100 in chips) 
Seat 9: ApkawaDavit ($101.62 in chips) 
Spid1: posts small blind $0.50
ApkawaDavit: posts big blind $1
*** HOLE CARDS ***
Dealt to matiko09 [Ac 7c]
MRC63S: calls $1
matiko09: folds 
WrongButton: folds 
boutabi: folds 
JACQUILF: folds 
ilaviiitech: folds 
Spid1: folds 
ApkawaDavit: checks 
*** FLOP *** [7h Th 3s]
ApkawaDavit: checks 
MRC63S: checks 
*** TURN *** [7h Th 3s] [Td]
ApkawaDavit: checks 
MRC63S: bets $2
ApkawaDavit: folds 
Uncalled bet ($2) returned to MRC63S
MRC63S collected $2.38 from pot
MRC63S: doesn't show hand 
*** SUMMARY ***
Total pot $2.50 | Rake $0.12 
Board [7h Th 3s Td]
Seat 1: MRC63S collected ($2.38)
Seat 2: matiko09 folded before Flop (didn't bet)
Seat 3: WrongButton folded before Flop (didn't bet)
Seat 5: boutabi folded before Flop (didn't bet)
Seat 6: JACQUILF folded before Flop (didn't bet)
Seat 7: ilaviiitech (button) folded before Flop (didn't bet)
Seat 8: Spid1 (small blind) folded before Flop
Seat 9: ApkawaDavit (big blind) folded on the Turn





PokerStars Hand #152662724366:  Hold'em No Limit ($0.50/$1.00 USD) - 2016/04/30 18:43:40 CET [2016/04/30 12:43:40 ET]
Table 'Lova II' 9-max Seat #7 is the button
Seat 1: Pacifistas ($104.08 in chips) 
Seat 2: bilukm ($299.62 in chips) 
Seat 3: matiko09 ($103.37 in chips) 
Seat 4: VanDobeln ($126.35 in chips) 
Seat 5: Ilov3NBA ($161.01 in chips) 
Seat 6: HITYESCA ($100.50 in chips) 
Seat 7: Szevasztopol ($105.32 in chips) 
Seat 8: cap. marb ($60.39 in chips) 
Seat 9: IseeUcards ($100 in chips) 
cap. marb: posts small blind $0.50
IseeUcards: posts big blind $1
*** HOLE CARDS ***
Dealt to matiko09 [2d Ah]
Pacifistas: folds 
Pacifistas leaves the table
I The King I joins the table at seat #1 
I The King I leaves the table
hurtNCYDE joins the table at seat #1 
hurtNCYDE leaves the table
bilukm: raises $2 to $3
Bimaxa joins the table at seat #1 
matiko09: folds 
VanDobeln: folds 
Ilov3NBA: folds 
Bimaxa leaves the table
HITYESCA: folds 
Szevasztopol: folds 
cap. marb: folds 
IseeUcards: folds 
Uncalled bet ($2) returned to bilukm
bilukm collected $2.50 from pot
bilukm: doesn't show hand 
*** SUMMARY ***
Total pot $2.50 | Rake $0 
Seat 1: Pacifistas folded before Flop (didn't bet)
Seat 2: bilukm collected ($2.50)
Seat 3: matiko09 folded before Flop (didn't bet)
Seat 4: VanDobeln folded before Flop (didn't bet)
Seat 5: Ilov3NBA folded before Flop (didn't bet)
Seat 6: HITYESCA folded before Flop (didn't bet)
Seat 7: Szevasztopol (button) folded before Flop (didn't bet)
Seat 8: cap. marb (small blind) folded before Flop
Seat 9: IseeUcards (big blind) folded before Flop





PokerStars Hand #152662732997:  Hold'em No Limit ($0.50/$1.00 USD) - 2016/04/30 18:43:51 CET [2016/04/30 12:43:51 ET]
Table 'Selinur II' 9-max Seat #4 is the button
Seat 1: bigacsiga ($187.20 in chips) 
Seat 2: matiko09 ($100 in chips) 
Seat 3: HITYESCA ($100 in chips) 
Seat 4: cap. marb ($38.50 in chips) 
Seat 5: qwertzuiopüß ($60.34 in chips) 
Seat 6: Daniel Daffe ($61.32 in chips) 
Seat 7: azqanaz ($100 in chips) 
Seat 8: Pacifistas ($103.65 in chips) 
Seat 9: Spid1 ($100 in chips) 
qwertzuiopüß: posts small blind $0.50
Daniel Daffe: posts big blind $1
*** HOLE CARDS ***
Dealt to matiko09 [Jh 9s]
azqanaz: folds 
Pacifistas: folds 
Spid1: folds 
bigacsiga: folds 
azqanaz leaves the table
matiko09: folds 
JACQUILF joins the table at seat #7 
HITYESCA: folds 
cap. marb: folds 
qwertzuiopüß: folds 
Uncalled bet ($0.50) returned to Daniel Daffe
Daniel Daffe collected $1 from pot
Daniel Daffe: doesn't show hand 
*** SUMMARY ***
Total pot $1 | Rake $0 
Seat 1: bigacsiga folded before Flop (didn't bet)
Seat 2: matiko09 folded before Flop (didn't bet)
Seat 3: HITYESCA folded before Flop (didn't bet)
Seat 4: cap. marb (button) folded before Flop (didn't bet)
Seat 5: qwertzuiopüß (small blind) folded before Flop
Seat 6: Daniel Daffe (big blind) collected ($1)
Seat 7: azqanaz folded before Flop (didn't bet)
Seat 8: Pacifistas folded before Flop (didn't bet)
Seat 9: Spid1 folded before Flop (didn't bet)





PokerStars Hand #152662744248:  Hold'em No Limit ($0.50/$1.00 USD) - 2016/04/30 18:44:06 CET [2016/04/30 12:44:06 ET]
Table 'Lova II' 9-max Seat #8 is the button
Seat 2: bilukm ($301.12 in chips) 
Seat 3: matiko09 ($103.37 in chips) 
Seat 4: VanDobeln ($126.35 in chips) 
Seat 5: Ilov3NBA ($161.01 in chips) 
Seat 6: HITYESCA ($100.50 in chips) 
Seat 7: Szevasztopol ($105.32 in chips) 
Seat 8: cap. marb ($59.89 in chips) 
Seat 9: IseeUcards ($100 in chips) 
IseeUcards: posts small blind $0.50
bilukm: posts big blind $1
*** HOLE CARDS ***
Dealt to matiko09 [Qd Kd]
matiko09: raises $2 to $3
VanDobeln: folds 
Ilov3NBA: folds 
HITYESCA: folds 
RoadtoNepal joins the table at seat #1 
RoadtoNepal leaves the table
Szevasztopol: folds 
pelikan1968 joins the table at seat #1 
cap. marb: folds 
IseeUcards: folds 
bilukm: folds 
Uncalled bet ($2) returned to matiko09
matiko09 collected $2.50 from pot
matiko09: doesn't show hand 
*** SUMMARY ***
Total pot $2.50 | Rake $0 
Seat 2: bilukm (big blind) folded before Flop
Seat 3: matiko09 collected ($2.50)
Seat 4: VanDobeln folded before Flop (didn't bet)
Seat 5: Ilov3NBA folded before Flop (didn't bet)
Seat 6: HITYESCA folded before Flop (didn't bet)
Seat 7: Szevasztopol folded before Flop (didn't bet)
Seat 8: cap. marb (button) folded before Flop (didn't bet)
Seat 9: IseeUcards (small blind) folded before Flop





PokerStars Hand #152662750057:  Hold'em No Limit ($0.50/$1.00 USD) - 2016/04/30 18:44:13 CET [2016/04/30 12:44:13 ET]
Table 'Hippasos' 9-max Seat #8 is the button
Seat 1: MRC63S ($79.90 in chips) 
Seat 2: matiko09 ($100 in chips) 
Seat 3: WrongButton ($102.99 in chips) 
Seat 5: boutabi ($114.75 in chips) 
Seat 6: JACQUILF ($100 in chips) 
Seat 7: ilaviiitech ($100 in chips) 
Seat 8: Spid1 ($100 in chips) 
Seat 9: ApkawaDavit ($100.62 in chips) 
ApkawaDavit: posts small blind $0.50
MRC63S: posts big blind $1
*** HOLE CARDS ***
Dealt to matiko09 [Qs 9c]
matiko09: folds 
WrongButton: folds 
boutabi: raises $1 to $2
JACQUILF: folds 
ilaviiitech: folds 
Spid1: folds 
ApkawaDavit: folds 
MRC63S: calls $1
*** FLOP *** [Ah 5d 8s]
MRC63S: checks 
boutabi: checks 
*** TURN *** [Ah 5d 8s] [9h]
MRC63S: checks 
boutabi: checks 
*** RIVER *** [Ah 5d 8s 9h] [4d]
MRC63S: checks 
boutabi: bets $1
MRC63S: folds 
Uncalled bet ($1) returned to boutabi
boutabi collected $4.28 from pot
boutabi: doesn't show hand 
*** SUMMARY ***
Total pot $4.50 | Rake $0.22 
Board [Ah 5d 8s 9h 4d]
Seat 1: MRC63S (big blind) folded on the River
Seat 2: matiko09 folded before Flop (didn't bet)
Seat 3: WrongButton folded before Flop (didn't bet)
Seat 5: boutabi collected ($4.28)
Seat 6: JACQUILF folded before Flop (didn't bet)
Seat 7: ilaviiitech folded before Flop (didn't bet)
Seat 8: Spid1 (button) folded before Flop (didn't bet)
Seat 9: ApkawaDavit (small blind) folded before Flop





PokerStars Hand #152662754476:  Hold'em No Limit ($0.50/$1.00 USD) - 2016/04/30 18:44:19 CET [2016/04/30 12:44:19 ET]
Table 'Dagmar' 9-max Seat #5 is the button
Seat 1: matiko09 ($195 in chips) 
Seat 2: Spid1 ($190.78 in chips) 
Seat 3: ApkawaDavit ($112.20 in chips) 
Seat 4: RoadtoNepal ($108.68 in chips) 
Seat 5: cap. marb ($45.52 in chips) 
Seat 6: arctur17 ($104.03 in chips) 
Seat 7: kswmh ($75.98 in chips) 
Seat 8: Ilov3NBA ($144.48 in chips) 
Seat 9: okkernoot111 ($85.85 in chips) 
arctur17: posts small blind $0.50
kswmh: posts big blind $1
*** HOLE CARDS ***
Dealt to matiko09 [3s 9s]
Ilov3NBA: folds 
okkernoot111: folds 
matiko09: folds 
Spid1: folds 
ApkawaDavit: folds 
RoadtoNepal: folds 
cap. marb: folds 
arctur17: folds 
Uncalled bet ($0.50) returned to kswmh
kswmh collected $1 from pot
kswmh: doesn't show hand 
*** SUMMARY ***
Total pot $1 | Rake $0 
Seat 1: matiko09 folded before Flop (didn't bet)
Seat 2: Spid1 folded before Flop (didn't bet)
Seat 3: ApkawaDavit folded before Flop (didn't bet)
Seat 4: RoadtoNepal folded before Flop (didn't bet)
Seat 5: cap. marb (button) folded before Flop (didn't bet)
Seat 6: arctur17 (small blind) folded before Flop
Seat 7: kswmh (big blind) collected ($1)
Seat 8: Ilov3NBA folded before Flop (didn't bet)
Seat 9: okkernoot111 folded before Flop (didn't bet)





PokerStars Hand #152662774834:  Hold'em No Limit ($0.50/$1.00 USD) - 2016/04/30 18:44:45 CET [2016/04/30 12:44:45 ET]
Table 'Selinur II' 9-max Seat #5 is the button
Seat 1: bigacsiga ($187.20 in chips) 
Seat 2: matiko09 ($100 in chips) 
Seat 3: HITYESCA ($100 in chips) 
Seat 4: cap. marb ($38.50 in chips) 
Seat 5: qwertzuiopüß ($59.84 in chips) 
Seat 6: Daniel Daffe ($61.82 in chips) 
Seat 8: Pacifistas ($103.65 in chips) 
Seat 9: Spid1 ($100 in chips) 
Daniel Daffe: posts small blind $0.50
Pacifistas: posts big blind $1
*** HOLE CARDS ***
Dealt to matiko09 [8d 3c]
Spid1: folds 
bigacsiga: folds 
matiko09: folds 
HITYESCA: folds 
cap. marb: folds 
qwertzuiopüß: raises $2 to $3
Daniel Daffe: folds 
Pacifistas: folds 
Uncalled bet ($2) returned to qwertzuiopüß
qwertzuiopüß collected $2.50 from pot
qwertzuiopüß: doesn't show hand 
*** SUMMARY ***
Total pot $2.50 | Rake $0 
Seat 1: bigacsiga folded before Flop (didn't bet)
Seat 2: matiko09 folded before Flop (didn't bet)
Seat 3: HITYESCA folded before Flop (didn't bet)
Seat 4: cap. marb folded before Flop (didn't bet)
Seat 5: qwertzuiopüß (button) collected ($2.50)
Seat 6: Daniel Daffe (small blind) folded before Flop
Seat 8: Pacifistas (big blind) folded before Flop
Seat 9: Spid1 folded before Flop (didn't bet)





PokerStars Hand #152662778034:  Hold'em No Limit ($0.50/$1.00 USD) - 2016/04/30 18:44:49 CET [2016/04/30 12:44:49 ET]
Table 'Dagmar' 9-max Seat #6 is the button
Seat 1: matiko09 ($195 in chips) 
Seat 2: Spid1 ($190.78 in chips) 
Seat 3: ApkawaDavit ($112.20 in chips) 
Seat 4: RoadtoNepal ($108.68 in chips) 
Seat 5: cap. marb ($45.52 in chips) 
Seat 6: arctur17 ($103.53 in chips) 
Seat 7: kswmh ($76.48 in chips) 
Seat 8: Ilov3NBA ($144.48 in chips) 
Seat 9: okkernoot111 ($85.85 in chips) 
kswmh: posts small blind $0.50
Ilov3NBA: posts big blind $1
*** HOLE CARDS ***
Dealt to matiko09 [6c 7d]
okkernoot111: folds 
matiko09: folds 
Spid1: folds 
ApkawaDavit: raises $2 to $3
RoadtoNepal: folds 
cap. marb: folds 
arctur17: folds 
kswmh: calls $2.50
Ilov3NBA: folds 
*** FLOP *** [4s 8c Jd]
kswmh: checks 
ApkawaDavit: bets $5.50
kswmh: folds 
Uncalled bet ($5.50) returned to ApkawaDavit
ApkawaDavit collected $6.65 from pot
ApkawaDavit: doesn't show hand 
*** SUMMARY ***
Total pot $7 | Rake $0.35 
Board [4s 8c Jd]
Seat 1: matiko09 folded before Flop (didn't bet)
Seat 2: Spid1 folded before Flop (didn't bet)
Seat 3: ApkawaDavit collected ($6.65)
Seat 4: RoadtoNepal folded before Flop (didn't bet)
Seat 5: cap. marb folded before Flop (didn't bet)
Seat 6: arctur17 (button) folded before Flop (didn't bet)
Seat 7: kswmh (small blind) folded on the Flop
Seat 8: Ilov3NBA (big blind) folded before Flop
Seat 9: okkernoot111 folded before Flop (didn't bet)





PokerStars Hand #152662783047:  Hold'em No Limit ($0.50/$1.00 USD) - 2016/04/30 18:44:55 CET [2016/04/30 12:44:55 ET]
Table 'Kalliope II' 9-max Seat #1 is the button
Seat 1: cap. marb ($36.11 in chips) 
Seat 2: bigacsiga ($150.78 in chips) 
Seat 3: matiko09 ($100 in chips) 
Seat 4: Ilov3NBA ($120.42 in chips) 
Seat 6: hurtNCYDE ($106.46 in chips) 
Seat 7: ApkawaDavit ($159.43 in chips) 
Seat 8: RoadtoNepal ($118.23 in chips) 
Seat 9: scaihaze ($118.92 in chips) 
bigacsiga: posts small blind $0.50
matiko09: posts big blind $1
*** HOLE CARDS ***
Dealt to matiko09 [5d 5h]
Ilov3NBA: folds 
hurtNCYDE: folds 
ApkawaDavit: folds 
RoadtoNepal: folds 
scaihaze: folds 
cap. marb: raises $1.12 to $2.12
bigacsiga: folds 
matiko09: calls $1.12
*** FLOP *** [8c 6d 4s]
matiko09: checks 
cap. marb: bets $2.97
matiko09: calls $2.97
*** TURN *** [8c 6d 4s] [7d]
matiko09: checks 
cap. marb: checks 
*** RIVER *** [8c 6d 4s 7d] [3d]
matiko09: bets $7
cap. marb: calls $7
*** SHOW DOWN ***
matiko09: shows [5d 5h] (a straight, Four to Eight)
cap. marb: mucks hand 
matiko09 collected $23.45 from pot
*** SUMMARY ***
Total pot $24.68 | Rake $1.23 
Board [8c 6d 4s 7d 3d]
Seat 1: cap. marb (button) mucked [Qh Qc]
Seat 2: bigacsiga (small blind) folded before Flop
Seat 3: matiko09 (big blind) showed [5d 5h] and won ($23.45) with a straight, Four to Eight
Seat 4: Ilov3NBA folded before Flop (didn't bet)
Seat 6: hurtNCYDE folded before Flop (didn't bet)
Seat 7: ApkawaDavit folded before Flop (didn't bet)
Seat 8: RoadtoNepal folded before Flop (didn't bet)
Seat 9: scaihaze folded before Flop (didn't bet)





PokerStars Hand #152662783762:  Hold'em No Limit ($0.50/$1.00 USD) - 2016/04/30 18:44:56 CET [2016/04/30 12:44:56 ET]
Table 'Hippasos' 9-max Seat #9 is the button
Seat 1: MRC63S ($77.90 in chips) 
Seat 2: matiko09 ($100 in chips) 
Seat 3: WrongButton ($102.99 in chips) 
Seat 5: boutabi ($117.03 in chips) 
Seat 6: JACQUILF ($100 in chips) 
Seat 7: ilaviiitech ($100 in chips) 
Seat 8: Spid1 ($100 in chips) 
Seat 9: ApkawaDavit ($100.12 in chips) 
MRC63S: posts small blind $0.50
matiko09: posts big blind $1
*** HOLE CARDS ***
Dealt to matiko09 [Ah 8h]
WrongButton: folds 
boutabi: calls $1
JACQUILF: raises $3 to $4
ilaviiitech: folds 
Spid1: folds 
ApkawaDavit: folds 
MRC63S: folds 
matiko09: folds 
boutabi: calls $3
*** FLOP *** [7d 6c 9c]
boutabi: checks 
JACQUILF: bets $5.41
boutabi: folds 
Uncalled bet ($5.41) returned to JACQUILF
JACQUILF collected $9.02 from pot
JACQUILF: doesn't show hand 
*** SUMMARY ***
Total pot $9.50 | Rake $0.48 
Board [7d 6c 9c]
Seat 1: MRC63S (small blind) folded before Flop
Seat 2: matiko09 (big blind) folded before Flop
Seat 3: WrongButton folded before Flop (didn't bet)
Seat 5: boutabi folded on the Flop
Seat 6: JACQUILF collected ($9.02)
Seat 7: ilaviiitech folded before Flop (didn't bet)
Seat 8: Spid1 folded before Flop (didn't bet)
Seat 9: ApkawaDavit (button) folded before Flop (didn't bet)





PokerStars Hand #152662787487:  Hold'em No Limit ($0.50/$1.00 USD) - 2016/04/30 18:45:01 CET [2016/04/30 12:45:01 ET]
Table 'Lova II' 9-max Seat #9 is the button
Seat 2: bilukm ($300.12 in chips) 
Seat 3: matiko09 ($104.87 in chips) 
Seat 4: VanDobeln ($126.35 in chips) 
Seat 5: Ilov3NBA ($161.01 in chips) 
Seat 6: HITYESCA ($100.50 in chips) 
Seat 7: Szevasztopol ($105.32 in chips) 
Seat 8: cap. marb ($59.89 in chips) 
Seat 9: IseeUcards ($100 in chips) 
pelikan1968 will be allowed to play after the button
bilukm: posts small blind $0.50
matiko09: posts big blind $1
*** HOLE CARDS ***
Dealt to matiko09 [7d 3h]
VanDobeln: folds 
Ilov3NBA: raises $2 to $3
HITYESCA: folds 
Szevasztopol: folds 
cap. marb: folds 
IseeUcards: folds 
bilukm: calls $2.50
matiko09: folds 
*** FLOP *** [Tc Qd Th]
bilukm: bets $3.32
Ilov3NBA: folds 
Uncalled bet ($3.32) returned to bilukm
bilukm collected $6.65 from pot
bilukm: doesn't show hand 
*** SUMMARY ***
Total pot $7 | Rake $0.35 
Board [Tc Qd Th]
Seat 2: bilukm (small blind) collected ($6.65)
Seat 3: matiko09 (big blind) folded before Flop
Seat 4: VanDobeln folded before Flop (didn't bet)
Seat 5: Ilov3NBA folded on the Flop
Seat 6: HITYESCA folded before Flop (didn't bet)
Seat 7: Szevasztopol folded before Flop (didn't bet)
Seat 8: cap. marb folded before Flop (didn't bet)
Seat 9: IseeUcards (button) folded before Flop (didn't bet)





PokerStars Hand #152662788294:  Hold'em No Limit ($0.50/$1.00 USD) - 2016/04/30 18:45:02 CET [2016/04/30 12:45:02 ET]
Table 'Ruvuma' 9-max Seat #3 is the button
Seat 1: Ilov3NBA ($104.88 in chips) 
Seat 2: Spid1 ($100 in chips) 
Seat 3: OneTwo81 ($94.72 in chips) 
Seat 4: splicanin1 ($98.43 in chips) 
Seat 5: 1CANSEEY0U ($22.57 in chips) 
Seat 6: Pacifistas ($100 in chips) 
Seat 7: matiko09 ($100 in chips) 
Seat 8: Bailey Dew ($141.10 in chips) 
Seat 9: ApkawaDavit ($167.58 in chips) 
splicanin1: posts small blind $0.50
1CANSEEY0U: posts big blind $1
*** HOLE CARDS ***
Dealt to matiko09 [9s 5s]
Pacifistas: folds 
matiko09: folds 
Bailey Dew: folds 
ApkawaDavit: raises $2 to $3
Ilov3NBA: folds 
Spid1: raises $6 to $9
OneTwo81: folds 
splicanin1: folds 
1CANSEEY0U: folds 
ApkawaDavit: calls $6
*** FLOP *** [Qs 9c 8h]
ApkawaDavit: checks 
Spid1: bets $12
ApkawaDavit: calls $12
*** TURN *** [Qs 9c 8h] [Th]
ApkawaDavit: checks 
Spid1: bets $27.50
ApkawaDavit: folds 
Uncalled bet ($27.50) returned to Spid1
Spid1 collected $41.32 from pot
Spid1: doesn't show hand 
*** SUMMARY ***
Total pot $43.50 | Rake $2.18 
Board [Qs 9c 8h Th]
Seat 1: Ilov3NBA folded before Flop (didn't bet)
Seat 2: Spid1 collected ($41.32)
Seat 3: OneTwo81 (button) folded before Flop (didn't bet)
Seat 4: splicanin1 (small blind) folded before Flop
Seat 5: 1CANSEEY0U (big blind) folded before Flop
Seat 6: Pacifistas folded before Flop (didn't bet)
Seat 7: matiko09 folded before Flop (didn't bet)
Seat 8: Bailey Dew folded before Flop (didn't bet)
Seat 9: ApkawaDavit folded on the Turn





PokerStars Hand #152662796075:  Hold'em No Limit ($0.50/$1.00 USD) - 2016/04/30 18:45:12 CET [2016/04/30 12:45:12 ET]
Table 'Selinur II' 9-max Seat #6 is the button
Seat 1: bigacsiga ($187.20 in chips) 
Seat 2: matiko09 ($100 in chips) 
Seat 3: HITYESCA ($100 in chips) 
Seat 4: cap. marb ($38.50 in chips) 
Seat 5: qwertzuiopüß ($61.34 in chips) 
Seat 6: Daniel Daffe ($61.32 in chips) 
Seat 8: Pacifistas ($102.65 in chips) 
Seat 9: Spid1 ($100 in chips) 
Pacifistas: posts small blind $0.50
Spid1: posts big blind $1
*** HOLE CARDS ***
Dealt to matiko09 [3s Js]
bigacsiga: folds 
matiko09: folds 
HITYESCA: folds 
cap. marb: folds 
qwertzuiopüß: folds 
Daniel Daffe: folds 
Pacifistas: folds 
Uncalled bet ($0.50) returned to Spid1
Spid1 collected $1 from pot
Spid1: doesn't show hand 
*** SUMMARY ***
Total pot $1 | Rake $0 
Seat 1: bigacsiga folded before Flop (didn't bet)
Seat 2: matiko09 folded before Flop (didn't bet)
Seat 3: HITYESCA folded before Flop (didn't bet)
Seat 4: cap. marb folded before Flop (didn't bet)
Seat 5: qwertzuiopüß folded before Flop (didn't bet)
Seat 6: Daniel Daffe (button) folded before Flop (didn't bet)
Seat 8: Pacifistas (small blind) folded before Flop
Seat 9: Spid1 (big blind) collected ($1)





PokerStars Hand #152662806420:  Hold'em No Limit ($0.50/$1.00 USD) - 2016/04/30 18:45:25 CET [2016/04/30 12:45:25 ET]
Table 'Dagmar' 9-max Seat #7 is the button
Seat 1: matiko09 ($195 in chips) 
Seat 2: Spid1 ($190.78 in chips) 
Seat 3: ApkawaDavit ($115.85 in chips) 
Seat 4: RoadtoNepal ($108.68 in chips) 
Seat 5: cap. marb ($45.52 in chips) 
Seat 6: arctur17 ($103.53 in chips) 
Seat 7: kswmh ($73.48 in chips) 
Seat 8: Ilov3NBA ($143.48 in chips) 
Seat 9: okkernoot111 ($85.85 in chips) 
Ilov3NBA: posts small blind $0.50
okkernoot111: posts big blind $1
*** HOLE CARDS ***
Dealt to matiko09 [4s 9s]
matiko09: folds 
Spid1: folds 
ApkawaDavit: folds 
RoadtoNepal: folds 
cap. marb: folds 
arctur17: folds 
kswmh: raises $1 to $2
Ilov3NBA: folds 
okkernoot111: folds 
Uncalled bet ($1) returned to kswmh
kswmh collected $2.50 from pot
*** SUMMARY ***
Total pot $2.50 | Rake $0 
Seat 1: matiko09 folded before Flop (didn't bet)
Seat 2: Spid1 folded before Flop (didn't bet)
Seat 3: ApkawaDavit folded before Flop (didn't bet)
Seat 4: RoadtoNepal folded before Flop (didn't bet)
Seat 5: cap. marb folded before Flop (didn't bet)
Seat 6: arctur17 folded before Flop (didn't bet)
Seat 7: kswmh (button) collected ($2.50)
Seat 8: Ilov3NBA (small blind) folded before Flop
Seat 9: okkernoot111 (big blind) folded before Flop





PokerStars Hand #152662815236:  Hold'em No Limit ($0.50/$1.00 USD) - 2016/04/30 18:45:36 CET [2016/04/30 12:45:36 ET]
Table 'Hippasos' 9-max Seat #1 is the button
Seat 1: MRC63S ($77.40 in chips) 
Seat 2: matiko09 ($100 in chips) 
Seat 3: WrongButton ($102.99 in chips) 
Seat 5: boutabi ($113.03 in chips) 
Seat 6: JACQUILF ($105.02 in chips) 
Seat 7: ilaviiitech ($100 in chips) 
Seat 8: Spid1 ($100 in chips) 
Seat 9: ApkawaDavit ($100.12 in chips) 
matiko09: posts small blind $0.50
WrongButton: posts big blind $1
*** HOLE CARDS ***
Dealt to matiko09 [6s 3c]
boutabi: raises $4 to $5
JACQUILF: folds 
ilaviiitech: folds 
Spid1: folds 
ApkawaDavit: folds 
MRC63S: folds 
matiko09: folds 
WrongButton: folds 
Uncalled bet ($4) returned to boutabi
boutabi collected $2.50 from pot
boutabi: doesn't show hand 
*** SUMMARY ***
Total pot $2.50 | Rake $0 
Seat 1: MRC63S (button) folded before Flop (didn't bet)
Seat 2: matiko09 (small blind) folded before Flop
Seat 3: WrongButton (big blind) folded before Flop
Seat 5: boutabi collected ($2.50)
Seat 6: JACQUILF folded before Flop (didn't bet)
Seat 7: ilaviiitech folded before Flop (didn't bet)
Seat 8: Spid1 folded before Flop (didn't bet)
Seat 9: ApkawaDavit folded before Flop (didn't bet)





PokerStars Hand #152662826326:  Hold'em No Limit ($0.50/$1.00 USD) - 2016/04/30 18:45:51 CET [2016/04/30 12:45:51 ET]
Table 'Selinur II' 9-max Seat #8 is the button
Seat 2: matiko09 ($100 in chips) 
Seat 3: HITYESCA ($100 in chips) 
Seat 4: cap. marb ($38.50 in chips) 
Seat 5: qwertzuiopüß ($61.34 in chips) 
Seat 6: Daniel Daffe ($61.32 in chips) 
Seat 8: Pacifistas ($102.15 in chips) 
Seat 9: Spid1 ($100.50 in chips) 
Spid1: posts small blind $0.50
bigacsiga: is sitting out 
matiko09: posts big blind $1
*** HOLE CARDS ***
Dealt to matiko09 [6s 9s]
HITYESCA: folds 
bigacsiga leaves the table
cap. marb: folds 
qwertzuiopüß: folds 
Daniel Daffe: folds 
Pacifistas: raises $1.50 to $2.50
Spid1: folds 
matiko09: folds 
Uncalled bet ($1.50) returned to Pacifistas
Pacifistas collected $2.50 from pot
Pacifistas: doesn't show hand 
*** SUMMARY ***
Total pot $2.50 | Rake $0 
Seat 2: matiko09 (big blind) folded before Flop
Seat 3: HITYESCA folded before Flop (didn't bet)
Seat 4: cap. marb folded before Flop (didn't bet)
Seat 5: qwertzuiopüß folded before Flop (didn't bet)
Seat 6: Daniel Daffe folded before Flop (didn't bet)
Seat 8: Pacifistas (button) collected ($2.50)
Seat 9: Spid1 (small blind) folded before Flop





PokerStars Hand #152662827776:  Hold'em No Limit ($0.50/$1.00 USD) - 2016/04/30 18:45:53 CET [2016/04/30 12:45:53 ET]
Table 'Dagmar' 9-max Seat #8 is the button
Seat 1: matiko09 ($195 in chips) 
Seat 2: Spid1 ($190.78 in chips) 
Seat 3: ApkawaDavit ($115.85 in chips) 
Seat 4: RoadtoNepal ($108.68 in chips) 
Seat 5: cap. marb ($45.52 in chips) 
Seat 6: arctur17 ($103.53 in chips) 
Seat 7: kswmh ($74.98 in chips) 
Seat 8: Ilov3NBA ($142.98 in chips) 
Seat 9: okkernoot111 ($84.85 in chips) 
okkernoot111: posts small blind $0.50
matiko09: posts big blind $1
*** HOLE CARDS ***
Dealt to matiko09 [9h Jh]
Spid1: folds 
ApkawaDavit: folds 
RoadtoNepal: raises $2 to $3
cap. marb: folds 
arctur17: calls $3
kswmh: folds 
Ilov3NBA: folds 
okkernoot111: folds 
matiko09: folds 
*** FLOP *** [Kd Ah 5h]
RoadtoNepal: bets $5.34
arctur17: calls $5.34
*** TURN *** [Kd Ah 5h] [Js]
RoadtoNepal: bets $12.95
arctur17: calls $12.95
*** RIVER *** [Kd Ah 5h Js] [6d]
RoadtoNepal: bets $29
arctur17: calls $29
*** SHOW DOWN ***
RoadtoNepal: shows [As 6s] (two pair, Aces and Sixes)
arctur17: shows [Kh Ac] (two pair, Aces and Kings)
arctur17 collected $99.58 from pot
*** SUMMARY ***
Total pot $102.08 | Rake $2.50 
Board [Kd Ah 5h Js 6d]
Seat 1: matiko09 (big blind) folded before Flop
Seat 2: Spid1 folded before Flop (didn't bet)
Seat 3: ApkawaDavit folded before Flop (didn't bet)
Seat 4: RoadtoNepal showed [As 6s] and lost with two pair, Aces and Sixes
Seat 5: cap. marb folded before Flop (didn't bet)
Seat 6: arctur17 showed [Kh Ac] and won ($99.58) with two pair, Aces and Kings
Seat 7: kswmh folded before Flop (didn't bet)
Seat 8: Ilov3NBA (button) folded before Flop (didn't bet)
Seat 9: okkernoot111 (small blind) folded before Flop





PokerStars Hand #152662835131:  Hold'em No Limit ($0.50/$1.00 USD) - 2016/04/30 18:46:02 CET [2016/04/30 12:46:02 ET]
Table 'Lova II' 9-max Seat #2 is the button
Seat 2: bilukm ($303.77 in chips) 
Seat 3: matiko09 ($103.87 in chips) 
Seat 4: VanDobeln ($126.35 in chips) 
Seat 5: Ilov3NBA ($158.01 in chips) 
Seat 6: HITYESCA ($100.50 in chips) 
Seat 7: Szevasztopol ($105.32 in chips) 
Seat 8: cap. marb ($59.89 in chips) 
Seat 9: IseeUcards ($100 in chips) 
matiko09: posts small blind $0.50
VanDobeln: posts big blind $1
pelikan1968: sits out 
*** HOLE CARDS ***
Dealt to matiko09 [Jc 9c]
Ilov3NBA: folds 
HITYESCA: raises $2 to $3
Szevasztopol: folds 
cap. marb: folds 
IseeUcards: folds 
bilukm: calls $3
matiko09: folds 
VanDobeln: folds 
*** FLOP *** [Kh 7s Ad]
HITYESCA: bets $3
bilukm: calls $3
*** TURN *** [Kh 7s Ad] [Tc]
HITYESCA: checks 
bilukm: checks 
*** RIVER *** [Kh 7s Ad Tc] [Ac]
HITYESCA: checks 
bilukm: bets $6.41
HITYESCA: folds 
Uncalled bet ($6.41) returned to bilukm
bilukm collected $12.82 from pot
bilukm: doesn't show hand 
*** SUMMARY ***
Total pot $13.50 | Rake $0.68 
Board [Kh 7s Ad Tc Ac]
Seat 2: bilukm (button) collected ($12.82)
Seat 3: matiko09 (small blind) folded before Flop
Seat 4: VanDobeln (big blind) folded before Flop
Seat 5: Ilov3NBA folded before Flop (didn't bet)
Seat 6: HITYESCA folded on the River
Seat 7: Szevasztopol folded before Flop (didn't bet)
Seat 8: cap. marb folded before Flop (didn't bet)
Seat 9: IseeUcards folded before Flop (didn't bet)





PokerStars Hand #152662837327:  Hold'em No Limit ($0.50/$1.00 USD) - 2016/04/30 18:46:05 CET [2016/04/30 12:46:05 ET]
Table 'Ruvuma' 9-max Seat #4 is the button
Seat 1: Ilov3NBA ($104.88 in chips) 
Seat 2: Spid1 ($120.32 in chips) 
Seat 3: OneTwo81 ($94.72 in chips) 
Seat 4: splicanin1 ($97.93 in chips) 
Seat 5: 1CANSEEY0U ($21.57 in chips) 
Seat 6: Pacifistas ($100 in chips) 
Seat 7: matiko09 ($100 in chips) 
Seat 8: Bailey Dew ($141.10 in chips) 
Seat 9: ApkawaDavit ($146.58 in chips) 
1CANSEEY0U: posts small blind $0.50
Pacifistas: posts big blind $1
*** HOLE CARDS ***
Dealt to matiko09 [6s Ah]
matiko09: folds 
Bailey Dew: folds 
ApkawaDavit: folds 
Ilov3NBA: folds 
Spid1: raises $2 to $3
OneTwo81: folds 
splicanin1: folds 
1CANSEEY0U: folds 
Pacifistas: folds 
Uncalled bet ($2) returned to Spid1
Spid1 collected $2.50 from pot
Spid1: doesn't show hand 
*** SUMMARY ***
Total pot $2.50 | Rake $0 
Seat 1: Ilov3NBA folded before Flop (didn't bet)
Seat 2: Spid1 collected ($2.50)
Seat 3: OneTwo81 folded before Flop (didn't bet)
Seat 4: splicanin1 (button) folded before Flop (didn't bet)
Seat 5: 1CANSEEY0U (small blind) folded before Flop
Seat 6: Pacifistas (big blind) folded before Flop
Seat 7: matiko09 folded before Flop (didn't bet)
Seat 8: Bailey Dew folded before Flop (didn't bet)
Seat 9: ApkawaDavit folded before Flop (didn't bet)





PokerStars Hand #152662843535:  Hold'em No Limit ($0.50/$1.00 USD) - 2016/04/30 18:46:13 CET [2016/04/30 12:46:13 ET]
Table 'Hippasos' 9-max Seat #2 is the button
Seat 1: MRC63S ($77.40 in chips) 
Seat 2: matiko09 ($100 in chips) 
Seat 3: WrongButton ($101.99 in chips) 
Seat 4: Pacifistas ($100 in chips) 
Seat 5: boutabi ($114.53 in chips) 
Seat 6: JACQUILF ($105.02 in chips) 
Seat 7: ilaviiitech ($100 in chips) 
Seat 8: Spid1 ($100 in chips) 
Seat 9: ApkawaDavit ($100.12 in chips) 
WrongButton: posts small blind $0.50
Pacifistas: posts big blind $1
*** HOLE CARDS ***
Dealt to matiko09 [2h 8d]
boutabi: raises $4 to $5
JACQUILF: folds 
ilaviiitech: calls $5
Spid1: folds 
ApkawaDavit: folds 
MRC63S: folds 
matiko09: folds 
WrongButton: folds 
Pacifistas: folds 
*** FLOP *** [6s Qc 7c]
boutabi: bets $9
ilaviiitech: calls $9
*** TURN *** [6s Qc 7c] [Qd]
boutabi: bets $16
ilaviiitech: calls $16
*** RIVER *** [6s Qc 7c Qd] [3h]
boutabi: bets $31
ilaviiitech: folds 
Uncalled bet ($31) returned to boutabi
boutabi collected $59 from pot
boutabi: doesn't show hand 
*** SUMMARY ***
Total pot $61.50 | Rake $2.50 
Board [6s Qc 7c Qd 3h]
Seat 1: MRC63S folded before Flop (didn't bet)
Seat 2: matiko09 (button) folded before Flop (didn't bet)
Seat 3: WrongButton (small blind) folded before Flop
Seat 4: Pacifistas (big blind) folded before Flop
Seat 5: boutabi collected ($59)
Seat 6: JACQUILF folded before Flop (didn't bet)
Seat 7: ilaviiitech folded on the River
Seat 8: Spid1 folded before Flop (didn't bet)
Seat 9: ApkawaDavit folded before Flop (didn't bet)





PokerStars Hand #152662846288:  Hold'em No Limit ($0.50/$1.00 USD) - 2016/04/30 18:46:16 CET [2016/04/30 12:46:16 ET]
Table 'Kalliope II' 9-max Seat #2 is the button
Seat 1: cap. marb ($40 in chips) 
Seat 2: bigacsiga ($150.28 in chips) 
Seat 3: matiko09 ($111.36 in chips) 
Seat 4: Ilov3NBA ($120.42 in chips) 
Seat 6: hurtNCYDE ($106.46 in chips) 
Seat 7: ApkawaDavit ($159.43 in chips) 
Seat 8: RoadtoNepal ($118.23 in chips) 
Seat 9: scaihaze ($118.92 in chips) 
matiko09: posts small blind $0.50
Ilov3NBA: posts big blind $1
*** HOLE CARDS ***
Dealt to matiko09 [Ad Qh]
hurtNCYDE: folds 
ApkawaDavit: folds 
RoadtoNepal: folds 
scaihaze: folds 
cap. marb: folds 
bigacsiga: raises $1 to $2
matiko09: raises $7 to $9
Ilov3NBA: folds 
bigacsiga: folds 
Uncalled bet ($7) returned to matiko09
matiko09 collected $5 from pot
matiko09: doesn't show hand 
*** SUMMARY ***
Total pot $5 | Rake $0 
Seat 1: cap. marb folded before Flop (didn't bet)
Seat 2: bigacsiga (button) folded before Flop
Seat 3: matiko09 (small blind) collected ($5)
Seat 4: Ilov3NBA (big blind) folded before Flop
Seat 6: hurtNCYDE folded before Flop (didn't bet)
Seat 7: ApkawaDavit folded before Flop (didn't bet)
Seat 8: RoadtoNepal folded before Flop (didn't bet)
Seat 9: scaihaze folded before Flop (didn't bet)





PokerStars Hand #152662846623:  Hold'em No Limit ($0.50/$1.00 USD) - 2016/04/30 18:46:17 CET [2016/04/30 12:46:17 ET]
Table 'Selinur II' 9-max Seat #9 is the button
Seat 2: matiko09 ($100 in chips) 
Seat 3: HITYESCA ($100 in chips) 
Seat 4: cap. marb ($38.50 in chips) 
Seat 5: qwertzuiopüß ($61.34 in chips) 
Seat 6: Daniel Daffe ($61.32 in chips) 
Seat 8: Pacifistas ($103.65 in chips) 
Seat 9: Spid1 ($100 in chips) 
matiko09: posts small blind $0.50
HITYESCA: posts big blind $1
*** HOLE CARDS ***
Dealt to matiko09 [9h 5s]
cap. marb: folds 
hurtNCYDE joins the table at seat #1 
hurtNCYDE leaves the table
I The King I joins the table at seat #1 
I The King I leaves the table
Bimaxa joins the table at seat #1 
qwertzuiopüß: calls $1
Daniel Daffe: folds 
Pacifistas: folds 
Spid1: folds 
matiko09: folds 
HITYESCA: checks 
*** FLOP *** [Ks 9c Jc]
HITYESCA: checks 
qwertzuiopüß: checks 
*** TURN *** [Ks 9c Jc] [Jh]
HITYESCA: checks 
qwertzuiopüß: checks 
*** RIVER *** [Ks 9c Jc Jh] [Jd]
JACQUILF leaves the table
WrongButton joins the table at seat #7 
HITYESCA: checks 
qwertzuiopüß: checks 
*** SHOW DOWN ***
HITYESCA: shows [5h 6h] (three of a kind, Jacks)
qwertzuiopüß: shows [Td 9d] (a full house, Jacks full of Nines)
qwertzuiopüß collected $2.38 from pot
*** SUMMARY ***
Total pot $2.50 | Rake $0.12 
Board [Ks 9c Jc Jh Jd]
Seat 2: matiko09 (small blind) folded before Flop
Seat 3: HITYESCA (big blind) showed [5h 6h] and lost with three of a kind, Jacks
Seat 4: cap. marb folded before Flop (didn't bet)
Seat 5: qwertzuiopüß showed [Td 9d] and won ($2.38) with a full house, Jacks full of Nines
Seat 6: Daniel Daffe folded before Flop (didn't bet)
Seat 8: Pacifistas folded before Flop (didn't bet)
Seat 9: Spid1 (button) folded before Flop (didn't bet)





PokerStars Hand #152662852559:  Hold'em No Limit ($0.50/$1.00 USD) - 2016/04/30 18:46:25 CET [2016/04/30 12:46:25 ET]
Table 'Ruvuma' 9-max Seat #5 is the button
Seat 1: Ilov3NBA ($104.88 in chips) 
Seat 2: Spid1 ($121.82 in chips) 
Seat 3: OneTwo81 ($94.72 in chips) 
Seat 4: splicanin1 ($97.93 in chips) 
Seat 5: 1CANSEEY0U ($21.07 in chips) 
Seat 6: Pacifistas ($100 in chips) 
Seat 7: matiko09 ($100 in chips) 
Seat 8: Bailey Dew ($141.10 in chips) 
Seat 9: ApkawaDavit ($146.58 in chips) 
Pacifistas: posts small blind $0.50
matiko09: posts big blind $1
*** HOLE CARDS ***
Dealt to matiko09 [Js Qc]
Bailey Dew: folds 
ApkawaDavit: folds 
Ilov3NBA: folds 
Spid1: folds 
OneTwo81: folds 
splicanin1: calls $1
1CANSEEY0U: folds 
Pacifistas: calls $0.50
matiko09: raises $3 to $4
splicanin1: calls $3
Pacifistas: folds 
*** FLOP *** [Kh 7h Td]
matiko09: bets $5.50
splicanin1: calls $5.50
*** TURN *** [Kh 7h Td] [7c]
matiko09: checks 
splicanin1: bets $15
matiko09: folds 
Uncalled bet ($15) returned to splicanin1
splicanin1 collected $19 from pot
splicanin1: doesn't show hand 
*** SUMMARY ***
Total pot $20 | Rake $1 
Board [Kh 7h Td 7c]
Seat 1: Ilov3NBA folded before Flop (didn't bet)
Seat 2: Spid1 folded before Flop (didn't bet)
Seat 3: OneTwo81 folded before Flop (didn't bet)
Seat 4: splicanin1 collected ($19)
Seat 5: 1CANSEEY0U (button) folded before Flop (didn't bet)
Seat 6: Pacifistas (small blind) folded before Flop
Seat 7: matiko09 (big blind) folded on the Turn
Seat 8: Bailey Dew folded before Flop (didn't bet)
Seat 9: ApkawaDavit folded before Flop (didn't bet)





PokerStars Hand #152662871408:  Hold'em No Limit ($0.50/$1.00 USD) - 2016/04/30 18:46:48 CET [2016/04/30 12:46:48 ET]
Table 'Kalliope II' 9-max Seat #3 is the button
Seat 1: cap. marb ($40 in chips) 
Seat 2: bigacsiga ($148.28 in chips) 
Seat 3: matiko09 ($114.36 in chips) 
Seat 4: Ilov3NBA ($119.42 in chips) 
Seat 6: hurtNCYDE ($106.46 in chips) 
Seat 7: ApkawaDavit ($159.43 in chips) 
Seat 8: RoadtoNepal ($118.23 in chips) 
Seat 9: scaihaze ($118.92 in chips) 
Ilov3NBA: posts small blind $0.50
hurtNCYDE: posts big blind $1
*** HOLE CARDS ***
Dealt to matiko09 [Kd Ah]
ApkawaDavit: folds 
RoadtoNepal: folds 
scaihaze: folds 
cap. marb: folds 
bigacsiga: folds 
matiko09: raises $1.27 to $2.27
Ilov3NBA: folds 
hurtNCYDE: folds 
Uncalled bet ($1.27) returned to matiko09
matiko09 collected $2.50 from pot
matiko09: doesn't show hand 
*** SUMMARY ***
Total pot $2.50 | Rake $0 
Seat 1: cap. marb folded before Flop (didn't bet)
Seat 2: bigacsiga folded before Flop (didn't bet)
Seat 3: matiko09 (button) collected ($2.50)
Seat 4: Ilov3NBA (small blind) folded before Flop
Seat 6: hurtNCYDE (big blind) folded before Flop
Seat 7: ApkawaDavit folded before Flop (didn't bet)
Seat 8: RoadtoNepal folded before Flop (didn't bet)
Seat 9: scaihaze folded before Flop (didn't bet)





PokerStars Hand #152662881160:  Hold'em No Limit ($0.50/$1.00 USD) - 2016/04/30 18:47:01 CET [2016/04/30 12:47:01 ET]
Table 'Dagmar' 9-max Seat #9 is the button
Seat 1: matiko09 ($194 in chips) 
Seat 2: Spid1 ($190.78 in chips) 
Seat 3: ApkawaDavit ($115.85 in chips) 
Seat 4: RoadtoNepal ($100 in chips) 
Seat 5: cap. marb ($45.52 in chips) 
Seat 6: arctur17 ($152.82 in chips) 
Seat 7: kswmh ($74.98 in chips) 
Seat 8: Ilov3NBA ($142.98 in chips) 
Seat 9: okkernoot111 ($84.35 in chips) 
matiko09: posts small blind $0.50
Spid1: posts big blind $1
*** HOLE CARDS ***
Dealt to matiko09 [7s As]
ApkawaDavit: folds 
RoadtoNepal: folds 
cap. marb: folds 
arctur17: folds 
kswmh: folds 
Ilov3NBA: raises $1.50 to $2.50
okkernoot111: calls $2.50
matiko09: folds 
Spid1: folds 
*** FLOP *** [4c 4h Kd]
Ilov3NBA: bets $3.39
okkernoot111: calls $3.39
*** TURN *** [4c 4h Kd] [3s]
Ilov3NBA: checks 
okkernoot111: checks 
*** RIVER *** [4c 4h Kd 3s] [3c]
Ilov3NBA: checks 
okkernoot111: bets $6.31
Ilov3NBA: folds 
Uncalled bet ($6.31) returned to okkernoot111
okkernoot111 collected $12.62 from pot
*** SUMMARY ***
Total pot $13.28 | Rake $0.66 
Board [4c 4h Kd 3s 3c]
Seat 1: matiko09 (small blind) folded before Flop
Seat 2: Spid1 (big blind) folded before Flop
Seat 3: ApkawaDavit folded before Flop (didn't bet)
Seat 4: RoadtoNepal folded before Flop (didn't bet)
Seat 5: cap. marb folded before Flop (didn't bet)
Seat 6: arctur17 folded before Flop (didn't bet)
Seat 7: kswmh folded before Flop (didn't bet)
Seat 8: Ilov3NBA folded on the River
Seat 9: okkernoot111 (button) collected ($12.62)





PokerStars Hand #152662880978:  Hold'em No Limit ($0.50/$1.00 USD) - 2016/04/30 18:47:01 CET [2016/04/30 12:47:01 ET]
Table 'Lova II' 9-max Seat #3 is the button
Seat 2: bilukm ($310.59 in chips) 
Seat 3: matiko09 ($103.37 in chips) 
Seat 4: VanDobeln ($125.35 in chips) 
Seat 5: Ilov3NBA ($158.01 in chips) 
Seat 6: HITYESCA ($100 in chips) 
Seat 7: Szevasztopol ($105.32 in chips) 
Seat 8: cap. marb ($59.89 in chips) 
Seat 9: IseeUcards ($100 in chips) 
VanDobeln: posts small blind $0.50
Ilov3NBA: posts big blind $1
pelikan1968: sits out 
*** HOLE CARDS ***
Dealt to matiko09 [5c 6s]
HITYESCA: folds 
Szevasztopol: folds 
cap. marb: folds 
IseeUcards: folds 
bilukm: folds 
matiko09: folds 
VanDobeln: calls $0.50
Ilov3NBA: checks 
*** FLOP *** [3h 9h Jc]
VanDobeln: bets $2
Ilov3NBA: folds 
Uncalled bet ($2) returned to VanDobeln
VanDobeln collected $1.90 from pot
VanDobeln: doesn't show hand 
*** SUMMARY ***
Total pot $2 | Rake $0.10 
Board [3h 9h Jc]
Seat 2: bilukm folded before Flop (didn't bet)
Seat 3: matiko09 (button) folded before Flop (didn't bet)
Seat 4: VanDobeln (small blind) collected ($1.90)
Seat 5: Ilov3NBA (big blind) folded on the Flop
Seat 6: HITYESCA folded before Flop (didn't bet)
Seat 7: Szevasztopol folded before Flop (didn't bet)
Seat 8: cap. marb folded before Flop (didn't bet)
Seat 9: IseeUcards folded before Flop (didn't bet)





PokerStars Hand #152662893841:  Hold'em No Limit ($0.50/$1.00 USD) - 2016/04/30 18:47:16 CET [2016/04/30 12:47:16 ET]
Table 'Selinur II' 9-max Seat #2 is the button
Seat 2: matiko09 ($100 in chips) 
Seat 3: HITYESCA ($100 in chips) 
Seat 4: cap. marb ($38.50 in chips) 
Seat 5: qwertzuiopüß ($62.72 in chips) 
Seat 6: Daniel Daffe ($61.32 in chips) 
Seat 8: Pacifistas ($103.65 in chips) 
Seat 9: Spid1 ($100 in chips) 
HITYESCA: posts small blind $0.50
cap. marb: posts big blind $1
WrongButton: sits out 
Bimaxa: sits out 
*** HOLE CARDS ***
Dealt to matiko09 [As Ad]
qwertzuiopüß: folds 
Daniel Daffe: folds 
Pacifistas: folds 
Spid1: folds 
matiko09: raises $1.27 to $2.27
HITYESCA: calls $1.77
cap. marb: folds 
*** FLOP *** [7s 8c 4c]
HITYESCA: checks 
matiko09: checks 
*** TURN *** [7s 8c 4c] [Ah]
HITYESCA: checks 
matiko09: bets $3.41
HITYESCA: folds 
Uncalled bet ($3.41) returned to matiko09
matiko09 collected $5.26 from pot
matiko09: doesn't show hand 
*** SUMMARY ***
Total pot $5.54 | Rake $0.28 
Board [7s 8c 4c Ah]
Seat 2: matiko09 (button) collected ($5.26)
Seat 3: HITYESCA (small blind) folded on the Turn
Seat 4: cap. marb (big blind) folded before Flop
Seat 5: qwertzuiopüß folded before Flop (didn't bet)
Seat 6: Daniel Daffe folded before Flop (didn't bet)
Seat 8: Pacifistas folded before Flop (didn't bet)
Seat 9: Spid1 folded before Flop (didn't bet)





PokerStars Hand #152662894497:  Hold'em No Limit ($0.50/$1.00 USD) - 2016/04/30 18:47:17 CET [2016/04/30 12:47:17 ET]
Table 'Hippasos' 9-max Seat #3 is the button
Seat 1: MRC63S ($77.40 in chips) 
Seat 2: matiko09 ($100 in chips) 
Seat 3: WrongButton ($101.49 in chips) 
Seat 4: Pacifistas ($100 in chips) 
Seat 5: boutabi ($143.53 in chips) 
Seat 6: JACQUILF ($105.02 in chips) 
Seat 7: ilaviiitech ($100 in chips) 
Seat 8: Spid1 ($100 in chips) 
Seat 9: ApkawaDavit ($100.12 in chips) 
Pacifistas: posts small blind $0.50
boutabi: posts big blind $1
*** HOLE CARDS ***
Dealt to matiko09 [Jc 8d]
JACQUILF: folds 
ilaviiitech: folds 
Spid1: raises $2 to $3
ApkawaDavit: folds 
MRC63S: folds 
matiko09: folds 
WrongButton: folds 
Pacifistas: calls $2.50
boutabi: calls $2
*** FLOP *** [7d Ah 5c]
Pacifistas: checks 
boutabi: checks 
Spid1: checks 
*** TURN *** [7d Ah 5c] [8c]
Pacifistas: bets $5.50
boutabi: calls $5.50
Spid1: folds 
*** RIVER *** [7d Ah 5c 8c] [7h]
Pacifistas: checks 
boutabi: bets $27
Pacifistas: folds 
Uncalled bet ($27) returned to boutabi
boutabi collected $19 from pot
*** SUMMARY ***
Total pot $20 | Rake $1 
Board [7d Ah 5c 8c 7h]
Seat 1: MRC63S folded before Flop (didn't bet)
Seat 2: matiko09 folded before Flop (didn't bet)
Seat 3: WrongButton (button) folded before Flop (didn't bet)
Seat 4: Pacifistas (small blind) folded on the River
Seat 5: boutabi (big blind) collected ($19)
Seat 6: JACQUILF folded before Flop (didn't bet)
Seat 7: ilaviiitech folded before Flop (didn't bet)
Seat 8: Spid1 folded on the Turn
Seat 9: ApkawaDavit folded before Flop (didn't bet)





PokerStars Hand #152662897598:  Hold'em No Limit ($0.50/$1.00 USD) - 2016/04/30 18:47:21 CET [2016/04/30 12:47:21 ET]
Table 'Ruvuma' 9-max Seat #6 is the button
Seat 1: Ilov3NBA ($104.88 in chips) 
Seat 2: Spid1 ($121.82 in chips) 
Seat 3: OneTwo81 ($94.72 in chips) 
Seat 4: splicanin1 ($107.43 in chips) 
Seat 5: 1CANSEEY0U ($21.07 in chips) 
Seat 6: Pacifistas ($100 in chips) 
Seat 7: matiko09 ($100 in chips) 
Seat 8: Bailey Dew ($141.10 in chips) 
Seat 9: ApkawaDavit ($146.58 in chips) 
matiko09: posts small blind $0.50
Bailey Dew: posts big blind $1
*** HOLE CARDS ***
Dealt to matiko09 [5h 3h]
ApkawaDavit: folds 
Ilov3NBA: raises $2 to $3
Spid1: folds 
OneTwo81: folds 
splicanin1: calls $3
1CANSEEY0U: calls $3
Pacifistas: folds 
matiko09: folds 
Bailey Dew: folds 
*** FLOP *** [2c Qd 5s]
Ilov3NBA: bets $5.48
splicanin1: folds 
1CANSEEY0U: calls $5.48
*** TURN *** [2c Qd 5s] [7s]
Ilov3NBA: bets $8
1CANSEEY0U: folds 
Uncalled bet ($8) returned to Ilov3NBA
Ilov3NBA collected $20.39 from pot
Ilov3NBA: doesn't show hand 
*** SUMMARY ***
Total pot $21.46 | Rake $1.07 
Board [2c Qd 5s 7s]
Seat 1: Ilov3NBA collected ($20.39)
Seat 2: Spid1 folded before Flop (didn't bet)
Seat 3: OneTwo81 folded before Flop (didn't bet)
Seat 4: splicanin1 folded on the Flop
Seat 5: 1CANSEEY0U folded on the Turn
Seat 6: Pacifistas (button) folded before Flop (didn't bet)
Seat 7: matiko09 (small blind) folded before Flop
Seat 8: Bailey Dew (big blind) folded before Flop
Seat 9: ApkawaDavit folded before Flop (didn't bet)





PokerStars Hand #152662903012:  Hold'em No Limit ($0.50/$1.00 USD) - 2016/04/30 18:47:27 CET [2016/04/30 12:47:27 ET]
Table 'Kalliope II' 9-max Seat #4 is the button
Seat 1: cap. marb ($40 in chips) 
Seat 2: bigacsiga ($148.28 in chips) 
Seat 3: matiko09 ($115.86 in chips) 
Seat 4: Ilov3NBA ($118.92 in chips) 
Seat 6: hurtNCYDE ($105.46 in chips) 
Seat 7: ApkawaDavit ($159.43 in chips) 
Seat 8: RoadtoNepal ($118.23 in chips) 
Seat 9: scaihaze ($118.92 in chips) 
hurtNCYDE: posts small blind $0.50
ApkawaDavit: posts big blind $1
*** HOLE CARDS ***
Dealt to matiko09 [5s Ac]
RoadtoNepal: folds 
scaihaze: raises $2 to $3
cap. marb: folds 
bigacsiga: folds 
matiko09: folds 
Ilov3NBA: folds 
hurtNCYDE: folds 
ApkawaDavit: folds 
Uncalled bet ($2) returned to scaihaze
scaihaze collected $2.50 from pot
scaihaze: doesn't show hand 
*** SUMMARY ***
Total pot $2.50 | Rake $0 
Seat 1: cap. marb folded before Flop (didn't bet)
Seat 2: bigacsiga folded before Flop (didn't bet)
Seat 3: matiko09 folded before Flop (didn't bet)
Seat 4: Ilov3NBA (button) folded before Flop (didn't bet)
Seat 6: hurtNCYDE (small blind) folded before Flop
Seat 7: ApkawaDavit (big blind) folded before Flop
Seat 8: RoadtoNepal folded before Flop (didn't bet)
Seat 9: scaihaze collected ($2.50)





PokerStars Hand #152662923694:  Hold'em No Limit ($0.50/$1.00 USD) - 2016/04/30 18:47:53 CET [2016/04/30 12:47:53 ET]
Table 'Lova II' 9-max Seat #4 is the button
Seat 2: bilukm ($310.59 in chips) 
Seat 3: matiko09 ($103.37 in chips) 
Seat 4: VanDobeln ($126.25 in chips) 
Seat 5: Ilov3NBA ($157.01 in chips) 
Seat 6: HITYESCA ($100 in chips) 
Seat 7: Szevasztopol ($105.32 in chips) 
Seat 8: cap. marb ($59.89 in chips) 
Seat 9: IseeUcards ($100 in chips) 
Ilov3NBA: posts small blind $0.50
HITYESCA: posts big blind $1
pelikan1968: sits out 
*** HOLE CARDS ***
Dealt to matiko09 [9c Ad]
Szevasztopol: folds 
cap. marb: folds 
IseeUcards: folds 
bilukm: raises $1 to $2
matiko09: folds 
VanDobeln: folds 
Ilov3NBA: folds 
HITYESCA: folds 
Uncalled bet ($1) returned to bilukm
bilukm collected $2.50 from pot
bilukm: doesn't show hand 
*** SUMMARY ***
Total pot $2.50 | Rake $0 
Seat 2: bilukm collected ($2.50)
Seat 3: matiko09 folded before Flop (didn't bet)
Seat 4: VanDobeln (button) folded before Flop (didn't bet)
Seat 5: Ilov3NBA (small blind) folded before Flop
Seat 6: HITYESCA (big blind) folded before Flop
Seat 7: Szevasztopol folded before Flop (didn't bet)
Seat 8: cap. marb folded before Flop (didn't bet)
Seat 9: IseeUcards folded before Flop (didn't bet)





PokerStars Hand #152662932724:  Hold'em No Limit ($0.50/$1.00 USD) - 2016/04/30 18:48:05 CET [2016/04/30 12:48:05 ET]
Table 'Kalliope II' 9-max Seat #6 is the button
Seat 1: cap. marb ($40 in chips) 
Seat 2: bigacsiga ($148.28 in chips) 
Seat 3: matiko09 ($115.86 in chips) 
Seat 4: Ilov3NBA ($118.92 in chips) 
Seat 6: hurtNCYDE ($104.96 in chips) 
Seat 7: ApkawaDavit ($158.43 in chips) 
Seat 8: RoadtoNepal ($118.23 in chips) 
Seat 9: scaihaze ($120.42 in chips) 
ApkawaDavit: posts small blind $0.50
RoadtoNepal: posts big blind $1
*** HOLE CARDS ***
Dealt to matiko09 [Th Jc]
scaihaze: folds 
cap. marb: folds 
bigacsiga: folds 
matiko09: folds 
Ilov3NBA: raises $1.50 to $2.50
hurtNCYDE: raises $5.50 to $8
ApkawaDavit: folds 
RoadtoNepal: folds 
Ilov3NBA: raises $12 to $20
hurtNCYDE: folds 
Uncalled bet ($12) returned to Ilov3NBA
Ilov3NBA collected $17.50 from pot
Ilov3NBA: doesn't show hand 
*** SUMMARY ***
Total pot $17.50 | Rake $0 
Seat 1: cap. marb folded before Flop (didn't bet)
Seat 2: bigacsiga folded before Flop (didn't bet)
Seat 3: matiko09 folded before Flop (didn't bet)
Seat 4: Ilov3NBA collected ($17.50)
Seat 6: hurtNCYDE (button) folded before Flop
Seat 7: ApkawaDavit (small blind) folded before Flop
Seat 8: RoadtoNepal (big blind) folded before Flop
Seat 9: scaihaze folded before Flop (didn't bet)





PokerStars Hand #152662933109:  Hold'em No Limit ($0.50/$1.00 USD) - 2016/04/30 18:48:05 CET [2016/04/30 12:48:05 ET]
Table 'Selinur II' 9-max Seat #3 is the button
Seat 2: matiko09 ($102.99 in chips) 
Seat 3: HITYESCA ($100 in chips) 
Seat 4: cap. marb ($37.50 in chips) 
Seat 5: qwertzuiopüß ($62.72 in chips) 
Seat 6: Daniel Daffe ($61.32 in chips) 
Seat 8: Pacifistas ($103.65 in chips) 
Seat 9: Spid1 ($100 in chips) 
cap. marb: posts small blind $0.50
qwertzuiopüß: posts big blind $1
WrongButton: sits out 
Bimaxa: sits out 
*** HOLE CARDS ***
Dealt to matiko09 [5c 2d]
Daniel Daffe: calls $1
Pacifistas: folds 
Spid1: raises $4 to $5
matiko09: folds 
HITYESCA: folds 
cap. marb: folds 
qwertzuiopüß: folds 
Daniel Daffe: calls $4
*** FLOP *** [7h Tc 3h]
Daniel Daffe: checks 
Spid1: bets $6.50
Daniel Daffe: folds 
Uncalled bet ($6.50) returned to Spid1
Spid1 collected $10.92 from pot
Spid1: doesn't show hand 
*** SUMMARY ***
Total pot $11.50 | Rake $0.58 
Board [7h Tc 3h]
Seat 2: matiko09 folded before Flop (didn't bet)
Seat 3: HITYESCA (button) folded before Flop (didn't bet)
Seat 4: cap. marb (small blind) folded before Flop
Seat 5: qwertzuiopüß (big blind) folded before Flop
Seat 6: Daniel Daffe folded on the Flop
Seat 8: Pacifistas folded before Flop (didn't bet)
Seat 9: Spid1 collected ($10.92)





PokerStars Hand #152662948801:  Hold'em No Limit ($0.50/$1.00 USD) - 2016/04/30 18:48:25 CET [2016/04/30 12:48:25 ET]
Table 'Lova II' 9-max Seat #5 is the button
Seat 2: bilukm ($312.09 in chips) 
Seat 3: matiko09 ($103.37 in chips) 
Seat 4: VanDobeln ($126.25 in chips) 
Seat 5: Ilov3NBA ($156.51 in chips) 
Seat 6: HITYESCA ($100 in chips) 
Seat 7: Szevasztopol ($105.32 in chips) 
Seat 8: cap. marb ($59.89 in chips) 
Seat 9: IseeUcards ($100 in chips) 
HITYESCA: posts small blind $0.50
Szevasztopol: posts big blind $1
pelikan1968: sits out 
*** HOLE CARDS ***
Dealt to matiko09 [9d 8s]
cap. marb: raises $1.12 to $2.12
IseeUcards: folds 
bilukm: folds 
matiko09: folds 
VanDobeln: folds 
Ilov3NBA: folds 
HITYESCA: folds 
Szevasztopol: folds 
Uncalled bet ($1.12) returned to cap. marb
cap. marb collected $2.50 from pot
cap. marb: doesn't show hand 
*** SUMMARY ***
Total pot $2.50 | Rake $0 
Seat 2: bilukm folded before Flop (didn't bet)
Seat 3: matiko09 folded before Flop (didn't bet)
Seat 4: VanDobeln folded before Flop (didn't bet)
Seat 5: Ilov3NBA (button) folded before Flop (didn't bet)
Seat 6: HITYESCA (small blind) folded before Flop
Seat 7: Szevasztopol (big blind) folded before Flop
Seat 8: cap. marb collected ($2.50)
Seat 9: IseeUcards folded before Flop (didn't bet)





PokerStars Hand #152662956878:  Hold'em No Limit ($0.50/$1.00 USD) - 2016/04/30 18:48:34 CET [2016/04/30 12:48:34 ET]
Table 'Ruvuma' 9-max Seat #7 is the button
Seat 1: Ilov3NBA ($116.79 in chips) 
Seat 2: Spid1 ($121.82 in chips) 
Seat 3: OneTwo81 ($94.72 in chips) 
Seat 4: splicanin1 ($104.43 in chips) 
Seat 5: 1CANSEEY0U ($12.59 in chips) 
Seat 6: Pacifistas ($100 in chips) 
Seat 7: matiko09 ($100 in chips) 
Seat 8: Bailey Dew ($140.10 in chips) 
Seat 9: ApkawaDavit ($146.58 in chips) 
Bailey Dew: posts small blind $0.50
ApkawaDavit: posts big blind $1
*** HOLE CARDS ***
Dealt to matiko09 [9h 6d]
Ilov3NBA: folds 
Spid1: folds 
OneTwo81: calls $1
splicanin1: folds 
1CANSEEY0U: folds 
1CANSEEY0U leaves the table
hurtNCYDE joins the table at seat #5 
Pacifistas: folds 
matiko09: folds 
Bailey Dew: folds 
ApkawaDavit: checks 
*** FLOP *** [3s Qc 6s]
ApkawaDavit: checks 
OneTwo81: checks 
*** TURN *** [3s Qc 6s] [4s]
ApkawaDavit: checks 
OneTwo81: bets $2
ApkawaDavit: calls $2
*** RIVER *** [3s Qc 6s 4s] [Ad]
ApkawaDavit: checks 
OneTwo81: bets $6
ApkawaDavit: folds 
Uncalled bet ($6) returned to OneTwo81
OneTwo81 collected $6.18 from pot
OneTwo81: doesn't show hand 
*** SUMMARY ***
Total pot $6.50 | Rake $0.32 
Board [3s Qc 6s 4s Ad]
Seat 1: Ilov3NBA folded before Flop (didn't bet)
Seat 2: Spid1 folded before Flop (didn't bet)
Seat 3: OneTwo81 collected ($6.18)
Seat 4: splicanin1 folded before Flop (didn't bet)
Seat 5: 1CANSEEY0U folded before Flop (didn't bet)
Seat 6: Pacifistas folded before Flop (didn't bet)
Seat 7: matiko09 (button) folded before Flop (didn't bet)
Seat 8: Bailey Dew (small blind) folded before Flop
Seat 9: ApkawaDavit (big blind) folded on the River





PokerStars Hand #152662958904:  Hold'em No Limit ($0.50/$1.00 USD) - 2016/04/30 18:48:37 CET [2016/04/30 12:48:37 ET]
Table 'Dagmar' 9-max Seat #1 is the button
Seat 1: matiko09 ($193.50 in chips) 
Seat 2: Spid1 ($189.78 in chips) 
Seat 3: ApkawaDavit ($115.85 in chips) 
Seat 4: RoadtoNepal ($100 in chips) 
Seat 5: cap. marb ($45.52 in chips) 
Seat 6: arctur17 ($152.82 in chips) 
Seat 7: kswmh ($74.98 in chips) 
Seat 8: Ilov3NBA ($137.09 in chips) 
Seat 9: okkernoot111 ($91.08 in chips) 
Spid1: posts small blind $0.50
ApkawaDavit: posts big blind $1
*** HOLE CARDS ***
Dealt to matiko09 [Js 8s]
RoadtoNepal: folds 
cap. marb: folds 
arctur17: folds 
kswmh: raises $1 to $2
Ilov3NBA: raises $4 to $6
okkernoot111: folds 
matiko09: folds 
Spid1: folds 
ApkawaDavit: folds 
kswmh: calls $4
*** FLOP *** [Qs 5h Qd]
kswmh: bets $1
Ilov3NBA: raises $6 to $7
kswmh: calls $6
*** TURN *** [Qs 5h Qd] [Kh]
kswmh: bets $1
Ilov3NBA: calls $1
*** RIVER *** [Qs 5h Qd Kh] [Th]
kswmh: bets $1
Ilov3NBA: raises $3.50 to $4.50
kswmh: calls $3.50
*** SHOW DOWN ***
Ilov3NBA: shows [Kd Jd] (two pair, Kings and Queens)
kswmh: shows [Tc Td] (a full house, Tens full of Queens)
kswmh collected $36.58 from pot
*** SUMMARY ***
Total pot $38.50 | Rake $1.92 
Board [Qs 5h Qd Kh Th]
Seat 1: matiko09 (button) folded before Flop (didn't bet)
Seat 2: Spid1 (small blind) folded before Flop
Seat 3: ApkawaDavit (big blind) folded before Flop
Seat 4: RoadtoNepal folded before Flop (didn't bet)
Seat 5: cap. marb folded before Flop (didn't bet)
Seat 6: arctur17 folded before Flop (didn't bet)
Seat 7: kswmh showed [Tc Td] and won ($36.58) with a full house, Tens full of Queens
Seat 8: Ilov3NBA showed [Kd Jd] and lost with two pair, Kings and Queens
Seat 9: okkernoot111 folded before Flop (didn't bet)





PokerStars Hand #152662967093:  Hold'em No Limit ($0.50/$1.00 USD) - 2016/04/30 18:48:47 CET [2016/04/30 12:48:47 ET]
Table 'Selinur II' 9-max Seat #4 is the button
Seat 2: matiko09 ($102.99 in chips) 
Seat 3: HITYESCA ($100 in chips) 
Seat 4: cap. marb ($37 in chips) 
Seat 5: qwertzuiopüß ($61.72 in chips) 
Seat 6: Daniel Daffe ($56.32 in chips) 
Seat 8: Pacifistas ($103.65 in chips) 
Seat 9: Spid1 ($105.92 in chips) 
qwertzuiopüß: posts small blind $0.50
Daniel Daffe: posts big blind $1
WrongButton: sits out 
Bimaxa: sits out 
*** HOLE CARDS ***
Dealt to matiko09 [4s 6c]
Pacifistas: folds 
Spid1: folds 
matiko09: folds 
HITYESCA: raises $1.50 to $2.50
cap. marb: folds 
qwertzuiopüß: folds 
Daniel Daffe: calls $1.50
*** FLOP *** [7s Ts 9c]
Daniel Daffe: bets $5.22
HITYESCA: calls $5.22
*** TURN *** [7s Ts 9c] [Td]
Daniel Daffe: bets $15.14
HITYESCA: raises $77.14 to $92.28 and is all-in
Daniel Daffe: folds 
Uncalled bet ($77.14) returned to HITYESCA
HITYESCA collected $43.91 from pot
HITYESCA: doesn't show hand 
*** SUMMARY ***
Total pot $46.22 | Rake $2.31 
Board [7s Ts 9c Td]
Seat 2: matiko09 folded before Flop (didn't bet)
Seat 3: HITYESCA collected ($43.91)
Seat 4: cap. marb (button) folded before Flop (didn't bet)
Seat 5: qwertzuiopüß (small blind) folded before Flop
Seat 6: Daniel Daffe (big blind) folded on the Turn
Seat 8: Pacifistas folded before Flop (didn't bet)
Seat 9: Spid1 folded before Flop (didn't bet)





PokerStars Hand #152662979918:  Hold'em No Limit ($0.50/$1.00 USD) - 2016/04/30 18:49:03 CET [2016/04/30 12:49:03 ET]
Table 'Lova II' 9-max Seat #6 is the button
Seat 2: bilukm ($312.09 in chips) 
Seat 3: matiko09 ($103.37 in chips) 
Seat 4: VanDobeln ($126.25 in chips) 
Seat 5: Ilov3NBA ($156.51 in chips) 
Seat 6: HITYESCA ($100 in chips) 
Seat 7: Szevasztopol ($104.32 in chips) 
Seat 8: cap. marb ($61.39 in chips) 
Seat 9: IseeUcards ($100 in chips) 
Szevasztopol: posts small blind $0.50
cap. marb: posts big blind $1
pelikan1968: sits out 
*** HOLE CARDS ***
Dealt to matiko09 [3c Jd]
IseeUcards: folds 
bilukm: folds 
matiko09: folds 
VanDobeln: folds 
Ilov3NBA: folds 
HITYESCA: folds 
Szevasztopol: folds 
Uncalled bet ($0.50) returned to cap. marb
cap. marb collected $1 from pot
cap. marb: doesn't show hand 
*** SUMMARY ***
Total pot $1 | Rake $0 
Seat 2: bilukm folded before Flop (didn't bet)
Seat 3: matiko09 folded before Flop (didn't bet)
Seat 4: VanDobeln folded before Flop (didn't bet)
Seat 5: Ilov3NBA folded before Flop (didn't bet)
Seat 6: HITYESCA (button) folded before Flop (didn't bet)
Seat 7: Szevasztopol (small blind) folded before Flop
Seat 8: cap. marb (big blind) collected ($1)
Seat 9: IseeUcards folded before Flop (didn't bet)





PokerStars Hand #152662991057:  Hold'em No Limit ($0.50/$1.00 USD) - 2016/04/30 18:49:16 CET [2016/04/30 12:49:16 ET]
Table 'Hippasos' 9-max Seat #4 is the button
Seat 1: MRC63S ($77.40 in chips) 
Seat 2: matiko09 ($100 in chips) 
Seat 3: WrongButton ($101.49 in chips) 
Seat 4: Pacifistas ($100 in chips) 
Seat 5: boutabi ($154.03 in chips) 
Seat 6: JACQUILF ($105.02 in chips) 
Seat 7: ilaviiitech ($100 in chips) 
Seat 8: Spid1 ($100 in chips) 
Seat 9: ApkawaDavit ($100.12 in chips) 
boutabi: posts small blind $0.50
JACQUILF: posts big blind $1
*** HOLE CARDS ***
Dealt to matiko09 [Qh 5c]
ilaviiitech: folds 
Spid1: folds 
ApkawaDavit: folds 
MRC63S: calls $1
matiko09: folds 
WrongButton: folds 
Pacifistas: folds 
boutabi: raises $4 to $5
JACQUILF: calls $4
MRC63S: folds 
*** FLOP *** [Ah 3d Td]
boutabi: checks 
JACQUILF: bets $8.50
boutabi: calls $8.50
*** TURN *** [Ah 3d Td] [Tc]
boutabi: bets $17
JACQUILF: calls $17
*** RIVER *** [Ah 3d Td Tc] [8s]
boutabi: bets $9
JACQUILF: calls $9
*** SHOW DOWN ***
boutabi: shows [7h 2h] (a pair of Tens)
JACQUILF: shows [Qc As] (two pair, Aces and Tens)
JACQUILF collected $77.50 from pot
*** SUMMARY ***
Total pot $80 | Rake $2.50 
Board [Ah 3d Td Tc 8s]
Seat 1: MRC63S folded before Flop
Seat 2: matiko09 folded before Flop (didn't bet)
Seat 3: WrongButton folded before Flop (didn't bet)
Seat 4: Pacifistas (button) folded before Flop (didn't bet)
Seat 5: boutabi (small blind) showed [7h 2h] and lost with a pair of Tens
Seat 6: JACQUILF (big blind) showed [Qc As] and won ($77.50) with two pair, Aces and Tens
Seat 7: ilaviiitech folded before Flop (didn't bet)
Seat 8: Spid1 folded before Flop (didn't bet)
Seat 9: ApkawaDavit folded before Flop (didn't bet)





PokerStars Hand #152662994914:  Hold'em No Limit ($0.50/$1.00 USD) - 2016/04/30 18:49:21 CET [2016/04/30 12:49:21 ET]
Table 'Kalliope II' 9-max Seat #7 is the button
Seat 1: cap. marb ($40 in chips) 
Seat 2: bigacsiga ($148.28 in chips) 
Seat 3: matiko09 ($115.86 in chips) 
Seat 4: Ilov3NBA ($128.42 in chips) 
Seat 6: hurtNCYDE ($100 in chips) 
Seat 7: ApkawaDavit ($157.93 in chips) 
Seat 8: RoadtoNepal ($117.23 in chips) 
Seat 9: scaihaze ($120.42 in chips) 
RoadtoNepal: posts small blind $0.50
scaihaze: posts big blind $1
*** HOLE CARDS ***
Dealt to matiko09 [Ks 9h]
cap. marb: raises $1.12 to $2.12
bigacsiga: folds 
matiko09: folds 
Ilov3NBA: folds 
hurtNCYDE: folds 
ApkawaDavit: folds 
RoadtoNepal: folds 
scaihaze: folds 
Uncalled bet ($1.12) returned to cap. marb
cap. marb collected $2.50 from pot
cap. marb: doesn't show hand 
*** SUMMARY ***
Total pot $2.50 | Rake $0 
Seat 1: cap. marb collected ($2.50)
Seat 2: bigacsiga folded before Flop (didn't bet)
Seat 3: matiko09 folded before Flop (didn't bet)
Seat 4: Ilov3NBA folded before Flop (didn't bet)
Seat 6: hurtNCYDE folded before Flop (didn't bet)
Seat 7: ApkawaDavit (button) folded before Flop (didn't bet)
Seat 8: RoadtoNepal (small blind) folded before Flop
Seat 9: scaihaze (big blind) folded before Flop





PokerStars Hand #152663010028:  Hold'em No Limit ($0.50/$1.00 USD) - 2016/04/30 18:49:39 CET [2016/04/30 12:49:39 ET]
Table 'Lova II' 9-max Seat #7 is the button
Seat 2: bilukm ($312.09 in chips) 
Seat 3: matiko09 ($103.37 in chips) 
Seat 4: VanDobeln ($126.25 in chips) 
Seat 5: Ilov3NBA ($156.51 in chips) 
Seat 6: HITYESCA ($100 in chips) 
Seat 7: Szevasztopol ($103.82 in chips) 
Seat 8: cap. marb ($61.89 in chips) 
Seat 9: IseeUcards ($100 in chips) 
cap. marb: posts small blind $0.50
IseeUcards: posts big blind $1
pelikan1968: sits out 
*** HOLE CARDS ***
Dealt to matiko09 [Qs 2c]
bilukm: raises $1 to $2
matiko09: folds 
VanDobeln: folds 
Ilov3NBA: folds 
HITYESCA: folds 
Szevasztopol: folds 
cap. marb: folds 
IseeUcards: folds 
Uncalled bet ($1) returned to bilukm
bilukm collected $2.50 from pot
bilukm: doesn't show hand 
*** SUMMARY ***
Total pot $2.50 | Rake $0 
Seat 2: bilukm collected ($2.50)
Seat 3: matiko09 folded before Flop (didn't bet)
Seat 4: VanDobeln folded before Flop (didn't bet)
Seat 5: Ilov3NBA folded before Flop (didn't bet)
Seat 6: HITYESCA folded before Flop (didn't bet)
Seat 7: Szevasztopol (button) folded before Flop (didn't bet)
Seat 8: cap. marb (small blind) folded before Flop
Seat 9: IseeUcards (big blind) folded before Flop





PokerStars Hand #152663019288:  Hold'em No Limit ($0.50/$1.00 USD) - 2016/04/30 18:49:51 CET [2016/04/30 12:49:51 ET]
Table 'Dagmar' 9-max Seat #2 is the button
Seat 1: matiko09 ($193.50 in chips) 
Seat 2: Spid1 ($189.28 in chips) 
Seat 3: ApkawaDavit ($114.85 in chips) 
Seat 4: RoadtoNepal ($100 in chips) 
Seat 5: cap. marb ($45.52 in chips) 
Seat 6: arctur17 ($152.82 in chips) 
Seat 7: kswmh ($93.06 in chips) 
Seat 8: Ilov3NBA ($118.59 in chips) 
Seat 9: okkernoot111 ($91.08 in chips) 
ApkawaDavit: posts small blind $0.50
RoadtoNepal: posts big blind $1
*** HOLE CARDS ***
Dealt to matiko09 [8c Jc]
cap. marb: folds 
arctur17: folds 
kswmh: folds 
Ilov3NBA: folds 
okkernoot111: folds 
matiko09: folds 
Spid1: folds 
ApkawaDavit: folds 
Uncalled bet ($0.50) returned to RoadtoNepal
RoadtoNepal collected $1 from pot
RoadtoNepal: doesn't show hand 
*** SUMMARY ***
Total pot $1 | Rake $0 
Seat 1: matiko09 folded before Flop (didn't bet)
Seat 2: Spid1 (button) folded before Flop (didn't bet)
Seat 3: ApkawaDavit (small blind) folded before Flop
Seat 4: RoadtoNepal (big blind) collected ($1)
Seat 5: cap. marb folded before Flop (didn't bet)
Seat 6: arctur17 folded before Flop (didn't bet)
Seat 7: kswmh folded before Flop (didn't bet)
Seat 8: Ilov3NBA folded before Flop (didn't bet)
Seat 9: okkernoot111 folded before Flop (didn't bet)





PokerStars Hand #152663020345:  Hold'em No Limit ($0.50/$1.00 USD) - 2016/04/30 18:49:52 CET [2016/04/30 12:49:52 ET]
Table 'Ruvuma' 9-max Seat #8 is the button
Seat 1: Ilov3NBA ($116.79 in chips) 
Seat 2: Spid1 ($121.82 in chips) 
Seat 3: OneTwo81 ($97.90 in chips) 
Seat 4: splicanin1 ($104.43 in chips) 
Seat 6: Pacifistas ($100 in chips) 
Seat 7: matiko09 ($100 in chips) 
Seat 8: Bailey Dew ($139.60 in chips) 
Seat 9: ApkawaDavit ($143.58 in chips) 
ApkawaDavit: posts small blind $0.50
Ilov3NBA: posts big blind $1
hurtNCYDE: sits out 
*** HOLE CARDS ***
Dealt to matiko09 [2h 2d]
Spid1: folds 
OneTwo81: folds 
splicanin1: folds 
Pacifistas: folds 
matiko09: raises $1.50 to $2.50
Bailey Dew: folds 
ApkawaDavit: folds 
Ilov3NBA: folds 
Uncalled bet ($1.50) returned to matiko09
matiko09 collected $2.50 from pot
matiko09: doesn't show hand 
*** SUMMARY ***
Total pot $2.50 | Rake $0 
Seat 1: Ilov3NBA (big blind) folded before Flop
Seat 2: Spid1 folded before Flop (didn't bet)
Seat 3: OneTwo81 folded before Flop (didn't bet)
Seat 4: splicanin1 folded before Flop (didn't bet)
Seat 6: Pacifistas folded before Flop (didn't bet)
Seat 7: matiko09 collected ($2.50)
Seat 8: Bailey Dew (button) folded before Flop (didn't bet)
Seat 9: ApkawaDavit (small blind) folded before Flop





PokerStars Hand #152663044432:  Hold'em No Limit ($0.50/$1.00 USD) - 2016/04/30 18:50:22 CET [2016/04/30 12:50:22 ET]
Table 'Selinur II' 9-max Seat #5 is the button
Seat 2: matiko09 ($102.99 in chips) 
Seat 3: HITYESCA ($121.05 in chips) 
Seat 4: cap. marb ($37 in chips) 
Seat 5: qwertzuiopüß ($61.22 in chips) 
Seat 6: Daniel Daffe ($33.46 in chips) 
Seat 7: WrongButton ($100 in chips) 
Seat 8: Pacifistas ($103.65 in chips) 
Seat 9: Spid1 ($105.92 in chips) 
Daniel Daffe: posts small blind $0.50
WrongButton: posts big blind $1
Bimaxa: sits out 
*** HOLE CARDS ***
Dealt to matiko09 [8h Tc]
Pacifistas: folds 
Spid1: folds 
matiko09: folds 
HITYESCA: folds 
cap. marb: raises $1.12 to $2.12
qwertzuiopüß: folds 
Daniel Daffe: folds 
WrongButton: folds 
Uncalled bet ($1.12) returned to cap. marb
cap. marb collected $2.50 from pot
cap. marb: doesn't show hand 
*** SUMMARY ***
Total pot $2.50 | Rake $0 
Seat 2: matiko09 folded before Flop (didn't bet)
Seat 3: HITYESCA folded before Flop (didn't bet)
Seat 4: cap. marb collected ($2.50)
Seat 5: qwertzuiopüß (button) folded before Flop (didn't bet)
Seat 6: Daniel Daffe (small blind) folded before Flop
Seat 7: WrongButton (big blind) folded before Flop
Seat 8: Pacifistas folded before Flop (didn't bet)
Seat 9: Spid1 folded before Flop (didn't bet)





PokerStars Hand #152663047272:  Hold'em No Limit ($0.50/$1.00 USD) - 2016/04/30 18:50:25 CET [2016/04/30 12:50:25 ET]
Table 'Ruvuma' 9-max Seat #9 is the button
Seat 1: Ilov3NBA ($115.79 in chips) 
Seat 2: Spid1 ($121.82 in chips) 
Seat 3: OneTwo81 ($97.90 in chips) 
Seat 4: splicanin1 ($104.43 in chips) 
Seat 6: Pacifistas ($100 in chips) 
Seat 7: matiko09 ($101.50 in chips) 
Seat 8: Bailey Dew ($139.60 in chips) 
Seat 9: ApkawaDavit ($143.08 in chips) 
Ilov3NBA: posts small blind $0.50
Spid1: posts big blind $1
hurtNCYDE: sits out 
*** HOLE CARDS ***
Dealt to matiko09 [Tc 8d]
OneTwo81: folds 
splicanin1: folds 
Pacifistas: folds 
matiko09: folds 
Bailey Dew: raises $1.50 to $2.50
ApkawaDavit: folds 
Ilov3NBA: folds 
Spid1: folds 
Uncalled bet ($1.50) returned to Bailey Dew
Bailey Dew collected $2.50 from pot
Bailey Dew: doesn't show hand 
*** SUMMARY ***
Total pot $2.50 | Rake $0 
Seat 1: Ilov3NBA (small blind) folded before Flop
Seat 2: Spid1 (big blind) folded before Flop
Seat 3: OneTwo81 folded before Flop (didn't bet)
Seat 4: splicanin1 folded before Flop (didn't bet)
Seat 6: Pacifistas folded before Flop (didn't bet)
Seat 7: matiko09 folded before Flop (didn't bet)
Seat 8: Bailey Dew collected ($2.50)
Seat 9: ApkawaDavit (button) folded before Flop (didn't bet)





PokerStars Hand #152663050838:  Hold'em No Limit ($0.50/$1.00 USD) - 2016/04/30 18:50:30 CET [2016/04/30 12:50:30 ET]
Table 'Dagmar' 9-max Seat #3 is the button
Seat 1: matiko09 ($193.50 in chips) 
Seat 2: Spid1 ($189.28 in chips) 
Seat 3: ApkawaDavit ($114.35 in chips) 
Seat 4: RoadtoNepal ($100.50 in chips) 
Seat 5: cap. marb ($45.52 in chips) 
Seat 6: arctur17 ($152.82 in chips) 
Seat 7: kswmh ($93.06 in chips) 
Seat 8: Ilov3NBA ($118.59 in chips) 
Seat 9: okkernoot111 ($91.08 in chips) 
RoadtoNepal: posts small blind $0.50
cap. marb: posts big blind $1
*** HOLE CARDS ***
Dealt to matiko09 [6c 3c]
arctur17: raises $2 to $3
kswmh: folds 
Ilov3NBA: folds 
okkernoot111: folds 
matiko09: folds 
Spid1: folds 
ApkawaDavit: folds 
RoadtoNepal: folds 
cap. marb: folds 
Uncalled bet ($2) returned to arctur17
arctur17 collected $2.50 from pot
arctur17: doesn't show hand 
*** SUMMARY ***
Total pot $2.50 | Rake $0 
Seat 1: matiko09 folded before Flop (didn't bet)
Seat 2: Spid1 folded before Flop (didn't bet)
Seat 3: ApkawaDavit (button) folded before Flop (didn't bet)
Seat 4: RoadtoNepal (small blind) folded before Flop
Seat 5: cap. marb (big blind) folded before Flop
Seat 6: arctur17 collected ($2.50)
Seat 7: kswmh folded before Flop (didn't bet)
Seat 8: Ilov3NBA folded before Flop (didn't bet)
Seat 9: okkernoot111 folded before Flop (didn't bet)





PokerStars Hand #152663057170:  Hold'em No Limit ($0.50/$1.00 USD) - 2016/04/30 18:50:37 CET [2016/04/30 12:50:37 ET]
Table 'Lova II' 9-max Seat #8 is the button
Seat 1: pelikan1968 ($80 in chips) 
Seat 2: bilukm ($313.59 in chips) 
Seat 3: matiko09 ($103.37 in chips) 
Seat 4: VanDobeln ($126.25 in chips) 
Seat 5: Ilov3NBA ($156.51 in chips) 
Seat 6: HITYESCA ($100 in chips) 
Seat 7: Szevasztopol ($103.82 in chips) 
Seat 8: cap. marb ($61.39 in chips) 
Seat 9: IseeUcards ($100 in chips) 
IseeUcards: posts small blind $0.50
pelikan1968: posts big blind $1
*** HOLE CARDS ***
Dealt to matiko09 [Qc Ah]
bilukm: folds 
matiko09: raises $2 to $3
VanDobeln: folds 
Ilov3NBA: folds 
HITYESCA: calls $3
Szevasztopol: folds 
cap. marb: folds 
IseeUcards: folds 
pelikan1968: calls $2
*** FLOP *** [Kd 2s Jh]
pelikan1968: checks 
matiko09: checks 
HITYESCA: checks 
*** TURN *** [Kd 2s Jh] [Jd]
pelikan1968: checks 
matiko09: checks 
HITYESCA: checks 
*** RIVER *** [Kd 2s Jh Jd] [Tc]
pelikan1968: checks 
matiko09: bets $6
HITYESCA: folds 
pelikan1968: folds 
Uncalled bet ($6) returned to matiko09
matiko09 collected $9.02 from pot
matiko09: doesn't show hand 
*** SUMMARY ***
Total pot $9.50 | Rake $0.48 
Board [Kd 2s Jh Jd Tc]
Seat 1: pelikan1968 (big blind) folded on the River
Seat 2: bilukm folded before Flop (didn't bet)
Seat 3: matiko09 collected ($9.02)
Seat 4: VanDobeln folded before Flop (didn't bet)
Seat 5: Ilov3NBA folded before Flop (didn't bet)
Seat 6: HITYESCA folded on the River
Seat 7: Szevasztopol folded before Flop (didn't bet)
Seat 8: cap. marb (button) folded before Flop (didn't bet)
Seat 9: IseeUcards (small blind) folded before Flop





PokerStars Hand #152663065406:  Hold'em No Limit ($0.50/$1.00 USD) - 2016/04/30 18:50:47 CET [2016/04/30 12:50:47 ET]
Table 'Ruvuma' 9-max Seat #1 is the button
Seat 1: Ilov3NBA ($115.29 in chips) 
Seat 2: Spid1 ($120.82 in chips) 
Seat 3: OneTwo81 ($97.90 in chips) 
Seat 4: splicanin1 ($104.43 in chips) 
Seat 6: Pacifistas ($100 in chips) 
Seat 7: matiko09 ($101.50 in chips) 
Seat 8: Bailey Dew ($141.10 in chips) 
Seat 9: ApkawaDavit ($143.08 in chips) 
Spid1: posts small blind $0.50
OneTwo81: posts big blind $1
hurtNCYDE: sits out 
*** HOLE CARDS ***
Dealt to matiko09 [7d Qc]
splicanin1: calls $1
Pacifistas: raises $3 to $4
matiko09: folds 
Bailey Dew: folds 
ApkawaDavit: folds 
Ilov3NBA: folds 
Spid1: folds 
OneTwo81: folds 
splicanin1: calls $3
*** FLOP *** [4s 2h Td]
splicanin1: checks 
Pacifistas: bets $5
splicanin1: folds 
Uncalled bet ($5) returned to Pacifistas
Pacifistas collected $9.02 from pot
Pacifistas: doesn't show hand 
*** SUMMARY ***
Total pot $9.50 | Rake $0.48 
Board [4s 2h Td]
Seat 1: Ilov3NBA (button) folded before Flop (didn't bet)
Seat 2: Spid1 (small blind) folded before Flop
Seat 3: OneTwo81 (big blind) folded before Flop
Seat 4: splicanin1 folded on the Flop
Seat 6: Pacifistas collected ($9.02)
Seat 7: matiko09 folded before Flop (didn't bet)
Seat 8: Bailey Dew folded before Flop (didn't bet)
Seat 9: ApkawaDavit folded before Flop (didn't bet)





PokerStars Hand #152663065161:  Hold'em No Limit ($0.50/$1.00 USD) - 2016/04/30 18:50:47 CET [2016/04/30 12:50:47 ET]
Table 'Hippasos' 9-max Seat #5 is the button
Seat 1: MRC63S ($76.40 in chips) 
Seat 2: matiko09 ($100 in chips) 
Seat 3: WrongButton ($101.49 in chips) 
Seat 4: Pacifistas ($100 in chips) 
Seat 5: boutabi ($114.53 in chips) 
Seat 6: JACQUILF ($143.02 in chips) 
Seat 7: ilaviiitech ($100 in chips) 
Seat 8: Spid1 ($100 in chips) 
Seat 9: ApkawaDavit ($100.12 in chips) 
JACQUILF: posts small blind $0.50
ilaviiitech: posts big blind $1
*** HOLE CARDS ***
Dealt to matiko09 [9h Ts]
Spid1: folds 
ApkawaDavit: folds 
MRC63S: calls $1
matiko09: folds 
WrongButton: folds 
Pacifistas: raises $3 to $4
boutabi: calls $4
JACQUILF: raises $12 to $16
ilaviiitech: folds 
MRC63S: folds 
Pacifistas: folds 
boutabi: calls $12
*** FLOP *** [3c Qs 7c]
JACQUILF: checks 
boutabi: checks 
*** TURN *** [3c Qs 7c] [Tc]
JACQUILF: checks 
boutabi: bets $30
JACQUILF: folds 
Uncalled bet ($30) returned to boutabi
boutabi collected $36.10 from pot
boutabi: doesn't show hand 
*** SUMMARY ***
Total pot $38 | Rake $1.90 
Board [3c Qs 7c Tc]
Seat 1: MRC63S folded before Flop
Seat 2: matiko09 folded before Flop (didn't bet)
Seat 3: WrongButton folded before Flop (didn't bet)
Seat 4: Pacifistas folded before Flop
Seat 5: boutabi (button) collected ($36.10)
Seat 6: JACQUILF (small blind) folded on the Turn
Seat 7: ilaviiitech (big blind) folded before Flop
Seat 8: Spid1 folded before Flop (didn't bet)
Seat 9: ApkawaDavit folded before Flop (didn't bet)





PokerStars Hand #152663071293:  Hold'em No Limit ($0.50/$1.00 USD) - 2016/04/30 18:50:55 CET [2016/04/30 12:50:55 ET]
Table 'Selinur II' 9-max Seat #6 is the button
Seat 2: matiko09 ($102.99 in chips) 
Seat 3: HITYESCA ($121.05 in chips) 
Seat 4: cap. marb ($38.50 in chips) 
Seat 5: qwertzuiopüß ($61.22 in chips) 
Seat 6: Daniel Daffe ($32.96 in chips) 
Seat 7: WrongButton ($100 in chips) 
Seat 8: Pacifistas ($103.65 in chips) 
Seat 9: Spid1 ($105.92 in chips) 
WrongButton: posts small blind $0.50
Pacifistas: posts big blind $1
Bimaxa: sits out 
*** HOLE CARDS ***
Dealt to matiko09 [6d 4s]
Spid1: folds 
matiko09: folds 
HITYESCA: folds 
cap. marb: folds 
qwertzuiopüß: folds 
Daniel Daffe: folds 
WrongButton: folds 
Uncalled bet ($0.50) returned to Pacifistas
Pacifistas collected $1 from pot
Pacifistas: doesn't show hand 
*** SUMMARY ***
Total pot $1 | Rake $0 
Seat 2: matiko09 folded before Flop (didn't bet)
Seat 3: HITYESCA folded before Flop (didn't bet)
Seat 4: cap. marb folded before Flop (didn't bet)
Seat 5: qwertzuiopüß folded before Flop (didn't bet)
Seat 6: Daniel Daffe (button) folded before Flop (didn't bet)
Seat 7: WrongButton (small blind) folded before Flop
Seat 8: Pacifistas (big blind) collected ($1)
Seat 9: Spid1 folded before Flop (didn't bet)





PokerStars Hand #152663082334:  Hold'em No Limit ($0.50/$1.00 USD) - 2016/04/30 18:50:58 CET [2016/04/30 12:50:58 ET]
Table 'Dagmar' 9-max Seat #4 is the button
Seat 1: matiko09 ($193.50 in chips) 
Seat 2: Spid1 ($189.28 in chips) 
Seat 3: ApkawaDavit ($114.35 in chips) 
Seat 4: RoadtoNepal ($100 in chips) 
Seat 5: cap. marb ($44.52 in chips) 
Seat 6: arctur17 ($154.32 in chips) 
Seat 7: kswmh ($93.06 in chips) 
Seat 8: Ilov3NBA ($118.59 in chips) 
Seat 9: okkernoot111 ($91.08 in chips) 
cap. marb: posts small blind $0.50
arctur17: posts big blind $1
*** HOLE CARDS ***
Dealt to matiko09 [Td 7c]
kswmh: raises $1 to $2
Ilov3NBA: folds 
okkernoot111: folds 
matiko09: folds 
Spid1: folds 
ApkawaDavit: folds 
RoadtoNepal: folds 
cap. marb: raises $4 to $6
arctur17: folds 
kswmh: calls $4
*** FLOP *** [Kc Ad 2h]
cap. marb: checks 
kswmh: bets $1
cap. marb: calls $1
*** TURN *** [Kc Ad 2h] [7h]
cap. marb: checks 
kswmh: bets $1
cap. marb: calls $1
*** RIVER *** [Kc Ad 2h 7h] [9c]
cap. marb: checks 
kswmh: bets $1
cap. marb: calls $1
*** SHOW DOWN ***
kswmh: shows [Kh 5h] (a pair of Kings)
cap. marb: mucks hand 
kswmh collected $18.05 from pot
*** SUMMARY ***
Total pot $19 | Rake $0.95 
Board [Kc Ad 2h 7h 9c]
Seat 1: matiko09 folded before Flop (didn't bet)
Seat 2: Spid1 folded before Flop (didn't bet)
Seat 3: ApkawaDavit folded before Flop (didn't bet)
Seat 4: RoadtoNepal (button) folded before Flop (didn't bet)
Seat 5: cap. marb (small blind) mucked [Qh Qs]
Seat 6: arctur17 (big blind) folded before Flop
Seat 7: kswmh showed [Kh 5h] and won ($18.05) with a pair of Kings
Seat 8: Ilov3NBA folded before Flop (didn't bet)
Seat 9: okkernoot111 folded before Flop (didn't bet)





PokerStars Hand #152663101096:  Hold'em No Limit ($0.50/$1.00 USD) - 2016/04/30 18:51:21 CET [2016/04/30 12:51:21 ET]
Table 'Ruvuma' 9-max Seat #2 is the button
Seat 1: Ilov3NBA ($115.29 in chips) 
Seat 2: Spid1 ($120.32 in chips) 
Seat 3: OneTwo81 ($96.90 in chips) 
Seat 4: splicanin1 ($100.43 in chips) 
Seat 6: Pacifistas ($105.02 in chips) 
Seat 7: matiko09 ($101.50 in chips) 
Seat 8: Bailey Dew ($141.10 in chips) 
Seat 9: ApkawaDavit ($143.08 in chips) 
OneTwo81: posts small blind $0.50
splicanin1: posts big blind $1
hurtNCYDE: sits out 
*** HOLE CARDS ***
Dealt to matiko09 [7c 4h]
Pacifistas: folds 
matiko09: folds 
Bailey Dew: folds 
ApkawaDavit: folds 
Ilov3NBA: folds 
Spid1: folds 
OneTwo81: calls $0.50
splicanin1: checks 
*** FLOP *** [3d Tc Jh]
OneTwo81: checks 
splicanin1: checks 
*** TURN *** [3d Tc Jh] [8s]
OneTwo81: bets $1
splicanin1: folds 
Uncalled bet ($1) returned to OneTwo81
OneTwo81 collected $1.90 from pot
OneTwo81: doesn't show hand 
*** SUMMARY ***
Total pot $2 | Rake $0.10 
Board [3d Tc Jh 8s]
Seat 1: Ilov3NBA folded before Flop (didn't bet)
Seat 2: Spid1 (button) folded before Flop (didn't bet)
Seat 3: OneTwo81 (small blind) collected ($1.90)
Seat 4: splicanin1 (big blind) folded on the Turn
Seat 6: Pacifistas folded before Flop (didn't bet)
Seat 7: matiko09 folded before Flop (didn't bet)
Seat 8: Bailey Dew folded before Flop (didn't bet)
Seat 9: ApkawaDavit folded before Flop (didn't bet)





PokerStars Hand #152663106667:  Hold'em No Limit ($0.50/$1.00 USD) - 2016/04/30 18:51:28 CET [2016/04/30 12:51:28 ET]
Table 'Selinur II' 9-max Seat #7 is the button
Seat 2: matiko09 ($102.99 in chips) 
Seat 3: HITYESCA ($121.05 in chips) 
Seat 4: cap. marb ($38.50 in chips) 
Seat 5: qwertzuiopüß ($61.22 in chips) 
Seat 6: Daniel Daffe ($32.96 in chips) 
Seat 7: WrongButton ($100 in chips) 
Seat 8: Pacifistas ($104.15 in chips) 
Seat 9: Spid1 ($105.92 in chips) 
Pacifistas: posts small blind $0.50
Spid1: posts big blind $1
Bimaxa: sits out 
*** HOLE CARDS ***
Dealt to matiko09 [9h 8d]
matiko09: folds 
HITYESCA: folds 
cap. marb: folds 
qwertzuiopüß: folds 
Daniel Daffe: folds 
WrongButton: folds 
Pacifistas: folds 
Uncalled bet ($0.50) returned to Spid1
Spid1 collected $1 from pot
*** SUMMARY ***
Total pot $1 | Rake $0 
Seat 2: matiko09 folded before Flop (didn't bet)
Seat 3: HITYESCA folded before Flop (didn't bet)
Seat 4: cap. marb folded before Flop (didn't bet)
Seat 5: qwertzuiopüß folded before Flop (didn't bet)
Seat 6: Daniel Daffe folded before Flop (didn't bet)
Seat 7: WrongButton (button) folded before Flop (didn't bet)
Seat 8: Pacifistas (small blind) folded before Flop
Seat 9: Spid1 (big blind) collected ($1)





PokerStars Hand #152663114563:  Hold'em No Limit ($0.50/$1.00 USD) - 2016/04/30 18:51:38 CET [2016/04/30 12:51:38 ET]
Table 'Gutemberga III' 9-max Seat #9 is the button
Seat 1: Butchers31 ($38.43 in chips) 
Seat 2: matiko09 ($100 in chips) 
Seat 5: TimTeamNo ($46.38 in chips) 
Seat 6: bigacsiga ($101.50 in chips) 
Seat 7: I The King I ($101 in chips) 
Seat 8: maxxmeister ($103.34 in chips) 
Seat 9: deadkiller1 ($126.19 in chips) 
Butchers31: posts small blind $0.50
matiko09: posts big blind $1
WrongButton: sits out 
Spid1: sits out 
*** HOLE CARDS ***
Dealt to matiko09 [Ac Ah]
TimTeamNo: folds 
bigacsiga: raises $1.50 to $2.50
I The King I: folds 
maxxmeister: raises $6.50 to $9
deadkiller1: folds 
Butchers31: calls $8.50
matiko09: raises $14 to $23
bigacsiga: folds 
maxxmeister: folds 
Butchers31: calls $14
*** FLOP *** [Td 5c Kc]
Butchers31: checks 
matiko09: bets $35.75
Butchers31: calls $15.43 and is all-in
Uncalled bet ($20.32) returned to matiko09
*** TURN *** [Td 5c Kc] [8c]
*** RIVER *** [Td 5c Kc 8c] [Js]
*** SHOW DOWN ***
Butchers31: shows [4s 4d] (a pair of Fours)
matiko09: shows [Ac Ah] (a pair of Aces)
matiko09 collected $85.86 from pot
*** SUMMARY ***
Total pot $88.36 | Rake $2.50 
Board [Td 5c Kc 8c Js]
Seat 1: Butchers31 (small blind) showed [4s 4d] and lost with a pair of Fours
Seat 2: matiko09 (big blind) showed [Ac Ah] and won ($85.86) with a pair of Aces
Seat 5: TimTeamNo folded before Flop (didn't bet)
Seat 6: bigacsiga folded before Flop
Seat 7: I The King I folded before Flop (didn't bet)
Seat 8: maxxmeister folded before Flop
Seat 9: deadkiller1 (button) folded before Flop (didn't bet)





PokerStars Hand #152663124752:  Hold'em No Limit ($0.50/$1.00 USD) - 2016/04/30 18:51:50 CET [2016/04/30 12:51:50 ET]
Table 'Selinur II' 9-max Seat #8 is the button
Seat 1: Bimaxa ($100 in chips) 
Seat 2: matiko09 ($102.99 in chips) 
Seat 3: HITYESCA ($121.05 in chips) 
Seat 4: cap. marb ($38.50 in chips) 
Seat 5: qwertzuiopüß ($61.22 in chips) 
Seat 6: Daniel Daffe ($32.96 in chips) 
Seat 7: WrongButton ($100 in chips) 
Seat 8: Pacifistas ($103.65 in chips) 
Seat 9: Spid1 ($106.42 in chips) 
Spid1: posts small blind $0.50
Bimaxa: posts big blind $1
*** HOLE CARDS ***
Dealt to matiko09 [8h Qh]
matiko09: folds 
HITYESCA: folds 
cap. marb: folds 
qwertzuiopüß: folds 
Daniel Daffe: folds 
WrongButton: folds 
Pacifistas: raises $1.50 to $2.50
Spid1: folds 
Bimaxa: calls $1.50
*** FLOP *** [4d 8c 7h]
Bimaxa: checks 
Pacifistas: bets $3.50
Bimaxa: folds 
Uncalled bet ($3.50) returned to Pacifistas
Pacifistas collected $5.22 from pot
Pacifistas: doesn't show hand 
*** SUMMARY ***
Total pot $5.50 | Rake $0.28 
Board [4d 8c 7h]
Seat 1: Bimaxa (big blind) folded on the Flop
Seat 2: matiko09 folded before Flop (didn't bet)
Seat 3: HITYESCA folded before Flop (didn't bet)
Seat 4: cap. marb folded before Flop (didn't bet)
Seat 5: qwertzuiopüß folded before Flop (didn't bet)
Seat 6: Daniel Daffe folded before Flop (didn't bet)
Seat 7: WrongButton folded before Flop (didn't bet)
Seat 8: Pacifistas (button) collected ($5.22)
Seat 9: Spid1 (small blind) folded before Flop





PokerStars Hand #152663125995:  Hold'em No Limit ($0.50/$1.00 USD) - 2016/04/30 18:51:52 CET [2016/04/30 12:51:52 ET]
Table 'Ruvuma' 9-max Seat #3 is the button
Seat 1: Ilov3NBA ($115.29 in chips) 
Seat 2: Spid1 ($120.32 in chips) 
Seat 3: OneTwo81 ($97.80 in chips) 
Seat 4: splicanin1 ($99.43 in chips) 
Seat 5: hurtNCYDE ($100 in chips) 
Seat 6: Pacifistas ($105.02 in chips) 
Seat 7: matiko09 ($101.50 in chips) 
Seat 8: Bailey Dew ($141.10 in chips) 
Seat 9: ApkawaDavit ($143.08 in chips) 
splicanin1: posts small blind $0.50
hurtNCYDE: posts big blind $1
*** HOLE CARDS ***
Dealt to matiko09 [Ac 3h]
Pacifistas: folds 
matiko09: folds 
Bailey Dew: folds 
ApkawaDavit: folds 
Ilov3NBA: folds 
Spid1: folds 
OneTwo81: calls $1
splicanin1: calls $0.50
hurtNCYDE: checks 
*** FLOP *** [5c 2c 5s]
splicanin1: checks 
hurtNCYDE: checks 
OneTwo81: checks 
*** TURN *** [5c 2c 5s] [Kh]
splicanin1: checks 
hurtNCYDE: checks 
OneTwo81: bets $2
splicanin1: folds 
hurtNCYDE: folds 
Uncalled bet ($2) returned to OneTwo81
OneTwo81 collected $2.85 from pot
OneTwo81: doesn't show hand 
*** SUMMARY ***
Total pot $3 | Rake $0.15 
Board [5c 2c 5s Kh]
Seat 1: Ilov3NBA folded before Flop (didn't bet)
Seat 2: Spid1 folded before Flop (didn't bet)
Seat 3: OneTwo81 (button) collected ($2.85)
Seat 4: splicanin1 (small blind) folded on the Turn
Seat 5: hurtNCYDE (big blind) folded on the Turn
Seat 6: Pacifistas folded before Flop (didn't bet)
Seat 7: matiko09 folded before Flop (didn't bet)
Seat 8: Bailey Dew folded before Flop (didn't bet)
Seat 9: ApkawaDavit folded before Flop (didn't bet)





PokerStars Hand #152663128450:  Hold'em No Limit ($0.50/$1.00 USD) - 2016/04/30 18:51:55 CET [2016/04/30 12:51:55 ET]
Table 'Dagmar' 9-max Seat #5 is the button
Seat 1: matiko09 ($193.50 in chips) 
Seat 2: Spid1 ($189.28 in chips) 
Seat 3: ApkawaDavit ($114.35 in chips) 
Seat 4: RoadtoNepal ($100 in chips) 
Seat 5: cap. marb ($35.52 in chips) 
Seat 6: arctur17 ($153.32 in chips) 
Seat 7: kswmh ($102.11 in chips) 
Seat 8: Ilov3NBA ($118.59 in chips) 
Seat 9: okkernoot111 ($91.08 in chips) 
arctur17: posts small blind $0.50
kswmh: posts big blind $1
*** HOLE CARDS ***
Dealt to matiko09 [3h 6h]
Ilov3NBA: raises $2 to $3
okkernoot111: folds 
matiko09: folds 
Spid1: folds 
ApkawaDavit: folds 
RoadtoNepal: folds 
cap. marb: folds 
arctur17: folds 
kswmh: folds 
Uncalled bet ($2) returned to Ilov3NBA
Ilov3NBA collected $2.50 from pot
Ilov3NBA: doesn't show hand 
*** SUMMARY ***
Total pot $2.50 | Rake $0 
Seat 1: matiko09 folded before Flop (didn't bet)
Seat 2: Spid1 folded before Flop (didn't bet)
Seat 3: ApkawaDavit folded before Flop (didn't bet)
Seat 4: RoadtoNepal folded before Flop (didn't bet)
Seat 5: cap. marb (button) folded before Flop (didn't bet)
Seat 6: arctur17 (small blind) folded before Flop
Seat 7: kswmh (big blind) folded before Flop
Seat 8: Ilov3NBA collected ($2.50)
Seat 9: okkernoot111 folded before Flop (didn't bet)





PokerStars Hand #152663154511:  Hold'em No Limit ($0.50/$1.00 USD) - 2016/04/30 18:52:27 CET [2016/04/30 12:52:27 ET]
Table 'Selinur II' 9-max Seat #9 is the button
Seat 1: Bimaxa ($100 in chips) 
Seat 2: matiko09 ($102.99 in chips) 
Seat 3: HITYESCA ($121.05 in chips) 
Seat 4: cap. marb ($38.50 in chips) 
Seat 5: qwertzuiopüß ($61.22 in chips) 
Seat 6: Daniel Daffe ($32.96 in chips) 
Seat 7: WrongButton ($100 in chips) 
Seat 8: Pacifistas ($106.37 in chips) 
Seat 9: Spid1 ($105.92 in chips) 
Bimaxa: posts small blind $0.50
matiko09: posts big blind $1
*** HOLE CARDS ***
Dealt to matiko09 [Qh Th]
HITYESCA: folds 
cap. marb: folds 
qwertzuiopüß: folds 
Daniel Daffe: calls $1
WrongButton: folds 
Pacifistas: folds 
Spid1: folds 
Bimaxa: folds 
matiko09: checks 
*** FLOP *** [8h Ah 9s]
matiko09: bets $1.55
Daniel Daffe: calls $1.55
*** TURN *** [8h Ah 9s] [2h]
matiko09: bets $4
Daniel Daffe: folds 
Uncalled bet ($4) returned to matiko09
matiko09 collected $5.32 from pot
matiko09: doesn't show hand 
*** SUMMARY ***
Total pot $5.60 | Rake $0.28 
Board [8h Ah 9s 2h]
Seat 1: Bimaxa (small blind) folded before Flop
Seat 2: matiko09 (big blind) collected ($5.32)
Seat 3: HITYESCA folded before Flop (didn't bet)
Seat 4: cap. marb folded before Flop (didn't bet)
Seat 5: qwertzuiopüß folded before Flop (didn't bet)
Seat 6: Daniel Daffe folded on the Turn
Seat 7: WrongButton folded before Flop (didn't bet)
Seat 8: Pacifistas folded before Flop (didn't bet)
Seat 9: Spid1 (button) folded before Flop (didn't bet)





PokerStars Hand #152663155929:  Hold'em No Limit ($0.50/$1.00 USD) - 2016/04/30 18:52:29 CET [2016/04/30 12:52:29 ET]
Table 'Gutemberga III' 9-max Seat #2 is the button
Seat 2: matiko09 ($147.43 in chips) 
Seat 5: TimTeamNo ($46.38 in chips) 
Seat 6: bigacsiga ($100 in chips) 
Seat 7: I The King I ($101 in chips) 
Seat 8: maxxmeister ($100 in chips) 
Seat 9: deadkiller1 ($126.19 in chips) 
WrongButton will be allowed to play after the button
Spid1 will be allowed to play after the button
TimTeamNo: posts small blind $0.50
bigacsiga: posts big blind $1
*** HOLE CARDS ***
Dealt to matiko09 [9d 8c]
I The King I: folds 
Butchers31 leaves the table
Bimaxa joins the table at seat #1 
Bimaxa leaves the table
hurtNCYDE joins the table at seat #1 
hurtNCYDE leaves the table
Ilov3NBA joins the table at seat #1 
maxxmeister: folds 
deadkiller1: folds 
WrongButton leaves the table
matiko09: folds 
TimTeamNo: raises $1 to $2
bigacsiga: folds 
Uncalled bet ($1) returned to TimTeamNo
TimTeamNo collected $2 from pot
TimTeamNo: doesn't show hand 
*** SUMMARY ***
Total pot $2 | Rake $0 
Seat 2: matiko09 (button) folded before Flop (didn't bet)
Seat 5: TimTeamNo (small blind) collected ($2)
Seat 6: bigacsiga (big blind) folded before Flop
Seat 7: I The King I folded before Flop (didn't bet)
Seat 8: maxxmeister folded before Flop (didn't bet)
Seat 9: deadkiller1 folded before Flop (didn't bet)





PokerStars Hand #152663160481:  Hold'em No Limit ($0.50/$1.00 USD) - 2016/04/30 18:52:34 CET [2016/04/30 12:52:34 ET]
Table 'Dagmar' 9-max Seat #6 is the button
Seat 1: matiko09 ($193.50 in chips) 
Seat 2: Spid1 ($189.28 in chips) 
Seat 3: ApkawaDavit ($114.35 in chips) 
Seat 4: RoadtoNepal ($100 in chips) 
Seat 5: cap. marb ($35.52 in chips) 
Seat 6: arctur17 ($152.82 in chips) 
Seat 7: kswmh ($101.11 in chips) 
Seat 8: Ilov3NBA ($120.09 in chips) 
Seat 9: okkernoot111 ($91.08 in chips) 
kswmh: posts small blind $0.50
Ilov3NBA: posts big blind $1
*** HOLE CARDS ***
Dealt to matiko09 [Qc 7c]
okkernoot111: folds 
matiko09: folds 
Spid1: folds 
ApkawaDavit: raises $2 to $3
RoadtoNepal: folds 
cap. marb: folds 
arctur17: folds 
kswmh: raises $2 to $5
Ilov3NBA: folds 
ApkawaDavit: calls $2
*** FLOP *** [Th 3s Ah]
kswmh: bets $1
ApkawaDavit: calls $1
*** TURN *** [Th 3s Ah] [8c]
kswmh: bets $1
ApkawaDavit: calls $1
*** RIVER *** [Th 3s Ah 8c] [Qd]
kswmh: bets $1
ApkawaDavit: calls $1
*** SHOW DOWN ***
kswmh: shows [Qh Js] (a pair of Queens)
ApkawaDavit: shows [Ac 5c] (a pair of Aces)
ApkawaDavit collected $16.15 from pot
*** SUMMARY ***
Total pot $17 | Rake $0.85 
Board [Th 3s Ah 8c Qd]
Seat 1: matiko09 folded before Flop (didn't bet)
Seat 2: Spid1 folded before Flop (didn't bet)
Seat 3: ApkawaDavit showed [Ac 5c] and won ($16.15) with a pair of Aces
Seat 4: RoadtoNepal folded before Flop (didn't bet)
Seat 5: cap. marb folded before Flop (didn't bet)
Seat 6: arctur17 (button) folded before Flop (didn't bet)
Seat 7: kswmh (small blind) showed [Qh Js] and lost with a pair of Queens
Seat 8: Ilov3NBA (big blind) folded before Flop
Seat 9: okkernoot111 folded before Flop (didn't bet)





PokerStars Hand #152663159844:  Hold'em No Limit ($0.50/$1.00 USD) - 2016/04/30 18:52:34 CET [2016/04/30 12:52:34 ET]
Table 'Ruvuma' 9-max Seat #4 is the button
Seat 1: Ilov3NBA ($115.29 in chips) 
Seat 2: Spid1 ($120.32 in chips) 
Seat 3: OneTwo81 ($99.65 in chips) 
Seat 4: splicanin1 ($98.43 in chips) 
Seat 5: hurtNCYDE ($100 in chips) 
Seat 6: Pacifistas ($105.02 in chips) 
Seat 7: matiko09 ($101.50 in chips) 
Seat 8: Bailey Dew ($141.10 in chips) 
Seat 9: ApkawaDavit ($143.08 in chips) 
hurtNCYDE: posts small blind $0.50
Pacifistas: posts big blind $1
*** HOLE CARDS ***
Dealt to matiko09 [Qd 2c]
matiko09: folds 
Bailey Dew: folds 
ApkawaDavit: folds 
Ilov3NBA: folds 
Spid1: folds 
OneTwo81: folds 
splicanin1: folds 
hurtNCYDE: raises $1.50 to $2.50
Pacifistas: folds 
Uncalled bet ($1.50) returned to hurtNCYDE
hurtNCYDE collected $2 from pot
*** SUMMARY ***
Total pot $2 | Rake $0 
Seat 1: Ilov3NBA folded before Flop (didn't bet)
Seat 2: Spid1 folded before Flop (didn't bet)
Seat 3: OneTwo81 folded before Flop (didn't bet)
Seat 4: splicanin1 (button) folded before Flop (didn't bet)
Seat 5: hurtNCYDE (small blind) collected ($2)
Seat 6: Pacifistas (big blind) folded before Flop
Seat 7: matiko09 folded before Flop (didn't bet)
Seat 8: Bailey Dew folded before Flop (didn't bet)
Seat 9: ApkawaDavit folded before Flop (didn't bet)





PokerStars Hand #152663163263:  Hold'em No Limit ($0.50/$1.00 USD) - 2016/04/30 18:52:38 CET [2016/04/30 12:52:38 ET]
Table 'Lova II' 9-max Seat #9 is the button
Seat 1: pelikan1968 ($77 in chips) 
Seat 2: bilukm ($313.59 in chips) 
Seat 3: matiko09 ($109.39 in chips) 
Seat 4: VanDobeln ($126.25 in chips) 
Seat 5: Ilov3NBA ($156.51 in chips) 
Seat 6: HITYESCA ($100 in chips) 
Seat 7: Szevasztopol ($103.82 in chips) 
Seat 8: cap. marb ($61.39 in chips) 
Seat 9: IseeUcards ($100 in chips) 
pelikan1968: posts small blind $0.50
bilukm: posts big blind $1
*** HOLE CARDS ***
Dealt to matiko09 [5s 4h]
matiko09: folds 
VanDobeln: folds 
Ilov3NBA: folds 
HITYESCA: folds 
Szevasztopol: folds 
cap. marb: folds 
IseeUcards: folds 
pelikan1968: raises $2 to $3
bilukm: folds 
Uncalled bet ($2) returned to pelikan1968
pelikan1968 collected $2 from pot
pelikan1968: doesn't show hand 
*** SUMMARY ***
Total pot $2 | Rake $0 
Seat 1: pelikan1968 (small blind) collected ($2)
Seat 2: bilukm (big blind) folded before Flop
Seat 3: matiko09 folded before Flop (didn't bet)
Seat 4: VanDobeln folded before Flop (didn't bet)
Seat 5: Ilov3NBA folded before Flop (didn't bet)
Seat 6: HITYESCA folded before Flop (didn't bet)
Seat 7: Szevasztopol folded before Flop (didn't bet)
Seat 8: cap. marb folded before Flop (didn't bet)
Seat 9: IseeUcards (button) folded before Flop (didn't bet)





PokerStars Hand #152663164203:  Hold'em No Limit ($0.50/$1.00 USD) - 2016/04/30 18:52:39 CET [2016/04/30 12:52:39 ET]
Table 'Hippasos' 9-max Seat #6 is the button
Seat 1: MRC63S ($75.40 in chips) 
Seat 2: matiko09 ($100 in chips) 
Seat 3: WrongButton ($101.49 in chips) 
Seat 4: Pacifistas ($100 in chips) 
Seat 5: boutabi ($134.63 in chips) 
Seat 6: JACQUILF ($127.02 in chips) 
Seat 7: ilaviiitech ($100 in chips) 
Seat 8: Spid1 ($100 in chips) 
Seat 9: ApkawaDavit ($100.12 in chips) 
ilaviiitech: posts small blind $0.50
Spid1: posts big blind $1
*** HOLE CARDS ***
Dealt to matiko09 [Js Ts]
ApkawaDavit: folds 
MRC63S: calls $1
matiko09: raises $3 to $4
WrongButton: folds 
Pacifistas: folds 
boutabi: folds 
JACQUILF: folds 
ilaviiitech: folds 
Spid1: folds 
MRC63S: calls $3
*** FLOP *** [9h As Qh]
MRC63S: checks 
matiko09: bets $6
MRC63S: folds 
Uncalled bet ($6) returned to matiko09
matiko09 collected $9.02 from pot
matiko09: doesn't show hand 
*** SUMMARY ***
Total pot $9.50 | Rake $0.48 
Board [9h As Qh]
Seat 1: MRC63S folded on the Flop
Seat 2: matiko09 collected ($9.02)
Seat 3: WrongButton folded before Flop (didn't bet)
Seat 4: Pacifistas folded before Flop (didn't bet)
Seat 5: boutabi folded before Flop (didn't bet)
Seat 6: JACQUILF (button) folded before Flop (didn't bet)
Seat 7: ilaviiitech (small blind) folded before Flop
Seat 8: Spid1 (big blind) folded before Flop
Seat 9: ApkawaDavit folded before Flop (didn't bet)





PokerStars Hand #152663185058:  Hold'em No Limit ($0.50/$1.00 USD) - 2016/04/30 18:53:05 CET [2016/04/30 12:53:05 ET]
Table 'Gutemberga III' 9-max Seat #5 is the button
Seat 2: matiko09 ($147.43 in chips) 
Seat 5: TimTeamNo ($47.38 in chips) 
Seat 6: bigacsiga ($100 in chips) 
Seat 7: I The King I ($101 in chips) 
Seat 8: maxxmeister ($100 in chips) 
Seat 9: deadkiller1 ($126.19 in chips) 
bigacsiga: posts small blind $0.50
I The King I: posts big blind $1
Ilov3NBA: sits out 
Spid1: sits out 
*** HOLE CARDS ***
Dealt to matiko09 [8h Ks]
cap. marb joins the table at seat #3 
maxxmeister: folds 
deadkiller1: folds 
matiko09: folds 
TimTeamNo: raises $2 to $3
bigacsiga: calls $2.50
I The King I: folds 
*** FLOP *** [Kc Kd 3d]
bigacsiga: checks 
TimTeamNo: checks 
*** TURN *** [Kc Kd 3d] [8s]
bigacsiga: checks 
TimTeamNo: bets $4
bigacsiga: folds 
Uncalled bet ($4) returned to TimTeamNo
TimTeamNo collected $6.65 from pot
TimTeamNo: doesn't show hand 
*** SUMMARY ***
Total pot $7 | Rake $0.35 
Board [Kc Kd 3d 8s]
Seat 2: matiko09 folded before Flop (didn't bet)
Seat 5: TimTeamNo (button) collected ($6.65)
Seat 6: bigacsiga (small blind) folded on the Turn
Seat 7: I The King I (big blind) folded before Flop
Seat 8: maxxmeister folded before Flop (didn't bet)
Seat 9: deadkiller1 folded before Flop (didn't bet)





PokerStars Hand #152663192778:  Hold'em No Limit ($0.50/$1.00 USD) - 2016/04/30 18:53:15 CET [2016/04/30 12:53:15 ET]
Table 'Ruvuma' 9-max Seat #5 is the button
Seat 1: Ilov3NBA ($115.29 in chips) 
Seat 2: Spid1 ($120.32 in chips) 
Seat 3: OneTwo81 ($99.65 in chips) 
Seat 4: splicanin1 ($98.43 in chips) 
Seat 5: hurtNCYDE ($101 in chips) 
Seat 6: Pacifistas ($104.02 in chips) 
Seat 7: matiko09 ($101.50 in chips) 
Seat 8: Bailey Dew ($141.10 in chips) 
Seat 9: ApkawaDavit ($143.08 in chips) 
Pacifistas: posts small blind $0.50
matiko09: posts big blind $1
*** HOLE CARDS ***
Dealt to matiko09 [5c 8d]
Bailey Dew: raises $2 to $3
ApkawaDavit: folds 
Ilov3NBA: folds 
Spid1: raises $6 to $9
OneTwo81: folds 
splicanin1: folds 
hurtNCYDE: folds 
Pacifistas: folds 
matiko09: folds 
Bailey Dew: folds 
Uncalled bet ($6) returned to Spid1
Spid1 collected $7.50 from pot
Spid1: doesn't show hand 
*** SUMMARY ***
Total pot $7.50 | Rake $0 
Seat 1: Ilov3NBA folded before Flop (didn't bet)
Seat 2: Spid1 collected ($7.50)
Seat 3: OneTwo81 folded before Flop (didn't bet)
Seat 4: splicanin1 folded before Flop (didn't bet)
Seat 5: hurtNCYDE (button) folded before Flop (didn't bet)
Seat 6: Pacifistas (small blind) folded before Flop
Seat 7: matiko09 (big blind) folded before Flop
Seat 8: Bailey Dew folded before Flop
Seat 9: ApkawaDavit folded before Flop (didn't bet)





PokerStars Hand #152663195892:  Hold'em No Limit ($0.50/$1.00 USD) - 2016/04/30 18:53:19 CET [2016/04/30 12:53:19 ET]
Table 'Lova II' 9-max Seat #1 is the button
Seat 1: pelikan1968 ($78 in chips) 
Seat 2: bilukm ($312.59 in chips) 
Seat 3: matiko09 ($109.39 in chips) 
Seat 4: VanDobeln ($126.25 in chips) 
Seat 5: Ilov3NBA ($156.51 in chips) 
Seat 6: HITYESCA ($100 in chips) 
Seat 7: Szevasztopol ($103.82 in chips) 
Seat 8: cap. marb ($61.39 in chips) 
Seat 9: IseeUcards ($100 in chips) 
bilukm: posts small blind $0.50
matiko09: posts big blind $1
*** HOLE CARDS ***
Dealt to matiko09 [4h 7d]
VanDobeln: folds 
Ilov3NBA: folds 
HITYESCA: raises $2 to $3
Szevasztopol: folds 
cap. marb: folds 
IseeUcards: folds 
pelikan1968: folds 
bilukm: calls $2.50
matiko09: folds 
*** FLOP *** [5d Kh Jd]
bilukm: checks 
HITYESCA: bets $5
bilukm: folds 
Uncalled bet ($5) returned to HITYESCA
HITYESCA collected $6.65 from pot
HITYESCA: doesn't show hand 
*** SUMMARY ***
Total pot $7 | Rake $0.35 
Board [5d Kh Jd]
Seat 1: pelikan1968 (button) folded before Flop (didn't bet)
Seat 2: bilukm (small blind) folded on the Flop
Seat 3: matiko09 (big blind) folded before Flop
Seat 4: VanDobeln folded before Flop (didn't bet)
Seat 5: Ilov3NBA folded before Flop (didn't bet)
Seat 6: HITYESCA collected ($6.65)
Seat 7: Szevasztopol folded before Flop (didn't bet)
Seat 8: cap. marb folded before Flop (didn't bet)
Seat 9: IseeUcards folded before Flop (didn't bet)





PokerStars Hand #152663211092:  Hold'em No Limit ($0.50/$1.00 USD) - 2016/04/30 18:53:38 CET [2016/04/30 12:53:38 ET]
Table 'Dagmar' 9-max Seat #7 is the button
Seat 1: matiko09 ($193.50 in chips) 
Seat 2: Spid1 ($189.28 in chips) 
Seat 3: ApkawaDavit ($122.50 in chips) 
Seat 4: RoadtoNepal ($100 in chips) 
Seat 5: cap. marb ($35.52 in chips) 
Seat 6: arctur17 ($152.82 in chips) 
Seat 7: kswmh ($93.11 in chips) 
Seat 8: Ilov3NBA ($119.09 in chips) 
Seat 9: okkernoot111 ($91.08 in chips) 
Ilov3NBA: posts small blind $0.50
okkernoot111: posts big blind $1
*** HOLE CARDS ***
Dealt to matiko09 [2c 4c]
matiko09: folds 
Spid1: folds 
ApkawaDavit: folds 
RoadtoNepal: folds 
cap. marb: folds 
arctur17: folds 
kswmh: raises $1 to $2
Ilov3NBA: folds 
okkernoot111: folds 
Uncalled bet ($1) returned to kswmh
kswmh collected $2.50 from pot
kswmh: doesn't show hand 
*** SUMMARY ***
Total pot $2.50 | Rake $0 
Seat 1: matiko09 folded before Flop (didn't bet)
Seat 2: Spid1 folded before Flop (didn't bet)
Seat 3: ApkawaDavit folded before Flop (didn't bet)
Seat 4: RoadtoNepal folded before Flop (didn't bet)
Seat 5: cap. marb folded before Flop (didn't bet)
Seat 6: arctur17 folded before Flop (didn't bet)
Seat 7: kswmh (button) collected ($2.50)
Seat 8: Ilov3NBA (small blind) folded before Flop
Seat 9: okkernoot111 (big blind) folded before Flop





PokerStars Hand #152663212901:  Hold'em No Limit ($0.50/$1.00 USD) - 2016/04/30 18:53:40 CET [2016/04/30 12:53:40 ET]
Table 'Hippasos' 9-max Seat #7 is the button
Seat 1: MRC63S ($71.40 in chips) 
Seat 2: matiko09 ($105.02 in chips) 
Seat 3: WrongButton ($101.49 in chips) 
Seat 4: Pacifistas ($100 in chips) 
Seat 5: boutabi ($134.63 in chips) 
Seat 6: JACQUILF ($127.02 in chips) 
Seat 7: ilaviiitech ($100 in chips) 
Seat 8: Spid1 ($100 in chips) 
Seat 9: ApkawaDavit ($100.12 in chips) 
Spid1: posts small blind $0.50
ApkawaDavit: posts big blind $1
*** HOLE CARDS ***
Dealt to matiko09 [Ad 6s]
MRC63S: calls $1
matiko09: folds 
WrongButton: folds 
Pacifistas has timed out
Pacifistas: folds 
boutabi: folds 
JACQUILF: folds 
ilaviiitech: folds 
Spid1: raises $5 to $6
ApkawaDavit: folds 
MRC63S: calls $5
*** FLOP *** [5h 5c 5d]
Spid1: bets $7
MRC63S: calls $7
*** TURN *** [5h 5c 5d] [9s]
Spid1: bets $16
MRC63S: calls $16
*** RIVER *** [5h 5c 5d 9s] [9h]
Spid1: checks 
MRC63S: bets $42.40 and is all-in
Spid1: calls $42.40
*** SHOW DOWN ***
MRC63S: shows [Kc 5s] (four of a kind, Fives)
Spid1: shows [Qs Ks] (a full house, Fives full of Nines)
MRC63S collected $141.30 from pot
*** SUMMARY ***
Total pot $143.80 | Rake $2.50 
Board [5h 5c 5d 9s 9h]
Seat 1: MRC63S showed [Kc 5s] and won ($141.30) with four of a kind, Fives
Seat 2: matiko09 folded before Flop (didn't bet)
Seat 3: WrongButton folded before Flop (didn't bet)
Seat 4: Pacifistas folded before Flop (didn't bet)
Seat 5: boutabi folded before Flop (didn't bet)
Seat 6: JACQUILF folded before Flop (didn't bet)
Seat 7: ilaviiitech (button) folded before Flop (didn't bet)
Seat 8: Spid1 (small blind) showed [Qs Ks] and lost with a full house, Fives full of Nines
Seat 9: ApkawaDavit (big blind) folded before Flop





PokerStars Hand #152663217956:  Hold'em No Limit ($0.50/$1.00 USD) - 2016/04/30 18:53:46 CET [2016/04/30 12:53:46 ET]
Table 'Selinur II' 9-max Seat #1 is the button
Seat 1: Bimaxa ($100 in chips) 
Seat 2: matiko09 ($105.76 in chips) 
Seat 3: HITYESCA ($121.05 in chips) 
Seat 4: cap. marb ($38.50 in chips) 
Seat 5: qwertzuiopüß ($61.22 in chips) 
Seat 6: Daniel Daffe ($30.41 in chips) 
Seat 7: WrongButton ($100 in chips) 
Seat 8: Pacifistas ($106.37 in chips) 
Seat 9: Spid1 ($105.92 in chips) 
matiko09: posts small blind $0.50
HITYESCA: posts big blind $1
*** HOLE CARDS ***
Dealt to matiko09 [Ks 2c]
cap. marb: folds 
qwertzuiopüß: folds 
Daniel Daffe: raises $2 to $3
WrongButton: folds 
Pacifistas: raises $5 to $8
Spid1: folds 
Bimaxa: folds 
matiko09: folds 
HITYESCA: folds 
Daniel Daffe: raises $22.41 to $30.41 and is all-in
Pacifistas: calls $22.41
*** FLOP *** [Jc 2s 6h]
*** TURN *** [Jc 2s 6h] [4h]
*** RIVER *** [Jc 2s 6h 4h] [4s]
*** SHOW DOWN ***
Daniel Daffe: shows [9h 9s] (two pair, Nines and Fours)
Pacifistas: shows [Ah Kd] (a pair of Fours)
Daniel Daffe collected $59.82 from pot
*** SUMMARY ***
Total pot $62.32 | Rake $2.50 
Board [Jc 2s 6h 4h 4s]
Seat 1: Bimaxa (button) folded before Flop (didn't bet)
Seat 2: matiko09 (small blind) folded before Flop
Seat 3: HITYESCA (big blind) folded before Flop
Seat 4: cap. marb folded before Flop (didn't bet)
Seat 5: qwertzuiopüß folded before Flop (didn't bet)
Seat 6: Daniel Daffe showed [9h 9s] and won ($59.82) with two pair, Nines and Fours
Seat 7: WrongButton folded before Flop (didn't bet)
Seat 8: Pacifistas showed [Ah Kd] and lost with a pair of Fours
Seat 9: Spid1 folded before Flop (didn't bet)





PokerStars Hand #152663223749:  Hold'em No Limit ($0.50/$1.00 USD) - 2016/04/30 18:53:53 CET [2016/04/30 12:53:53 ET]
Table 'Ruvuma' 9-max Seat #6 is the button
Seat 1: Ilov3NBA ($115.29 in chips) 
Seat 2: Spid1 ($124.82 in chips) 
Seat 3: OneTwo81 ($99.65 in chips) 
Seat 4: splicanin1 ($98.43 in chips) 
Seat 5: hurtNCYDE ($101 in chips) 
Seat 6: Pacifistas ($103.52 in chips) 
Seat 7: matiko09 ($100.50 in chips) 
Seat 9: ApkawaDavit ($143.08 in chips) 
matiko09: posts small blind $0.50
Bailey Dew: is sitting out 
ApkawaDavit: posts big blind $1
*** HOLE CARDS ***
Dealt to matiko09 [4d 5h]
Ilov3NBA: folds 
Bailey Dew leaves the table
Spid1: folds 
OneTwo81: calls $1
splicanin1: folds 
hurtNCYDE: folds 
Pacifistas: folds 
RoadtoNepal joins the table at seat #8 
matiko09: folds 
RoadtoNepal leaves the table
ApkawaDavit: checks 
*** FLOP *** [Qd 9c Kh]
ApkawaDavit: checks 
OneTwo81: checks 
*** TURN *** [Qd 9c Kh] [7c]
ApkawaDavit: checks 
OneTwo81: bets $2
ApkawaDavit: folds 
Uncalled bet ($2) returned to OneTwo81
OneTwo81 collected $2.38 from pot
OneTwo81: doesn't show hand 
*** SUMMARY ***
Total pot $2.50 | Rake $0.12 
Board [Qd 9c Kh 7c]
Seat 1: Ilov3NBA folded before Flop (didn't bet)
Seat 2: Spid1 folded before Flop (didn't bet)
Seat 3: OneTwo81 collected ($2.38)
Seat 4: splicanin1 folded before Flop (didn't bet)
Seat 5: hurtNCYDE folded before Flop (didn't bet)
Seat 6: Pacifistas (button) folded before Flop (didn't bet)
Seat 7: matiko09 (small blind) folded before Flop
Seat 9: ApkawaDavit (big blind) folded on the Turn





PokerStars Hand #152663225641:  Hold'em No Limit ($0.50/$1.00 USD) - 2016/04/30 18:53:56 CET [2016/04/30 12:53:56 ET]
Table 'Dagmar' 9-max Seat #8 is the button
Seat 1: matiko09 ($193.50 in chips) 
Seat 2: Spid1 ($189.28 in chips) 
Seat 3: ApkawaDavit ($122.50 in chips) 
Seat 4: RoadtoNepal ($100 in chips) 
Seat 5: cap. marb ($35.52 in chips) 
Seat 6: arctur17 ($152.82 in chips) 
Seat 7: kswmh ($94.61 in chips) 
Seat 8: Ilov3NBA ($118.59 in chips) 
Seat 9: okkernoot111 ($90.08 in chips) 
okkernoot111: posts small blind $0.50
matiko09: posts big blind $1
*** HOLE CARDS ***
Dealt to matiko09 [5h Ts]
Spid1: folds 
ApkawaDavit: folds 
RoadtoNepal: raises $1 to $2
cap. marb: folds 
arctur17: folds 
kswmh: folds 
Ilov3NBA: folds 
okkernoot111: folds 
matiko09: folds 
Uncalled bet ($1) returned to RoadtoNepal
RoadtoNepal collected $2.50 from pot
RoadtoNepal: doesn't show hand 
*** SUMMARY ***
Total pot $2.50 | Rake $0 
Seat 1: matiko09 (big blind) folded before Flop
Seat 2: Spid1 folded before Flop (didn't bet)
Seat 3: ApkawaDavit folded before Flop (didn't bet)
Seat 4: RoadtoNepal collected ($2.50)
Seat 5: cap. marb folded before Flop (didn't bet)
Seat 6: arctur17 folded before Flop (didn't bet)
Seat 7: kswmh folded before Flop (didn't bet)
Seat 8: Ilov3NBA (button) folded before Flop (didn't bet)
Seat 9: okkernoot111 (small blind) folded before Flop





PokerStars Hand #152663233220:  Hold'em No Limit ($0.50/$1.00 USD) - 2016/04/30 18:54:05 CET [2016/04/30 12:54:05 ET]
Table 'Gutemberga III' 9-max Seat #6 is the button
Seat 2: matiko09 ($147.43 in chips) 
Seat 5: TimTeamNo ($51.03 in chips) 
Seat 6: bigacsiga ($100 in chips) 
Seat 7: I The King I ($100 in chips) 
Seat 8: maxxmeister ($100 in chips) 
Seat 9: deadkiller1 ($126.19 in chips) 
I The King I: posts small blind $0.50
maxxmeister: posts big blind $1
Ilov3NBA: sits out 
cap. marb: sits out 
Spid1: sits out 
*** HOLE CARDS ***
Dealt to matiko09 [8c 7h]
deadkiller1: raises $2 to $3
matiko09: folds 
TimTeamNo: folds 
bigacsiga: folds 
I The King I: folds 
maxxmeister: folds 
Uncalled bet ($2) returned to deadkiller1
deadkiller1 collected $2.50 from pot
deadkiller1: doesn't show hand 
*** SUMMARY ***
Total pot $2.50 | Rake $0 
Seat 2: matiko09 folded before Flop (didn't bet)
Seat 5: TimTeamNo folded before Flop (didn't bet)
Seat 6: bigacsiga (button) folded before Flop (didn't bet)
Seat 7: I The King I (small blind) folded before Flop
Seat 8: maxxmeister (big blind) folded before Flop
Seat 9: deadkiller1 collected ($2.50)





PokerStars Hand #152663244994:  Hold'em No Limit ($0.50/$1.00 USD) - 2016/04/30 18:54:20 CET [2016/04/30 12:54:20 ET]
Table 'Lova II' 9-max Seat #2 is the button
Seat 1: pelikan1968 ($78 in chips) 
Seat 2: bilukm ($309.59 in chips) 
Seat 3: matiko09 ($108.39 in chips) 
Seat 4: VanDobeln ($126.25 in chips) 
Seat 5: Ilov3NBA ($156.51 in chips) 
Seat 6: HITYESCA ($103.65 in chips) 
Seat 7: Szevasztopol ($103.82 in chips) 
Seat 8: cap. marb ($61.39 in chips) 
Seat 9: IseeUcards ($100 in chips) 
matiko09: posts small blind $0.50
VanDobeln: posts big blind $1
*** HOLE CARDS ***
Dealt to matiko09 [Qh 4d]
Ilov3NBA: folds 
HITYESCA: folds 
Szevasztopol: folds 
cap. marb: folds 
IseeUcards: folds 
pelikan1968: folds 
bilukm: folds 
matiko09: folds 
Uncalled bet ($0.50) returned to VanDobeln
VanDobeln collected $1 from pot
VanDobeln: doesn't show hand 
*** SUMMARY ***
Total pot $1 | Rake $0 
Seat 1: pelikan1968 folded before Flop (didn't bet)
Seat 2: bilukm (button) folded before Flop (didn't bet)
Seat 3: matiko09 (small blind) folded before Flop
Seat 4: VanDobeln (big blind) collected ($1)
Seat 5: Ilov3NBA folded before Flop (didn't bet)
Seat 6: HITYESCA folded before Flop (didn't bet)
Seat 7: Szevasztopol folded before Flop (didn't bet)
Seat 8: cap. marb folded before Flop (didn't bet)
Seat 9: IseeUcards folded before Flop (didn't bet)





PokerStars Hand #152663249609:  Hold'em No Limit ($0.50/$1.00 USD) - 2016/04/30 18:54:26 CET [2016/04/30 12:54:26 ET]
Table 'Gutemberga III' 9-max Seat #7 is the button
Seat 2: matiko09 ($147.43 in chips) 
Seat 5: TimTeamNo ($51.03 in chips) 
Seat 6: bigacsiga ($100 in chips) 
Seat 7: I The King I ($100 in chips) 
Seat 8: maxxmeister ($100 in chips) 
Seat 9: deadkiller1 ($127.69 in chips) 
maxxmeister: posts small blind $0.50
deadkiller1: posts big blind $1
Ilov3NBA: sits out 
cap. marb: sits out 
Spid1: sits out 
*** HOLE CARDS ***
Dealt to matiko09 [8s 3h]
matiko09: folds 
TimTeamNo: folds 
bigacsiga: folds 
I The King I: folds 
maxxmeister: raises $2.50 to $3.50
deadkiller1: calls $2.50
*** FLOP *** [Js 9c Td]
maxxmeister: checks 
deadkiller1: bets $4.38
maxxmeister: raises $13.62 to $18
deadkiller1: raises $106.19 to $124.19 and is all-in
maxxmeister: calls $78.50 and is all-in
Uncalled bet ($27.69) returned to deadkiller1
*** FIRST TURN *** [Js 9c Td] [6c]
*** FIRST RIVER *** [Js 9c Td 6c] [Ks]
*** SECOND TURN *** [Js 9c Td] [Qc]
*** SECOND RIVER *** [Js 9c Td Qc] [Qd]
*** FIRST SHOW DOWN ***
maxxmeister: shows [8d 7d] (a straight, Seven to Jack)
deadkiller1: shows [Qh Kh] (a straight, Nine to King)
deadkiller1 collected $98.75 from pot
*** SECOND SHOW DOWN ***
maxxmeister: shows [8d 7d] (a straight, Eight to Queen)
deadkiller1: shows [Qh Kh] (a straight, Nine to King)
deadkiller1 collected $98.75 from pot
*** SUMMARY ***
Total pot $200 | Rake $2.50 
Hand was run twice
FIRST Board [Js 9c Td 6c Ks]
SECOND Board [Js 9c Td Qc Qd]
Seat 2: matiko09 folded before Flop (didn't bet)
Seat 5: TimTeamNo folded before Flop (didn't bet)
Seat 6: bigacsiga folded before Flop (didn't bet)
Seat 7: I The King I (button) folded before Flop (didn't bet)
Seat 8: maxxmeister (small blind) showed [8d 7d] and lost with a straight, Seven to Jack, and lost with a straight, Eight to Queen
Seat 9: deadkiller1 (big blind) showed [Qh Kh] and won ($98.75) with a straight, Nine to King, and won ($98.75) with a straight, Nine to King





PokerStars Hand #152663251719:  Hold'em No Limit ($0.50/$1.00 USD) - 2016/04/30 18:54:28 CET [2016/04/30 12:54:28 ET]
Table 'Dagmar' 9-max Seat #9 is the button
Seat 1: matiko09 ($192.50 in chips) 
Seat 2: Spid1 ($189.28 in chips) 
Seat 3: ApkawaDavit ($122.50 in chips) 
Seat 4: RoadtoNepal ($101.50 in chips) 
Seat 5: cap. marb ($35.52 in chips) 
Seat 6: arctur17 ($152.82 in chips) 
Seat 7: kswmh ($94.61 in chips) 
Seat 8: Ilov3NBA ($118.59 in chips) 
Seat 9: okkernoot111 ($89.58 in chips) 
matiko09: posts small blind $0.50
Spid1: posts big blind $1
*** HOLE CARDS ***
Dealt to matiko09 [8c 4s]
ApkawaDavit: folds 
RoadtoNepal: raises $2 to $3
cap. marb: folds 
arctur17: folds 
kswmh: raises $2 to $5
Ilov3NBA: folds 
okkernoot111: calls $5
matiko09: folds 
Spid1: folds 
RoadtoNepal: calls $2
*** FLOP *** [5d Td 4c]
RoadtoNepal: checks 
kswmh: checks 
okkernoot111: checks 
*** TURN *** [5d Td 4c] [4h]
RoadtoNepal: checks 
kswmh: checks 
okkernoot111: checks 
*** RIVER *** [5d Td 4c 4h] [6c]
RoadtoNepal: checks 
kswmh: checks 
okkernoot111: checks 
*** SHOW DOWN ***
RoadtoNepal: shows [Ah Jh] (a pair of Fours)
kswmh: mucks hand 
okkernoot111: mucks hand 
RoadtoNepal collected $15.68 from pot
*** SUMMARY ***
Total pot $16.50 | Rake $0.82 
Board [5d Td 4c 4h 6c]
Seat 1: matiko09 (small blind) folded before Flop
Seat 2: Spid1 (big blind) folded before Flop
Seat 3: ApkawaDavit folded before Flop (didn't bet)
Seat 4: RoadtoNepal showed [Ah Jh] and won ($15.68) with a pair of Fours
Seat 5: cap. marb folded before Flop (didn't bet)
Seat 6: arctur17 folded before Flop (didn't bet)
Seat 7: kswmh mucked [3h Kd]
Seat 8: Ilov3NBA folded before Flop (didn't bet)
Seat 9: okkernoot111 (button) mucked [Ks 8s]





PokerStars Hand #152663254513:  Hold'em No Limit ($0.50/$1.00 USD) - 2016/04/30 18:54:32 CET [2016/04/30 12:54:32 ET]
Table 'Selinur II' 9-max Seat #2 is the button
Seat 1: Bimaxa ($100 in chips) 
Seat 2: matiko09 ($105.26 in chips) 
Seat 3: HITYESCA ($120.05 in chips) 
Seat 4: cap. marb ($38.50 in chips) 
Seat 5: qwertzuiopüß ($61.22 in chips) 
Seat 6: Daniel Daffe ($59.82 in chips) 
Seat 7: WrongButton ($100 in chips) 
Seat 8: Pacifistas ($100 in chips) 
Seat 9: Spid1 ($105.92 in chips) 
HITYESCA: posts small blind $0.50
cap. marb: posts big blind $1
*** HOLE CARDS ***
Dealt to matiko09 [Kd Jd]
qwertzuiopüß: folds 
Daniel Daffe: folds 
WrongButton: folds 
Pacifistas: raises $2 to $3
Spid1: raises $6 to $9
Bimaxa: folds 
Daniel Daffe leaves the table
Ilov3NBA joins the table at seat #6 
matiko09: folds 
HITYESCA: folds 
cap. marb: folds 
Pacifistas: folds 
Uncalled bet ($6) returned to Spid1
Spid1 collected $7.50 from pot
Spid1: doesn't show hand 
*** SUMMARY ***
Total pot $7.50 | Rake $0 
Seat 1: Bimaxa folded before Flop (didn't bet)
Seat 2: matiko09 (button) folded before Flop (didn't bet)
Seat 3: HITYESCA (small blind) folded before Flop
Seat 4: cap. marb (big blind) folded before Flop
Seat 5: qwertzuiopüß folded before Flop (didn't bet)
Seat 6: Daniel Daffe folded before Flop (didn't bet)
Seat 7: WrongButton folded before Flop (didn't bet)
Seat 8: Pacifistas folded before Flop
Seat 9: Spid1 collected ($7.50)





PokerStars Hand #152663480640:  Hold'em No Limit ($0.50/$1.00 USD) - 2016/04/30 19:00:40 CET [2016/04/30 13:00:40 ET]
Table 'Dagmar' 9-max Seat #7 is the button
Seat 1: matiko09 ($192 in chips) 
Seat 2: Spid1 ($192.40 in chips) 
Seat 3: ApkawaDavit ($100 in chips) 
Seat 4: RoadtoNepal ($132.26 in chips) 
Seat 5: cap. marb ($39.50 in chips) 
Seat 6: arctur17 ($151.32 in chips) 
Seat 7: kswmh ($79.42 in chips) 
Seat 8: Ilov3NBA ($128.21 in chips) 
Ilov3NBA: posts small blind $0.50
matiko09: posts big blind $1
*** HOLE CARDS ***
Dealt to matiko09 [Kh 2h]
Spid1: folds 
ApkawaDavit: folds 
RoadtoNepal: folds 
cap. marb: raises $1.12 to $2.12
arctur17: folds 
kswmh: folds 
Ilov3NBA: folds 
matiko09: folds 
Uncalled bet ($1.12) returned to cap. marb
cap. marb collected $2.50 from pot
cap. marb: doesn't show hand 
*** SUMMARY ***
Total pot $2.50 | Rake $0 
Seat 1: matiko09 (big blind) folded before Flop
Seat 2: Spid1 folded before Flop (didn't bet)
Seat 3: ApkawaDavit folded before Flop (didn't bet)
Seat 4: RoadtoNepal folded before Flop (didn't bet)
Seat 5: cap. marb collected ($2.50)
Seat 6: arctur17 folded before Flop (didn't bet)
Seat 7: kswmh (button) folded before Flop (didn't bet)
Seat 8: Ilov3NBA (small blind) folded before Flop





PokerStars Hand #152663491781:  Hold'em No Limit ($0.50/$1.00 USD) - 2016/04/30 19:00:57 CET [2016/04/30 13:00:57 ET]
Table 'Dagmar' 9-max Seat #8 is the button
Seat 1: matiko09 ($191 in chips) 
Seat 4: RoadtoNepal ($132.26 in chips) 
Seat 5: cap. marb ($41 in chips) 
Seat 6: arctur17 ($151.32 in chips) 
Seat 7: kswmh ($79.42 in chips) 
Seat 8: Ilov3NBA ($127.71 in chips) 
matiko09: posts small blind $0.50
Spid1: is sitting out 
Spid1 leaves the table
ApkawaDavit: is sitting out 
ApkawaDavit leaves the table
RoadtoNepal: posts big blind $1
*** HOLE CARDS ***
Dealt to matiko09 [Ad Th]
hurtNCYDE joins the table at seat #2 
cap. marb: folds 
arctur17: folds 
kswmh: folds 
hurtNCYDE leaves the table
Ilov3NBA: raises $1 to $2
bigacsiga joins the table at seat #2 
matiko09: calls $1.50
RoadtoNepal: folds 
*** FLOP *** [Kh Qs 7c]
matiko09: checks 
Ilov3NBA: checks 
*** TURN *** [Kh Qs 7c] [2h]
matiko09: bets $3
I The King I joins the table at seat #3 
Ilov3NBA: calls $3
*** RIVER *** [Kh Qs 7c 2h] [Kc]
matiko09: checks 
I The King I leaves the table
Ilov3NBA: checks 
*** SHOW DOWN ***
matiko09: shows [Ad Th] (a pair of Kings)
Ilov3NBA: mucks hand 
matiko09 collected $10.45 from pot
*** SUMMARY ***
Total pot $11 | Rake $0.55 
Board [Kh Qs 7c 2h Kc]
Seat 1: matiko09 (small blind) showed [Ad Th] and won ($10.45) with a pair of Kings
Seat 4: RoadtoNepal (big blind) folded before Flop
Seat 5: cap. marb folded before Flop (didn't bet)
Seat 6: arctur17 folded before Flop (didn't bet)
Seat 7: kswmh folded before Flop (didn't bet)
Seat 8: Ilov3NBA (button) mucked [Ah 9d]





PokerStars Hand #152663506474:  Hold'em No Limit ($0.50/$1.00 USD) - 2016/04/30 19:01:18 CET [2016/04/30 13:01:18 ET]
Table 'Lova II' 9-max Seat #9 is the button
Seat 1: pelikan1968 ($58.66 in chips) 
Seat 2: bilukm ($302.63 in chips) 
Seat 3: matiko09 ($107.89 in chips) 
Seat 4: VanDobeln ($123.75 in chips) 
Seat 5: Ilov3NBA ($160.13 in chips) 
Seat 6: HITYESCA ($100.81 in chips) 
Seat 7: Szevasztopol ($132.47 in chips) 
Seat 8: cap. marb ($59.89 in chips) 
Seat 9: IseeUcards ($100 in chips) 
pelikan1968: posts small blind $0.50
bilukm: posts big blind $1
*** HOLE CARDS ***
Dealt to matiko09 [Kd Ac]
matiko09: raises $2 to $3
VanDobeln: folds 
Ilov3NBA: raises $5.50 to $8.50
HITYESCA: folds 
Szevasztopol: folds 
cap. marb: folds 
IseeUcards: folds 
pelikan1968: folds 
bilukm: folds 
matiko09: calls $5.50
*** FLOP *** [5h 2d 2c]
matiko09: checks 
Ilov3NBA: bets $9.66
matiko09: folds 
Uncalled bet ($9.66) returned to Ilov3NBA
Ilov3NBA collected $17.58 from pot
Ilov3NBA: doesn't show hand 
*** SUMMARY ***
Total pot $18.50 | Rake $0.92 
Board [5h 2d 2c]
Seat 1: pelikan1968 (small blind) folded before Flop
Seat 2: bilukm (big blind) folded before Flop
Seat 3: matiko09 folded on the Flop
Seat 4: VanDobeln folded before Flop (didn't bet)
Seat 5: Ilov3NBA collected ($17.58)
Seat 6: HITYESCA folded before Flop (didn't bet)
Seat 7: Szevasztopol folded before Flop (didn't bet)
Seat 8: cap. marb folded before Flop (didn't bet)
Seat 9: IseeUcards (button) folded before Flop (didn't bet)





